ExecuteDtTm,t,n,SortTime,CombineTime,TotalTime
9/19/2013 8:28,6,10000000,1935,1499,3434
9/19/2013 8:28,6,10000000,1718,1460,3178
9/19/2013 8:28,6,10000000,1863,1522,3385
9/19/2013 8:28,6,10000000,2058,1602,3660
9/19/2013 8:28,6,10000000,1710,1533,3243
9/19/2013 8:29,6,10000000,1752,1562,3314
9/19/2013 8:29,6,10000000,1822,1606,3428
9/19/2013 8:29,6,10000000,1858,1461,3319
9/19/2013 8:29,6,10000000,1824,1480,3304
9/19/2013 8:29,6,10000000,1863,1504,3367
9/19/2013 8:29,6,10000000,1746,1566,3312
9/19/2013 8:29,6,10000000,1853,1558,3411
9/19/2013 8:29,6,10000000,1596,1734,3330
9/19/2013 8:29,6,10000000,1768,1495,3263
9/19/2013 8:29,6,10000000,1860,1491,3351
9/19/2013 8:30,6,10000000,1813,1498,3311
9/19/2013 8:30,6,10000000,1861,1528,3389
9/19/2013 8:30,6,10000000,1879,1535,3414
9/19/2013 8:30,6,10000000,1673,1540,3213
9/19/2013 8:30,6,10000000,1803,1591,3394
9/19/2013 8:30,6,10000000,1503,1568,3071
9/19/2013 8:30,6,10000000,2168,1550,3718
9/19/2013 8:30,6,10000000,1806,1566,3372
9/19/2013 8:30,6,10000000,1789,1488,3277
9/19/2013 8:30,6,10000000,2541,1601,4142
9/19/2013 8:31,6,10000000,1695,1553,3248
9/19/2013 8:31,6,10000000,2145,1558,3703
9/19/2013 8:31,6,10000000,1848,1511,3359
9/19/2013 8:31,6,10000000,2143,1562,3705
9/19/2013 8:31,6,10000000,1842,1579,3421
9/19/2013 8:31,6,10000000,1815,1542,3357
9/19/2013 8:31,6,10000000,1792,1496,3288
9/19/2013 8:31,6,10000000,1717,1495,3212
9/19/2013 8:31,6,10000000,1516,1568,3084
9/19/2013 8:31,6,10000000,1907,1544,3451
9/19/2013 8:32,6,10000000,1936,1498,3434
9/19/2013 8:32,6,10000000,1870,1522,3392
9/19/2013 8:32,6,10000000,1821,1486,3307
9/19/2013 8:32,6,10000000,1610,1692,3302
9/19/2013 8:32,6,10000000,1650,1657,3307
9/19/2013 8:32,6,10000000,1782,1489,3271
9/19/2013 8:32,6,10000000,1706,1731,3437
9/19/2013 8:32,6,10000000,1822,1544,3366
9/19/2013 8:32,6,10000000,1751,1548,3299
9/19/2013 8:32,6,10000000,1830,1572,3402
9/19/2013 8:33,6,10000000,1872,1568,3440
9/19/2013 8:33,6,10000000,1587,1581,3168
9/19/2013 8:33,6,10000000,1860,1556,3416
9/19/2013 8:33,6,10000000,1772,1496,3268
9/19/2013 8:33,6,10000000,1755,1560,3315
9/19/2013 8:33,6,10000000,1786,1559,3345
9/19/2013 8:33,6,10000000,2070,1464,3534
9/19/2013 8:33,6,10000000,2094,1502,3596
9/19/2013 8:33,6,20000000,3384,2998,6382
9/19/2013 8:34,6,20000000,3350,3014,6364
9/19/2013 8:34,6,20000000,3441,2965,6406
9/19/2013 8:34,6,20000000,3468,2827,6295
9/19/2013 8:34,6,20000000,3339,2973,6312
9/19/2013 8:34,6,20000000,3717,2890,6607
9/19/2013 8:34,6,20000000,3498,3322,6820
9/19/2013 8:35,6,20000000,3904,2932,6836
9/19/2013 8:35,6,20000000,3358,2991,6349
9/19/2013 8:35,6,20000000,3656,2995,6651
9/19/2013 8:35,6,20000000,3432,2972,6404
9/19/2013 8:35,6,20000000,3480,3032,6512
9/19/2013 8:35,6,20000000,3385,2893,6278
9/19/2013 8:35,6,20000000,3528,2861,6389
9/19/2013 8:36,6,20000000,3330,2915,6245
9/19/2013 8:36,6,20000000,3649,2896,6545
9/19/2013 8:36,6,20000000,3471,2958,6429
9/19/2013 8:36,6,20000000,3440,2969,6409
9/19/2013 8:36,6,20000000,3677,2852,6529
9/19/2013 8:36,6,20000000,3534,2900,6434
9/19/2013 8:37,6,20000000,3439,3160,6599
9/19/2013 8:37,6,20000000,3458,3015,6473
9/19/2013 8:37,6,20000000,3489,2933,6422
9/19/2013 8:37,6,20000000,3441,2856,6297
9/19/2013 8:37,6,20000000,3447,2879,6326
9/19/2013 8:37,6,20000000,3258,3008,6266
9/19/2013 8:38,6,20000000,3339,2840,6179
9/19/2013 8:38,6,20000000,3670,2861,6531
9/19/2013 8:38,6,20000000,3359,3063,6422
9/19/2013 8:38,6,20000000,3493,2755,6248
9/19/2013 8:38,6,20000000,3679,2854,6533
9/19/2013 8:38,6,20000000,3500,3029,6529
9/19/2013 8:38,6,20000000,3347,3031,6378
9/19/2013 8:39,6,20000000,3606,2935,6541
9/19/2013 8:39,6,20000000,3481,2897,6378
9/19/2013 8:39,6,20000000,3295,3011,6306
9/19/2013 8:39,6,20000000,3535,2906,6441
9/19/2013 8:39,6,20000000,3698,2863,6561
9/19/2013 8:39,6,20000000,3529,2985,6514
9/19/2013 8:40,6,20000000,3271,2996,6267
9/19/2013 8:40,6,20000000,3303,3006,6309
9/19/2013 8:40,6,20000000,3572,2932,6504
9/19/2013 8:40,6,20000000,3531,2976,6507
9/19/2013 8:40,6,20000000,3356,2885,6241
9/19/2013 8:40,6,20000000,3298,2955,6253
9/19/2013 8:41,6,20000000,3667,2914,6581
9/19/2013 8:41,6,20000000,3334,3031,6365
9/19/2013 8:41,6,20000000,3466,2862,6328
9/19/2013 8:41,6,20000000,3324,3047,6371
9/19/2013 8:41,6,20000000,3567,2892,6459
9/19/2013 8:41,6,20000000,3660,2917,6577
9/19/2013 8:42,6,20000000,3342,3947,7289
9/19/2013 8:42,6,20000000,3429,3040,6469
9/19/2013 8:42,6,20000000,3629,2879,6508
9/19/2013 8:42,6,20000000,3277,2972,6249
9/19/2013 8:42,6,20000000,3410,2867,6277
9/19/2013 8:42,6,20000000,3534,2846,6380
9/19/2013 8:43,6,20000000,3227,3080,6307
9/19/2013 8:43,6,20000000,3500,2882,6382
9/19/2013 8:43,6,20000000,3370,2831,6201
9/19/2013 8:43,6,20000000,3840,2882,6722
9/19/2013 8:43,6,20000000,3785,2899,6684
9/19/2013 8:43,6,20000000,3545,2853,6398
9/19/2013 8:43,6,20000000,3553,2958,6511
9/19/2013 8:44,6,20000000,3487,3013,6500
9/19/2013 8:44,6,20000000,3318,2824,6142
9/19/2013 8:44,6,20000000,3469,3010,6479
9/19/2013 8:44,6,20000000,3424,2972,6396
9/19/2013 8:44,6,20000000,3515,3022,6537
9/19/2013 8:44,6,20000000,3396,2883,6279
9/19/2013 8:45,6,20000000,3703,2855,6558
9/19/2013 8:45,6,20000000,3370,3051,6421
9/19/2013 8:45,6,20000000,3624,2992,6616
9/19/2013 8:45,6,20000000,3260,3002,6262
9/19/2013 8:45,6,20000000,3323,2984,6307
9/19/2013 8:45,6,20000000,3077,2981,6058
9/19/2013 8:46,6,20000000,4024,2893,6917
9/19/2013 8:46,6,20000000,3555,2874,6429
9/19/2013 8:46,6,20000000,3694,3745,7439
9/19/2013 8:46,6,20000000,3525,2929,6454
9/19/2013 8:46,6,20000000,3355,3833,7188
9/19/2013 8:46,6,20000000,3458,2974,6432
9/19/2013 8:47,6,20000000,3590,2975,6565
9/19/2013 8:47,6,20000000,3577,2856,6433
9/19/2013 8:47,6,20000000,3436,2972,6408
9/19/2013 8:47,6,20000000,3264,3041,6305
9/19/2013 8:47,6,20000000,3529,2997,6526
9/19/2013 8:47,6,20000000,3568,2868,6436
9/19/2013 8:48,6,20000000,3603,2977,6580
9/19/2013 8:48,6,20000000,3629,2943,6572
9/19/2013 8:48,6,20000000,3362,2866,6228
9/19/2013 8:48,6,20000000,3700,2899,6599
9/19/2013 8:48,6,20000000,3383,2967,6350
9/19/2013 8:48,6,20000000,3580,2782,6362
9/19/2013 8:48,6,20000000,3428,2776,6204
9/19/2013 8:49,6,20000000,3045,3016,6061
9/19/2013 8:49,6,20000000,3319,2982,6301
9/19/2013 8:49,6,20000000,3366,2988,6354
9/19/2013 8:49,6,20000000,3353,2857,6210
9/19/2013 8:49,6,20000000,3453,2849,6302
9/19/2013 8:49,6,20000000,3458,2886,6344
9/19/2013 8:50,6,20000000,3527,2849,6376
9/19/2013 8:50,6,20000000,3531,2895,6426
9/19/2013 8:50,6,20000000,3510,2822,6332
9/19/2013 8:50,6,20000000,3517,2741,6258
9/19/2013 8:50,6,20000000,3481,2833,6314
9/19/2013 8:50,6,20000000,3490,2870,6360
9/19/2013 8:51,6,20000000,3480,2961,6441
9/19/2013 8:51,6,20000000,3390,3008,6398
9/19/2013 8:51,6,20000000,3592,2956,6548
9/19/2013 8:51,6,20000000,3270,3023,6293
9/19/2013 8:51,6,20000000,3486,2871,6357
9/19/2013 8:51,6,20000000,3581,2783,6364
9/19/2013 8:51,6,20000000,3239,3047,6286
9/19/2013 8:52,6,20000000,3330,2974,6304
9/19/2013 8:52,6,30000000,5596,4399,9995
9/19/2013 8:52,6,30000000,5409,4250,9659
9/19/2013 8:52,6,30000000,5765,4298,10063
9/19/2013 8:53,6,30000000,5477,4304,9781
9/19/2013 8:53,6,30000000,6150,4440,10590
9/19/2013 8:53,6,30000000,5752,4197,9949
9/19/2013 8:53,6,30000000,5651,4232,9883
9/19/2013 8:53,6,30000000,5515,4413,9928
9/19/2013 8:54,6,30000000,5667,4231,9898
9/19/2013 8:54,6,30000000,5678,4383,10061
9/19/2013 8:54,6,30000000,5590,4406,9996
9/19/2013 8:54,6,30000000,5567,4330,9897
9/19/2013 8:55,6,30000000,5643,4414,10057
9/19/2013 8:55,6,30000000,6019,4752,10771
9/19/2013 8:55,6,30000000,5618,4468,10086
9/19/2013 8:55,6,30000000,5717,4435,10152
9/19/2013 8:56,6,30000000,5331,4343,9674
9/19/2013 8:56,6,30000000,5696,4231,9927
9/19/2013 8:56,6,30000000,5468,4490,9958
9/19/2013 8:56,6,30000000,5416,4360,9776
9/19/2013 8:56,6,30000000,5597,4481,10078
9/19/2013 8:57,6,30000000,5507,4383,9890
9/19/2013 8:57,6,30000000,5828,4405,10233
9/19/2013 8:57,6,30000000,5702,4215,9917
9/19/2013 8:57,6,30000000,5680,4312,9992
9/19/2013 8:58,6,30000000,5920,4432,10352
9/19/2013 8:58,6,30000000,5659,4230,9889
9/19/2013 8:58,6,30000000,5617,4433,10050
9/19/2013 8:58,6,30000000,5840,4288,10128
9/19/2013 8:59,6,30000000,5509,4424,9933
9/19/2013 8:59,6,30000000,5688,4618,10306
9/19/2013 8:59,6,30000000,5571,4235,9806
9/19/2013 8:59,6,30000000,5719,4167,9886
9/19/2013 8:59,6,30000000,5945,4221,10166
9/19/2013 9:00,6,30000000,5521,4454,9975
9/19/2013 9:00,6,30000000,5952,4224,10176
9/19/2013 9:00,6,30000000,5693,4266,9959
9/19/2013 9:00,6,30000000,5567,4416,9983
9/19/2013 9:01,6,30000000,5809,4122,9931
9/19/2013 9:01,6,30000000,5225,4171,9396
9/19/2013 9:01,6,30000000,5656,4183,9839
9/19/2013 9:01,6,30000000,5513,4318,9831
9/19/2013 9:02,6,30000000,5696,4862,10558
9/19/2013 9:02,6,30000000,5528,4367,9895
9/19/2013 9:02,6,30000000,5479,4259,9738
9/19/2013 9:02,6,30000000,5694,4223,9917
9/19/2013 9:02,6,30000000,5527,4299,9826
9/19/2013 9:03,6,30000000,5628,4455,10083
9/19/2013 9:03,6,30000000,5471,4340,9811
9/19/2013 9:03,6,30000000,5707,4415,10122
9/19/2013 9:03,6,30000000,5784,4231,10015
9/19/2013 9:04,6,30000000,5848,4435,10283
9/19/2013 9:04,6,30000000,5573,4226,9799
9/19/2013 9:04,6,30000000,5494,4478,9972
9/19/2013 9:04,6,30000000,5607,4237,9844
9/19/2013 9:05,6,30000000,5531,4208,9739
9/19/2013 9:05,6,30000000,5616,4397,10013
9/19/2013 9:05,6,30000000,5622,4402,10024
9/19/2013 9:05,6,30000000,5303,4296,9599
9/19/2013 9:05,6,30000000,5818,4415,10233
9/19/2013 9:06,6,30000000,5420,4284,9704
9/19/2013 9:06,6,30000000,5810,4694,10504
9/19/2013 9:06,6,30000000,5682,4608,10290
9/19/2013 9:06,6,30000000,5673,4264,9937
9/19/2013 9:07,6,30000000,5875,4396,10271
9/19/2013 9:07,6,30000000,5460,4442,9902
9/19/2013 9:07,6,30000000,5846,4227,10073
9/19/2013 9:07,6,30000000,5659,4378,10037
9/19/2013 9:08,6,30000000,5834,4260,10094
9/19/2013 9:08,6,30000000,5513,4260,9773
9/19/2013 9:08,6,30000000,5458,4399,9857
9/19/2013 9:08,6,30000000,5518,4288,9806
9/19/2013 9:08,6,30000000,5703,4387,10090
9/19/2013 9:09,6,30000000,5414,4260,9674
9/19/2013 9:09,6,30000000,5394,4379,9773
9/19/2013 9:26,6,30000000,5766,4280,10046
9/19/2013 9:26,6,30000000,5684,5015,10699
9/19/2013 9:26,6,30000000,5630,4240,9870
9/19/2013 9:27,6,30000000,5812,4238,10050
9/19/2013 9:27,6,30000000,5768,4461,10229
9/19/2013 9:27,6,30000000,5712,4222,9934
9/19/2013 9:27,6,30000000,5604,4496,10100
9/19/2013 9:28,6,30000000,5578,4281,9859
9/19/2013 9:28,6,30000000,5373,4442,9815
9/19/2013 9:28,6,30000000,5622,4280,9902
9/19/2013 9:28,6,30000000,5603,4222,9825
9/19/2013 9:29,6,30000000,5680,4426,10106
9/19/2013 9:29,6,30000000,5467,4481,9948
9/19/2013 9:29,6,30000000,5700,4284,9984
9/19/2013 9:29,6,30000000,6040,4233,10273
9/19/2013 9:29,6,30000000,5486,4355,9841
9/19/2013 9:30,6,30000000,5421,4796,10217
9/19/2013 9:30,6,30000000,5672,4448,10120
9/19/2013 9:30,6,30000000,5390,4295,9685
9/19/2013 9:30,6,30000000,5595,4239,9834
9/19/2013 9:31,6,30000000,5591,4234,9825
9/19/2013 9:31,6,30000000,5514,4574,10088
9/19/2013 9:31,6,30000000,5529,4380,9909
9/19/2013 9:31,6,30000000,5787,4378,10165
9/19/2013 9:32,6,30000000,5726,4462,10188
9/19/2013 9:32,6,30000000,5302,4361,9663
9/19/2013 9:32,6,30000000,5734,4251,9985
9/19/2013 9:32,6,30000000,5489,4395,9884
9/19/2013 9:32,6,30000000,5519,4229,9748
9/19/2013 9:33,6,30000000,5999,4199,10198
9/19/2013 9:33,6,30000000,5788,4446,10234
9/19/2013 9:33,6,30000000,5987,4331,10318
9/19/2013 9:33,6,30000000,5488,4329,9817
9/19/2013 9:34,6,30000000,5519,4396,9915
9/19/2013 9:34,6,30000000,5410,4211,9621
9/19/2013 9:34,6,30000000,5536,4173,9709
9/19/2013 9:34,6,30000000,5561,4326,9887
9/19/2013 9:35,6,30000000,5916,4330,10246
9/19/2013 9:35,6,30000000,5791,4755,10546
9/19/2013 9:35,6,40000000,6102,5988,12090
9/19/2013 9:35,6,40000000,7432,5664,13096
9/19/2013 9:36,6,40000000,5971,6038,12009
9/19/2013 9:36,6,40000000,6639,5899,12538
9/19/2013 9:36,6,40000000,7460,5666,13126
9/19/2013 9:36,6,40000000,7194,5620,12814
9/19/2013 9:37,6,40000000,6510,5973,12483
9/19/2013 9:37,6,40000000,6303,5846,12149
9/19/2013 9:37,6,40000000,7433,5950,13383
9/19/2013 9:38,6,40000000,7311,5592,12903
9/19/2013 9:38,6,40000000,7464,5850,13314
9/19/2013 9:38,6,40000000,6845,5722,12567
9/19/2013 9:38,6,40000000,6712,5897,12609
9/19/2013 9:39,6,40000000,7001,5740,12741
9/19/2013 9:39,6,40000000,6766,5830,12596
9/19/2013 9:39,6,40000000,6346,6017,12363
9/19/2013 9:40,6,40000000,6795,5714,12509
9/19/2013 9:40,6,40000000,7425,5625,13050
9/19/2013 9:40,6,40000000,6003,6125,12128
9/19/2013 9:40,6,40000000,7205,5676,12881
9/19/2013 9:41,6,40000000,6376,5702,12078
9/19/2013 9:41,6,40000000,6915,5739,12654
9/19/2013 9:41,6,40000000,6873,5867,12740
9/19/2013 9:42,6,40000000,5988,5987,11975
9/19/2013 9:42,6,40000000,7378,5931,13309
9/19/2013 9:42,6,40000000,7500,5671,13171
9/19/2013 9:42,6,40000000,7048,5558,12606
9/19/2013 9:43,6,40000000,6183,5856,12039
9/19/2013 9:43,6,40000000,6976,5590,12566
9/19/2013 9:43,6,40000000,7290,5908,13198
9/19/2013 9:44,6,40000000,6513,5954,12467
9/19/2013 9:44,6,40000000,7082,5676,12758
9/19/2013 9:44,6,40000000,6798,5820,12618
9/19/2013 9:44,6,40000000,6836,5867,12703
9/19/2013 9:45,6,40000000,6934,5624,12558
9/19/2013 9:45,6,40000000,6903,5850,12753
9/19/2013 9:45,6,40000000,6208,5906,12114
9/19/2013 9:46,6,40000000,7184,5827,13011
9/19/2013 9:46,6,40000000,6479,7506,13985
9/19/2013 9:46,6,40000000,6798,6047,12845
9/19/2013 9:47,6,40000000,7279,5730,13009
9/19/2013 9:47,6,40000000,7099,5878,12977
9/19/2013 9:47,6,40000000,6535,5963,12498
9/19/2013 9:47,6,40000000,6866,5664,12530
9/19/2013 9:48,6,40000000,7050,5920,12970
9/19/2013 9:48,6,40000000,6180,5807,11987
9/19/2013 9:48,6,40000000,6866,5714,12580
9/19/2013 9:48,6,40000000,6984,5857,12841
9/19/2013 9:49,6,40000000,6577,5908,12485
9/19/2013 9:49,6,40000000,6538,5855,12393
9/19/2013 9:49,6,40000000,7400,5674,13074
9/19/2013 9:50,6,40000000,6251,5870,12121
9/19/2013 9:50,6,40000000,6749,5701,12450
9/19/2013 9:50,6,40000000,6945,5764,12709
9/19/2013 9:50,6,40000000,6063,6074,12137
9/19/2013 9:51,6,40000000,6494,5786,12280
9/19/2013 9:51,6,40000000,6211,5819,12030
9/19/2013 9:51,6,40000000,6272,6221,12493
9/19/2013 9:52,6,40000000,7463,5808,13271
9/19/2013 9:52,6,40000000,6545,5908,12453
9/19/2013 9:52,6,40000000,7405,5828,13233
9/19/2013 9:52,6,40000000,6625,5747,12372
9/19/2013 9:53,6,40000000,7184,7547,14731
9/19/2013 9:53,6,40000000,6950,5908,12858
9/19/2013 9:53,6,40000000,7172,5537,12709
9/19/2013 9:54,6,40000000,6272,6007,12279
9/19/2013 9:54,6,40000000,6708,6196,12904
9/19/2013 9:54,6,40000000,7358,5638,12996
9/19/2013 9:55,6,40000000,7012,5954,12966
9/19/2013 9:55,6,40000000,7370,5728,13098
9/19/2013 9:55,6,40000000,7183,5781,12964
9/19/2013 9:55,6,40000000,6509,5809,12318
9/19/2013 9:56,6,40000000,7085,5854,12939
9/19/2013 9:56,6,40000000,6917,5814,12731
9/19/2013 9:56,6,40000000,6194,6004,12198
9/19/2013 9:57,6,40000000,7345,5908,13253
9/19/2013 9:57,6,40000000,6895,5415,12310
9/19/2013 9:57,6,40000000,6003,5930,11933
9/19/2013 9:57,6,40000000,6487,5846,12333
9/19/2013 9:58,6,40000000,6279,6057,12336
9/19/2013 9:58,6,40000000,6944,6030,12974
9/19/2013 9:58,6,40000000,5842,5813,11655
9/19/2013 9:58,6,40000000,6124,5838,11962
9/19/2013 9:59,6,40000000,7286,5739,13025
9/19/2013 9:59,6,40000000,6014,5944,11958
9/19/2013 9:59,6,40000000,7015,5762,12777
9/19/2013 10:00,6,40000000,7015,5843,12858
9/19/2013 10:00,6,40000000,7294,7532,14826
9/19/2013 10:00,6,40000000,7087,5932,13019
9/19/2013 10:01,6,40000000,6828,5787,12615
9/19/2013 10:01,6,40000000,6210,5919,12129
9/19/2013 10:01,6,40000000,7444,5854,13298
9/19/2013 10:01,6,40000000,6911,5962,12873
9/19/2013 10:02,6,40000000,6037,5944,11981
9/19/2013 10:02,6,40000000,7280,5793,13073
9/19/2013 10:02,6,40000000,6702,5871,12573
9/19/2013 10:03,6,40000000,6752,5858,12610
9/19/2013 10:03,6,40000000,7010,5576,12586
9/19/2013 10:03,6,40000000,6648,5858,12506
9/19/2013 10:03,6,40000000,7026,5853,12879
9/19/2013 10:04,6,40000000,6138,5972,12110
9/19/2013 10:04,6,40000000,5970,5847,11817
9/19/2013 10:04,6,40000000,6715,5800,12515
9/19/2013 10:04,6,40000000,6707,6068,12775
9/19/2013 10:05,6,40000000,6247,6042,12289
9/19/2013 10:05,6,40000000,7242,6067,13309
9/19/2013 10:05,6,40000000,6862,5803,12665
9/19/2013 10:06,6,40000000,6818,5989,12807
9/19/2013 10:06,6,40000000,7135,5843,12978
9/19/2013 10:06,6,40000000,6784,5805,12589
9/19/2013 10:06,6,40000000,6687,6048,12735
9/19/2013 10:07,6,40000000,6546,5751,12297
9/19/2013 10:07,6,40000000,6952,5712,12664
9/19/2013 10:07,6,40000000,6516,5952,12468
9/19/2013 10:08,6,40000000,6126,6138,12264
9/19/2013 10:08,6,50000000,8491,8024,16515
9/19/2013 10:08,6,50000000,8734,9062,17796
9/19/2013 10:09,6,50000000,7796,8404,16200
9/19/2013 10:09,6,50000000,8672,7681,16353
9/19/2013 10:09,6,50000000,8589,8099,16688
9/19/2013 10:10,6,50000000,8757,7910,16667
9/19/2013 10:10,6,50000000,8982,7725,16707
9/19/2013 10:11,6,50000000,8876,7848,16724
9/19/2013 10:11,6,50000000,8272,8082,16354
9/19/2013 10:11,6,50000000,8577,7978,16555
9/19/2013 10:12,6,50000000,8861,8174,17035
9/19/2013 10:12,6,50000000,8261,7747,16008
9/19/2013 10:12,6,50000000,8626,8148,16774
9/19/2013 10:13,6,50000000,8714,7990,16704
9/19/2013 10:13,6,50000000,8937,7932,16869
9/19/2013 10:13,6,50000000,8805,8100,16905
9/19/2013 10:14,6,50000000,8843,7783,16626
9/19/2013 10:14,6,50000000,9036,8193,17229
9/19/2013 10:15,6,50000000,8573,11134,19707
9/19/2013 10:15,6,50000000,7861,8015,15876
9/19/2013 10:15,6,50000000,8406,8109,16515
9/19/2013 10:16,6,50000000,8524,7633,16157
9/19/2013 10:16,6,50000000,8352,8131,16483
9/19/2013 10:16,6,50000000,8389,8056,16445
9/19/2013 10:17,6,50000000,8573,7728,16301
9/19/2013 10:17,6,50000000,8677,8317,16994
9/19/2013 10:17,6,50000000,8410,8924,17334
9/19/2013 10:18,6,50000000,8716,8084,16800
9/19/2013 10:18,6,50000000,8372,7895,16267
9/19/2013 10:19,6,50000000,8457,7872,16329
9/19/2013 10:19,6,50000000,8630,8349,16979
9/19/2013 10:19,6,50000000,8626,8014,16640
9/19/2013 10:20,6,50000000,8549,8346,16895
9/19/2013 10:20,6,50000000,9295,8223,17518
9/19/2013 10:20,6,50000000,8951,8418,17369
9/19/2013 10:21,6,50000000,8466,8292,16758
9/19/2013 10:21,6,50000000,8963,8616,17579
9/19/2013 10:22,6,50000000,8829,7954,16783
9/19/2013 10:22,6,50000000,8444,8213,16657
9/19/2013 10:22,6,50000000,9357,7889,17246
9/19/2013 10:23,6,50000000,8553,7944,16497
9/19/2013 10:23,6,50000000,8749,7825,16574
9/19/2013 10:23,6,50000000,9011,9110,18121
9/19/2013 10:24,6,50000000,8112,8062,16174
9/19/2013 10:24,6,50000000,7976,7989,15965
9/19/2013 10:24,6,50000000,8922,8563,17485
9/19/2013 10:25,6,50000000,8646,7827,16473
9/19/2013 10:25,6,50000000,8051,7717,15768
9/19/2013 10:26,6,50000000,8543,8432,16975
9/19/2013 10:26,6,50000000,8127,8213,16340
9/19/2013 10:26,6,50000000,8638,7784,16422
9/19/2013 10:27,6,50000000,8569,7871,16440
9/19/2013 10:27,6,50000000,8435,8185,16620
9/19/2013 10:27,6,50000000,8757,8005,16762
9/19/2013 10:28,6,50000000,9197,8576,17773
9/19/2013 10:28,6,50000000,8777,8294,17071
9/19/2013 10:28,6,50000000,8846,8014,16860
9/19/2013 10:29,6,50000000,8923,8185,17108
9/19/2013 10:29,6,50000000,9069,7894,16963
9/19/2013 10:30,6,50000000,8072,8449,16521
9/19/2013 10:30,6,50000000,8550,7678,16228
9/19/2013 10:30,6,50000000,8412,8295,16707
9/19/2013 10:31,6,50000000,8850,8033,16883
9/19/2013 10:31,6,50000000,8995,8188,17183
9/19/2013 10:31,6,50000000,8187,7839,16026
9/19/2013 10:32,6,50000000,8335,8385,16720
9/19/2013 10:32,6,50000000,8703,8523,17226
9/19/2013 10:32,6,50000000,8914,10352,19266
9/19/2013 10:33,6,50000000,8808,7764,16572
9/19/2013 10:33,6,50000000,8933,8055,16988
9/19/2013 10:34,6,50000000,8584,8324,16908
9/19/2013 10:34,6,50000000,8542,7395,15937
9/19/2013 10:51,6,50000000,8502,8215,16717
9/19/2013 10:52,6,50000000,8762,7786,16548
9/19/2013 10:52,6,50000000,8995,7740,16735
9/19/2013 10:52,6,50000000,8961,8167,17128
9/19/2013 10:53,6,50000000,8717,8188,16905
9/19/2013 10:53,6,50000000,8886,8554,17440
9/19/2013 10:53,6,50000000,8453,7766,16219
9/19/2013 10:54,6,50000000,8657,7883,16540
9/19/2013 10:54,6,50000000,8694,7996,16690
9/19/2013 10:54,6,50000000,8553,7724,16277
9/19/2013 10:55,6,50000000,8228,7925,16153
9/19/2013 10:55,6,50000000,8776,8583,17359
9/19/2013 10:56,6,50000000,8267,7809,16076
9/19/2013 10:56,6,50000000,8517,7953,16470
9/19/2013 10:56,6,50000000,8727,7869,16596
9/19/2013 10:57,6,50000000,8482,7889,16371
9/19/2013 10:57,6,50000000,8558,8017,16575
9/19/2013 10:57,6,50000000,8485,8616,17101
9/19/2013 10:58,6,50000000,9138,8354,17492
9/19/2013 10:58,6,50000000,8217,7738,15955
9/19/2013 10:58,6,50000000,8722,8113,16835
9/19/2013 10:59,6,50000000,8581,7919,16500
9/19/2013 10:59,6,50000000,8845,8183,17028
9/19/2013 11:00,6,50000000,8925,8237,17162
9/19/2013 11:00,6,50000000,8367,7986,16353
9/19/2013 11:00,6,50000000,8298,7956,16254
9/19/2013 11:01,6,50000000,8934,7762,16696
9/19/2013 11:01,6,50000000,8973,8238,17211
9/19/2013 11:01,6,50000000,8572,8321,16893
9/19/2013 11:02,6,50000000,9039,8598,17637
9/19/2013 11:02,6,50000000,7709,8926,16635
9/19/2013 11:03,6,50000000,8447,8032,16479
9/19/2013 11:03,6,50000000,8011,8561,16572
9/19/2013 11:03,6,50000000,8485,7874,16359
9/19/2013 11:04,6,50000000,9177,8561,17738
9/19/2013 11:04,6,50000000,8990,7828,16818
9/19/2013 11:04,6,50000000,8440,8319,16759
9/19/2013 11:05,6,50000000,8686,8026,16712
9/19/2013 11:05,6,50000000,9009,8258,17267
9/19/2013 11:05,6,50000000,8617,7738,16355
9/19/2013 11:06,6,50000000,7964,8364,16328
9/19/2013 11:06,6,50000000,8914,8277,17191
9/19/2013 11:07,6,60000000,11443,8223,19666
9/19/2013 11:07,6,60000000,12387,8242,20629
9/19/2013 11:07,6,60000000,10265,11197,21462
9/19/2013 11:08,6,60000000,11900,8594,20494
9/19/2013 11:08,6,60000000,11681,8775,20456
9/19/2013 11:09,6,60000000,11714,8468,20182
9/19/2013 11:09,6,60000000,11843,7869,19712
9/19/2013 11:10,6,60000000,11218,8251,19469
9/19/2013 11:10,6,60000000,11765,8289,20054
9/19/2013 11:11,6,60000000,11674,8132,19806
9/19/2013 11:11,6,60000000,10972,8317,19289
9/19/2013 11:11,6,60000000,10979,8415,19394
9/19/2013 11:12,6,60000000,12000,8709,20709
9/19/2013 11:12,6,60000000,12216,8215,20431
9/19/2013 11:13,6,60000000,11346,8297,19643
9/19/2013 11:13,6,60000000,11307,8393,19700
9/19/2013 11:14,6,60000000,11629,8228,19857
9/19/2013 11:14,6,60000000,11250,8396,19646
9/19/2013 11:14,6,60000000,11625,8796,20421
9/19/2013 11:15,6,60000000,11386,8449,19835
9/19/2013 11:15,6,60000000,12039,8823,20862
9/19/2013 11:16,6,60000000,11327,8506,19833
9/19/2013 11:16,6,60000000,12348,8359,20707
9/19/2013 11:17,6,60000000,12026,8438,20464
9/19/2013 11:17,6,60000000,11631,8309,19940
9/19/2013 11:17,6,60000000,11215,8262,19477
9/19/2013 11:18,6,60000000,11855,8314,20169
9/19/2013 11:18,6,60000000,12026,8258,20284
9/19/2013 11:19,6,60000000,12303,8262,20565
9/19/2013 11:19,6,60000000,11269,8819,20088
9/19/2013 11:20,6,60000000,11848,8114,19962
9/19/2013 11:20,6,60000000,11667,8253,19920
9/19/2013 11:20,6,60000000,12271,8154,20425
9/19/2013 11:21,6,60000000,12034,8165,20199
9/19/2013 11:21,6,60000000,11635,8280,19915
9/19/2013 11:22,6,60000000,12048,8297,20345
9/19/2013 11:22,6,60000000,11949,8338,20287
9/19/2013 11:23,6,60000000,12064,8155,20219
9/19/2013 11:23,6,60000000,11488,8749,20237
9/19/2013 11:23,6,60000000,11672,8638,20310
9/19/2013 11:24,6,60000000,12313,8614,20927
9/19/2013 11:24,6,60000000,11776,8728,20504
9/19/2013 11:25,6,60000000,11012,8420,19432
9/19/2013 11:25,6,60000000,12065,8288,20353
9/19/2013 11:26,6,60000000,11837,8179,20016
9/19/2013 11:26,6,60000000,12376,8204,20580
9/19/2013 11:27,6,60000000,11621,8722,20343
9/19/2013 11:27,6,60000000,11217,8702,19919
9/19/2013 11:27,6,60000000,12124,8307,20431
9/19/2013 11:28,6,60000000,11613,8168,19781
9/19/2013 11:28,6,60000000,11167,8453,19620
9/19/2013 11:29,6,60000000,12025,8192,20217
9/19/2013 11:29,6,60000000,11115,11704,22819
9/19/2013 11:30,6,60000000,11918,8720,20638
9/19/2013 11:30,6,60000000,12203,8262,20465
9/19/2013 11:30,6,60000000,12097,8314,20411
9/19/2013 11:31,6,60000000,11996,8258,20254
9/19/2013 11:31,6,60000000,11973,8240,20213
9/19/2013 11:32,6,60000000,11076,8146,19222
9/19/2013 11:32,6,60000000,11702,8412,20114
9/19/2013 11:33,6,60000000,11013,8349,19362
9/19/2013 11:33,6,60000000,10962,8089,19051
9/19/2013 11:33,6,60000000,11397,8775,20172
9/19/2013 11:34,6,60000000,12292,8117,20409
9/19/2013 11:34,6,60000000,11008,8698,19706
9/19/2013 11:35,6,60000000,10742,8515,19257
9/19/2013 11:35,6,60000000,11936,8268,20204
9/19/2013 11:36,6,60000000,11376,8315,19691
9/19/2013 11:36,6,60000000,11425,8159,19584
9/19/2013 11:36,6,60000000,11507,8747,20254
9/19/2013 11:37,6,60000000,12351,7817,20168
9/19/2013 11:37,6,60000000,12085,8145,20230
9/19/2013 11:38,6,60000000,11564,8631,20195
9/19/2013 11:38,6,60000000,12077,8244,20321
9/19/2013 11:39,6,60000000,11945,8272,20217
9/19/2013 11:39,6,60000000,11682,8219,19901
9/19/2013 11:40,6,60000000,11630,8589,20219
9/19/2013 11:40,6,60000000,11392,8258,19650
9/19/2013 11:40,6,60000000,11496,11274,22770
9/19/2013 11:41,6,60000000,12378,8168,20546
9/19/2013 11:41,6,60000000,12050,8262,20312
9/19/2013 11:42,6,60000000,12036,8223,20259
9/19/2013 11:42,6,60000000,11234,8368,19602
9/19/2013 11:43,6,60000000,11054,8463,19517
9/19/2013 11:43,6,60000000,12084,8827,20911
9/19/2013 11:43,6,60000000,10792,8615,19407
9/19/2013 11:44,6,60000000,11973,8359,20332
9/19/2013 11:44,6,60000000,11135,8385,19520
9/19/2013 11:45,6,60000000,11931,8261,20192
9/19/2013 11:45,6,60000000,11825,8410,20235
9/19/2013 11:46,6,60000000,11151,8214,19365
9/19/2013 11:46,6,60000000,11163,8397,19560
9/19/2013 11:46,6,60000000,11138,8759,19897
9/19/2013 11:47,6,60000000,11885,8231,20116
9/19/2013 11:47,6,60000000,12243,8288,20531
9/19/2013 11:48,6,60000000,11626,8745,20371
9/19/2013 11:48,6,60000000,11975,8201,20176
9/19/2013 11:49,6,60000000,11591,8364,19955
9/19/2013 11:49,6,60000000,11821,8338,20159
9/19/2013 11:49,6,60000000,10937,8428,19365
9/19/2013 11:50,6,60000000,11674,9946,21620
9/19/2013 11:50,6,60000000,12208,8261,20469
9/19/2013 11:51,6,60000000,11740,8759,20499
9/19/2013 11:51,6,60000000,11553,8903,20456
9/19/2013 11:52,6,60000000,11530,8663,20193
9/19/2013 11:52,6,60000000,11438,8297,19735
9/19/2013 11:53,6,60000000,11970,8310,20280
9/19/2013 11:53,6,60000000,11899,8771,20670
9/19/2013 11:53,6,60000000,12022,8236,20258
9/19/2013 11:54,6,60000000,11744,8266,20010
9/19/2013 11:54,6,60000000,11061,8749,19810
9/19/2013 11:55,6,60000000,11499,8335,19834
9/19/2013 11:55,6,60000000,12248,8259,20507
9/19/2013 11:56,6,60000000,11089,8355,19444
9/19/2013 11:56,6,60000000,12414,8338,20752
9/19/2013 11:56,6,70000000,12726,9834,22560
9/19/2013 11:57,6,70000000,12901,9891,22792
9/19/2013 11:57,6,70000000,12819,9523,22342
9/19/2013 11:58,6,70000000,12908,10010,22918
9/19/2013 11:58,6,70000000,12605,9589,22194
9/19/2013 11:59,6,70000000,12877,9748,22625
9/19/2013 11:59,6,70000000,13562,9738,23300
9/20/2013 12:00,6,70000000,12741,10027,22768
9/20/2013 12:00,6,70000000,13571,10164,23735
9/20/2013 12:01,6,70000000,13225,9566,22791
9/20/2013 12:01,6,70000000,13272,9761,23033
9/20/2013 12:02,6,70000000,12719,10024,22743
9/20/2013 12:02,6,70000000,13335,9690,23025
9/20/2013 12:03,6,70000000,13139,9759,22898
9/20/2013 12:03,6,70000000,12729,9771,22500
9/20/2013 12:04,6,70000000,13408,9824,23232
9/20/2013 12:04,6,70000000,12864,10001,22865
9/20/2013 12:05,6,70000000,12709,12902,25611
9/20/2013 12:05,6,70000000,12331,10069,22400
9/20/2013 12:06,6,70000000,13084,9800,22884
9/20/2013 12:06,6,70000000,12461,9715,22176
9/20/2013 12:07,6,70000000,13099,9826,22925
9/20/2013 12:07,6,70000000,13142,9950,23092
9/20/2013 12:08,6,70000000,13262,9715,22977
9/20/2013 12:08,6,70000000,13136,9492,22628
9/20/2013 12:09,6,70000000,13012,10394,23406
9/20/2013 12:09,6,70000000,13329,9892,23221
9/20/2013 12:10,6,70000000,13516,9917,23433
9/20/2013 12:10,6,70000000,13004,9714,22718
9/20/2013 12:11,6,70000000,14018,10075,24093
9/20/2013 12:11,6,70000000,13257,9735,22992
9/20/2013 12:12,6,70000000,13399,10369,23768
9/20/2013 12:12,6,70000000,12979,10660,23639
9/20/2013 12:13,6,70000000,13484,10165,23649
9/20/2013 12:13,6,70000000,13805,10022,23827
9/20/2013 12:14,6,70000000,13388,9735,23123
9/20/2013 12:14,6,70000000,13147,10068,23215
9/20/2013 12:15,6,70000000,13481,9923,23404
9/20/2013 12:15,6,70000000,13042,9850,22892
9/20/2013 12:16,6,70000000,13093,10046,23139
9/20/2013 12:16,6,70000000,13307,9760,23067
9/20/2013 12:17,6,70000000,14273,9577,23850
9/20/2013 12:17,6,70000000,12461,10288,22749
9/20/2013 12:18,6,70000000,12353,10088,22441
9/20/2013 12:18,6,70000000,12359,10184,22543
9/20/2013 12:19,6,70000000,13289,10180,23469
9/20/2013 12:19,6,70000000,13292,9767,23059
9/20/2013 12:20,6,70000000,12940,9744,22684
9/20/2013 12:20,6,70000000,12819,9781,22600
9/20/2013 12:21,6,70000000,12064,9690,21754
9/20/2013 12:21,6,70000000,12472,10171,22643
9/20/2013 12:22,6,70000000,13210,10079,23289
9/20/2013 12:22,6,70000000,13788,9847,23635
9/20/2013 12:23,6,70000000,12839,9951,22790
9/20/2013 12:23,6,70000000,13396,9873,23269
9/20/2013 12:24,6,70000000,13233,9668,22901
9/20/2013 12:24,6,70000000,13679,10170,23849
9/20/2013 12:25,6,70000000,12462,9586,22048
9/20/2013 12:25,6,70000000,13758,10076,23834
9/20/2013 12:26,6,70000000,13751,12193,25944
9/20/2013 12:26,6,70000000,12741,9813,22554
9/20/2013 12:27,6,70000000,12719,9741,22460
9/20/2013 12:27,6,70000000,14143,9777,23920
9/20/2013 12:28,6,70000000,13224,9756,22980
9/20/2013 12:28,6,70000000,13481,10226,23707
9/20/2013 12:29,6,70000000,12886,9960,22846
9/20/2013 12:29,6,70000000,13202,9744,22946
9/20/2013 12:30,6,70000000,13213,9767,22980
9/20/2013 12:30,6,70000000,13941,9762,23703
9/20/2013 12:31,6,70000000,13375,10063,23438
9/20/2013 12:31,6,70000000,13732,9815,23547
9/20/2013 12:32,6,70000000,12441,13311,25752
9/20/2013 12:32,6,70000000,12957,9708,22665
9/20/2013 12:33,6,70000000,12953,10256,23209
9/20/2013 12:33,6,70000000,11914,10061,21975
9/20/2013 12:33,6,70000000,12899,9751,22650
9/20/2013 12:34,6,70000000,13241,10026,23267
9/20/2013 12:34,6,70000000,13685,9966,23651
9/20/2013 12:35,6,70000000,13223,9754,22977
9/20/2013 12:35,6,70000000,13477,10066,23543
9/20/2013 12:36,6,70000000,13133,9417,22550
9/20/2013 12:36,6,70000000,12182,10199,22381
9/20/2013 12:37,6,70000000,12795,9944,22739
9/20/2013 12:37,6,70000000,12971,9851,22822
9/20/2013 12:38,6,70000000,12824,10349,23173
9/20/2013 12:38,6,70000000,13320,9791,23111
9/20/2013 12:39,6,70000000,13088,9849,22937
9/20/2013 12:39,6,70000000,12991,10005,22996
9/20/2013 12:40,6,70000000,12222,9800,22022
9/20/2013 12:40,6,70000000,12801,9992,22793
9/20/2013 12:41,6,70000000,12668,9440,22108
9/20/2013 12:41,6,70000000,13741,9729,23470
9/20/2013 12:42,6,70000000,13624,9910,23534
9/20/2013 12:42,6,70000000,13558,10160,23718
9/20/2013 12:43,6,70000000,12877,10350,23227
9/20/2013 12:43,6,70000000,12918,9837,22755
9/20/2013 12:44,6,70000000,13985,10268,24253
9/20/2013 12:44,6,70000000,13495,10087,23582
9/20/2013 12:45,6,70000000,12868,9690,22558
9/20/2013 12:45,6,70000000,12932,9683,22615
9/20/2013 12:46,6,70000000,13153,10012,23165
9/20/2013 12:46,6,70000000,13415,9606,23021
9/20/2013 12:47,6,70000000,12688,9666,22354
9/20/2013 12:47,6,70000000,13270,9792,23062
9/20/2013 12:48,6,70000000,13148,10060,23208
9/20/2013 12:48,6,70000000,13045,10634,23679
9/20/2013 12:49,6,70000000,13432,9824,23256
9/20/2013 12:49,6,70000000,13206,9867,23073
9/20/2013 12:50,6,70000000,12676,10133,22809
9/20/2013 12:50,6,70000000,13368,9744,23112
9/20/2013 12:51,6,70000000,13272,9880,23152
9/20/2013 12:51,6,70000000,12792,9807,22599
9/20/2013 12:52,6,70000000,14011,9721,23732
9/20/2013 12:52,6,70000000,12987,9749,22736
9/20/2013 12:53,6,70000000,12657,10054,22711
9/20/2013 12:53,6,80000000,13359,11429,24788
9/20/2013 12:54,6,80000000,13950,10957,24907
9/20/2013 12:54,6,80000000,15309,10866,26175
9/20/2013 12:55,6,80000000,14356,11521,25877
9/20/2013 12:55,6,80000000,13196,11712,24908
9/20/2013 12:56,6,80000000,14495,10411,24906
9/20/2013 12:56,6,80000000,13872,11387,25259
9/20/2013 12:57,6,80000000,14254,11070,25324
9/20/2013 12:58,6,80000000,15696,11113,26809
9/20/2013 12:58,6,80000000,15242,11104,26346
9/20/2013 12:59,6,80000000,13210,11397,24607
9/20/2013 12:59,6,80000000,16437,11059,27496
9/20/2013 1:00,6,80000000,15082,10822,25904
9/20/2013 1:00,6,80000000,12835,11330,24165
9/20/2013 1:01,6,80000000,14687,10852,25539
9/20/2013 1:01,6,80000000,14757,10815,25572
9/20/2013 1:02,6,80000000,12520,11376,23896
9/20/2013 1:02,6,80000000,14638,11423,26061
9/20/2013 1:03,6,80000000,14117,11421,25538
9/20/2013 1:04,6,80000000,15349,10809,26158
9/20/2013 1:04,6,80000000,15523,10999,26522
9/20/2013 1:05,6,80000000,14065,11092,25157
9/20/2013 1:05,6,80000000,13751,11301,25052
9/20/2013 1:06,6,80000000,13858,11171,25029
9/20/2013 1:06,6,80000000,14268,10998,25266
9/20/2013 1:07,6,80000000,14499,10928,25427
9/20/2013 1:07,6,80000000,15147,10955,26102
9/20/2013 1:08,6,80000000,15134,10863,25997
9/20/2013 1:08,6,80000000,14498,10910,25408
9/20/2013 1:09,6,80000000,14841,11252,26093
9/20/2013 1:10,6,80000000,14503,10840,25343
9/20/2013 1:10,6,80000000,15575,10793,26368
9/20/2013 1:11,6,80000000,15354,11048,26402
9/20/2013 1:11,6,80000000,15133,10877,26010
9/20/2013 1:12,6,80000000,14565,11352,25917
9/20/2013 1:12,6,80000000,13636,11431,25067
9/20/2013 1:13,6,80000000,15277,11097,26374
9/20/2013 1:13,6,80000000,13594,11048,24642
9/20/2013 1:14,6,80000000,13948,10893,24841
9/20/2013 1:15,6,80000000,15300,11265,26565
9/20/2013 1:15,6,80000000,13601,11441,25042
9/20/2013 1:16,6,80000000,13389,11228,24617
9/20/2013 1:16,6,80000000,14333,11178,25511
9/20/2013 1:17,6,80000000,15358,10777,26135
9/20/2013 1:17,6,80000000,15492,11048,26540
9/20/2013 1:18,6,80000000,13640,11214,24854
9/20/2013 1:18,6,80000000,14733,11450,26183
9/20/2013 1:19,6,80000000,14740,10904,25644
9/20/2013 1:19,6,80000000,13869,11314,25183
9/20/2013 1:20,6,80000000,14539,11264,25803
9/20/2013 1:21,6,80000000,13858,11375,25233
9/20/2013 1:21,6,80000000,14421,11026,25447
9/20/2013 1:22,6,80000000,14031,10919,24950
9/20/2013 1:22,6,80000000,15993,10944,26937
9/20/2013 1:23,6,80000000,13084,11384,24468
9/20/2013 1:23,6,80000000,14498,10992,25490
9/20/2013 1:24,6,80000000,14787,11511,26298
9/20/2013 1:24,6,80000000,16008,11034,27042
9/20/2013 1:25,6,80000000,14149,11365,25514
9/20/2013 1:25,6,80000000,14057,11333,25390
9/20/2013 1:26,6,80000000,14169,11372,25541
9/20/2013 1:27,6,80000000,13800,11015,24815
9/20/2013 1:27,6,80000000,13986,10998,24984
9/20/2013 1:28,6,80000000,14906,10992,25898
9/20/2013 1:28,6,80000000,15130,11024,26154
9/20/2013 1:29,6,80000000,14100,10884,24984
9/20/2013 1:29,6,80000000,14483,10806,25289
9/20/2013 1:30,6,80000000,14093,10967,25060
9/20/2013 1:30,6,80000000,14991,10903,25894
9/20/2013 1:31,6,80000000,14358,11502,25860
9/20/2013 1:31,6,80000000,14642,11227,25869
9/20/2013 1:32,6,80000000,14894,11258,26152
9/20/2013 1:32,6,80000000,13396,10566,23962
9/20/2013 1:33,6,80000000,13684,11347,25031
9/20/2013 1:34,6,80000000,14283,11418,25701
9/20/2013 1:34,6,80000000,13511,11484,24995
9/20/2013 1:35,6,80000000,14834,10958,25792
9/20/2013 1:35,6,80000000,13568,11202,24770
9/20/2013 1:36,6,80000000,14528,11224,25752
9/20/2013 1:36,6,80000000,13536,10961,24497
9/20/2013 1:37,6,80000000,14668,11352,26020
9/20/2013 1:37,6,80000000,14446,10403,24849
9/20/2013 1:38,6,80000000,15810,11016,26826
9/20/2013 1:38,6,80000000,14484,11447,25931
9/20/2013 1:39,6,80000000,15063,10955,26018
9/20/2013 1:40,6,80000000,14598,11253,25851
9/20/2013 1:40,6,80000000,14565,11415,25980
9/20/2013 1:41,6,80000000,13621,11404,25025
9/20/2013 1:41,6,80000000,14275,11022,25297
9/20/2013 1:42,6,80000000,14193,11115,25308
9/20/2013 1:42,6,80000000,15261,11044,26305
9/20/2013 1:43,6,80000000,14016,10980,24996
9/20/2013 1:43,6,80000000,15569,11054,26623
9/20/2013 1:44,6,80000000,14561,10811,25372
9/20/2013 1:44,6,80000000,14929,10786,25715
9/20/2013 1:45,6,80000000,13836,11455,25291
9/20/2013 1:46,6,80000000,15256,11060,26316
9/20/2013 1:46,6,80000000,15149,11144,26293
9/20/2013 1:47,6,80000000,14457,10946,25403
9/20/2013 1:47,6,80000000,15182,10916,26098
9/20/2013 1:48,6,80000000,13396,11447,24843
9/20/2013 1:48,6,80000000,13954,11035,24989
9/20/2013 1:49,6,80000000,13804,11896,25700
9/20/2013 1:49,6,80000000,14575,10796,25371
9/20/2013 1:50,6,80000000,13523,10787,24310
9/20/2013 1:50,6,80000000,14407,11103,25510
9/20/2013 1:51,6,80000000,14346,12260,26606
9/20/2013 1:52,6,80000000,13185,10925,24110
9/20/2013 1:52,6,80000000,14675,11204,25879
9/20/2013 1:53,6,80000000,14383,11072,25455
9/20/2013 1:53,6,80000000,15090,11364,26454
9/20/2013 1:54,6,80000000,13840,10975,24815
9/20/2013 1:54,6,80000000,14903,11027,25930
9/20/2013 1:55,6,80000000,15208,12124,27332
9/20/2013 1:55,6,80000000,12876,11497,24373
9/20/2013 1:56,6,90000000,16400,12104,28504
9/20/2013 1:57,6,90000000,16752,12890,29642
9/20/2013 1:57,6,90000000,16270,12786,29056
9/20/2013 1:58,6,90000000,15870,12162,28032
9/20/2013 1:58,6,90000000,15631,12187,27818
9/20/2013 1:59,6,90000000,15428,12658,28086
9/20/2013 2:00,6,90000000,16585,12245,28830
9/20/2013 2:00,6,90000000,14933,12285,27218
9/20/2013 2:01,6,90000000,16467,12379,28846
9/20/2013 2:01,6,90000000,15627,12663,28290
9/20/2013 2:02,6,90000000,14528,12735,27263
9/20/2013 2:03,6,90000000,15587,12541,28128
9/20/2013 2:03,6,90000000,15782,12089,27871
9/20/2013 2:04,6,90000000,15725,12697,28422
9/20/2013 2:04,6,90000000,16243,12524,28767
9/20/2013 2:05,6,90000000,14687,12685,27372
9/20/2013 2:06,6,90000000,15987,12831,28818
9/20/2013 2:06,6,90000000,15834,12343,28177
9/20/2013 2:07,6,90000000,17068,12419,29487
9/20/2013 2:07,6,90000000,16470,12355,28825
9/20/2013 2:08,6,90000000,16858,13435,30293
9/20/2013 2:09,6,90000000,16641,12296,28937
9/20/2013 2:09,6,90000000,15926,12689,28615
9/20/2013 2:10,6,90000000,15428,12519,27947
9/20/2013 2:10,6,90000000,15020,12102,27122
9/20/2013 2:11,6,90000000,14924,12379,27303
9/20/2013 2:12,6,90000000,15021,12136,27157
9/20/2013 2:12,6,90000000,15094,12328,27422
9/20/2013 2:13,6,90000000,15838,12328,28166
9/20/2013 2:13,6,90000000,16535,12692,29227
9/20/2013 2:14,6,90000000,15697,12710,28407
9/20/2013 2:15,6,90000000,17635,12326,29961
9/20/2013 2:15,6,90000000,15188,12357,27545
9/20/2013 2:16,6,90000000,16116,12849,28965
9/20/2013 2:16,6,90000000,16679,12451,29130
9/20/2013 2:17,6,90000000,15960,12754,28714
9/20/2013 2:18,6,90000000,16027,12392,28419
9/20/2013 2:18,6,90000000,15739,12359,28098
9/20/2013 2:19,6,90000000,16166,12279,28445
9/20/2013 2:19,6,90000000,16199,12379,28578
9/20/2013 2:20,6,90000000,14625,12529,27154
9/20/2013 2:21,6,90000000,16271,12704,28975
9/20/2013 2:21,6,90000000,14885,12717,27602
9/20/2013 2:22,6,90000000,14927,12240,27167
9/20/2013 2:22,6,90000000,17296,12837,30133
9/20/2013 2:23,6,90000000,14361,12678,27039
9/20/2013 2:24,6,90000000,14806,12402,27208
9/20/2013 2:24,6,90000000,17312,12144,29456
9/20/2013 2:25,6,90000000,15848,12422,28270
9/20/2013 2:25,6,90000000,17126,12170,29296
9/20/2013 2:26,6,90000000,16682,12322,29004
9/20/2013 2:27,6,90000000,16730,12426,29156
9/20/2013 2:27,6,90000000,15102,12713,27815
9/20/2013 2:28,6,90000000,15688,12685,28373
9/20/2013 2:29,6,90000000,15888,12722,28610
9/20/2013 2:29,6,90000000,16570,12369,28939
9/20/2013 2:30,6,90000000,15407,12118,27525
9/20/2013 2:30,6,90000000,15298,12656,27954
9/20/2013 2:31,6,90000000,15630,12744,28374
9/20/2013 2:32,6,90000000,17012,12444,29456
9/20/2013 2:32,6,90000000,15550,12854,28404
9/20/2013 2:33,6,90000000,15788,12362,28150
9/20/2013 2:33,6,90000000,15164,12155,27319
9/20/2013 2:34,6,90000000,15641,12715,28356
9/20/2013 2:35,6,90000000,15082,12300,27382
9/20/2013 2:35,6,90000000,14760,12714,27474
9/20/2013 2:36,6,90000000,15714,12528,28242
9/20/2013 2:36,6,90000000,15693,12455,28148
9/20/2013 2:37,6,90000000,16394,12506,28900
9/20/2013 2:38,6,90000000,16347,13574,29921
9/20/2013 2:38,6,90000000,15271,12127,27398
9/20/2013 2:39,6,90000000,16035,12790,28825
9/20/2013 2:39,6,90000000,16929,12308,29237
9/20/2013 2:40,6,90000000,15939,12268,28207
9/20/2013 2:41,6,90000000,15276,12626,27902
9/20/2013 2:41,6,90000000,15399,12305,27704
9/20/2013 2:42,6,90000000,16315,12345,28660
9/20/2013 2:42,6,90000000,16420,12434,28854
9/20/2013 2:43,6,90000000,16275,12741,29016
9/20/2013 2:44,6,90000000,16088,12153,28241
9/20/2013 2:44,6,90000000,17073,12298,29371
9/20/2013 2:45,6,90000000,16618,12210,28828
9/20/2013 2:45,6,90000000,16548,12390,28938
9/20/2013 2:46,6,90000000,16644,12169,28813
9/20/2013 2:47,6,90000000,15296,12527,27823
9/20/2013 2:47,6,90000000,15001,12756,27757
9/20/2013 2:48,6,90000000,15055,12896,27951
9/20/2013 2:48,6,90000000,15659,12278,27937
9/20/2013 2:49,6,90000000,15443,12552,27995
9/20/2013 2:50,6,90000000,16409,12402,28811
9/20/2013 2:50,6,90000000,15397,12222,27619
9/20/2013 2:51,6,90000000,17079,12379,29458
9/20/2013 2:52,6,90000000,15791,16581,32372
9/20/2013 2:52,6,90000000,16634,12342,28976
9/20/2013 2:53,6,90000000,16623,12477,29100
9/20/2013 2:53,6,90000000,14823,12444,27267
9/20/2013 2:54,6,90000000,15333,12372,27705
9/20/2013 2:55,6,90000000,16018,12462,28480
9/20/2013 2:55,6,90000000,13699,13337,27036
9/20/2013 2:56,6,90000000,16013,12423,28436
9/20/2013 2:56,6,90000000,15925,12474,28399
9/20/2013 2:57,6,90000000,16186,12873,29059
9/20/2013 2:58,6,90000000,15067,12671,27738
9/20/2013 2:58,6,90000000,15268,12278,27546
9/20/2013 2:59,6,90000000,15739,12666,28405
9/20/2013 2:59,6,90000000,15639,12783,28422
9/20/2013 3:00,6,90000000,16388,12864,29252
9/20/2013 3:01,6,90000000,16855,12422,29277
9/20/2013 3:01,6,90000000,16434,12185,28619
9/20/2013 3:02,6,90000000,15690,12176,27866
9/20/2013 3:02,6,90000000,15719,12661,28380
9/20/2013 3:03,6,90000000,16782,12351,29133
9/20/2013 3:04,6,90000000,17266,12191,29457
9/20/2013 3:04,6,90000000,15260,12746,28006
9/20/2013 3:05,6,90000000,14025,12374,26399
9/20/2013 3:05,6,100000000,16636,14570,31206
9/20/2013 3:06,6,100000000,16638,14494,31132
9/20/2013 3:07,6,100000000,18057,14462,32519
9/20/2013 3:07,6,100000000,17249,15877,33126
9/20/2013 3:08,6,100000000,16414,15006,31420
9/20/2013 3:09,6,100000000,17687,14994,32681
9/20/2013 3:09,6,100000000,16978,15275,32253
9/20/2013 3:10,6,100000000,17535,14868,32403
9/20/2013 3:11,6,100000000,15782,15225,31007
9/20/2013 3:11,6,100000000,16614,14961,31575
9/20/2013 3:12,6,100000000,18537,14767,33304
9/20/2013 3:13,6,100000000,17843,14581,32424
9/20/2013 3:14,6,100000000,18317,14878,33195
9/20/2013 3:14,6,100000000,18535,14474,33009
9/20/2013 3:15,6,100000000,16540,14740,31280
9/20/2013 3:16,6,100000000,17882,15063,32945
9/20/2013 3:16,6,100000000,19264,15039,34303
9/20/2013 3:17,6,100000000,17044,14783,31827
9/20/2013 3:18,6,100000000,16409,14967,31376
9/20/2013 3:18,6,100000000,17709,14942,32651
9/20/2013 3:19,6,100000000,16994,15388,32382
9/20/2013 3:20,6,100000000,17396,14719,32115
9/20/2013 3:20,6,100000000,17273,14682,31955
9/20/2013 3:21,6,100000000,16973,15463,32436
9/20/2013 3:22,6,100000000,17483,15347,32830
9/20/2013 3:22,6,100000000,16629,14596,31225
9/20/2013 3:23,6,100000000,17255,15049,32304
9/20/2013 3:24,6,100000000,17098,15275,32373
9/20/2013 3:24,6,100000000,18022,14918,32940
9/20/2013 3:25,6,100000000,15982,15280,31262
9/20/2013 3:26,6,100000000,17332,14623,31955
9/20/2013 3:26,6,100000000,18022,16551,34573
9/20/2013 3:27,6,100000000,16282,15356,31638
9/20/2013 3:28,6,100000000,17623,14755,32378
9/20/2013 3:28,6,100000000,17239,14730,31969
9/20/2013 3:29,6,100000000,16545,15412,31957
9/20/2013 3:30,6,100000000,16508,19963,36471
9/20/2013 3:31,6,100000000,16302,14854,31156
9/20/2013 3:31,6,100000000,17289,15228,32517
9/20/2013 3:32,6,100000000,18029,14738,32767
9/20/2013 3:33,6,100000000,17069,14421,31490
9/20/2013 3:33,6,100000000,17509,14410,31919
9/20/2013 3:34,6,100000000,18304,14654,32958
9/20/2013 3:35,6,100000000,16993,14764,31757
9/20/2013 3:35,6,100000000,16200,15309,31509
9/20/2013 3:36,6,100000000,16819,15071,31890
9/20/2013 3:37,6,100000000,16790,14976,31766
9/20/2013 3:37,6,100000000,16997,15428,32425
9/20/2013 3:38,6,100000000,18645,15009,33654
9/20/2013 3:39,6,100000000,17918,14802,32720
9/20/2013 3:39,6,100000000,16640,15256,31896
9/20/2013 3:40,6,100000000,17510,14980,32490
9/20/2013 3:41,6,100000000,17942,15126,33068
9/20/2013 3:41,6,100000000,18110,16049,34159
9/20/2013 3:42,6,100000000,17454,14397,31851
9/20/2013 3:43,6,100000000,17334,14809,32143
9/20/2013 3:44,6,100000000,18090,14787,32877
9/20/2013 3:44,6,100000000,18650,14995,33645
9/20/2013 3:45,6,100000000,17527,15271,32798
9/20/2013 3:46,6,100000000,16932,14845,31777
9/20/2013 3:46,6,100000000,16197,15142,31339
9/20/2013 3:47,6,100000000,16626,15222,31848
9/20/2013 3:48,6,100000000,16795,15231,32026
9/20/2013 3:48,6,100000000,17886,15533,33419
9/20/2013 3:49,6,100000000,17627,15034,32661
9/20/2013 3:50,6,100000000,17932,15434,33366
9/20/2013 3:50,6,100000000,16632,14979,31611
9/20/2013 3:51,6,100000000,17572,14875,32447
9/20/2013 3:52,6,100000000,17289,14671,31960
9/20/2013 3:52,6,100000000,16986,14706,31692
9/20/2013 3:53,6,100000000,17575,14991,32566
9/20/2013 3:54,6,100000000,17457,14600,32057
9/20/2013 3:54,6,100000000,16099,15181,31280
9/20/2013 3:55,6,100000000,16556,15225,31781
9/20/2013 3:56,6,100000000,16415,14959,31374
9/20/2013 3:56,6,100000000,18217,15092,33309
9/20/2013 3:57,6,100000000,17945,14603,32548
9/20/2013 3:58,6,100000000,17448,14473,31921
9/20/2013 3:58,6,100000000,16808,14803,31611
9/20/2013 3:59,6,100000000,17830,15047,32877
9/20/2013 4:00,6,100000000,17209,14693,31902
9/20/2013 4:00,6,100000000,16386,15020,31406
9/20/2013 4:01,6,100000000,17638,15137,32775
9/20/2013 4:02,6,100000000,17412,15158,32570
9/20/2013 4:02,6,100000000,16783,15058,31841
9/20/2013 4:03,6,100000000,18004,14407,32411
9/20/2013 4:04,6,100000000,17657,15331,32988
9/20/2013 4:05,6,100000000,16864,14734,31598
9/20/2013 4:05,6,100000000,16225,15290,31515
9/20/2013 4:06,6,100000000,17854,15232,33086
9/20/2013 4:07,6,100000000,17389,15269,32658
9/20/2013 4:07,6,100000000,17092,14589,31681
9/20/2013 4:08,6,100000000,18109,15226,33335
9/20/2013 4:09,6,100000000,16700,15388,32088
9/20/2013 4:09,6,100000000,17151,14803,31954
9/20/2013 4:10,6,100000000,18573,14819,33392
9/20/2013 4:11,6,100000000,15999,14651,30650
9/20/2013 4:11,6,100000000,18351,14122,32473
9/20/2013 4:12,6,100000000,18306,14857,33163
9/20/2013 4:13,6,100000000,17344,14859,32203
9/20/2013 4:13,6,100000000,17049,15281,32330
9/20/2013 4:14,6,100000000,17222,14612,31834
9/20/2013 4:15,6,100000000,16100,15022,31122
9/20/2013 4:15,6,100000000,16787,15293,32080
9/20/2013 4:16,6,100000000,17774,14807,32581
9/20/2013 4:17,6,100000000,16655,15198,31853
9/20/2013 4:17,6,100000000,17474,15357,32831
9/20/2013 4:18,6,100000000,17827,14612,32439
9/20/2013 4:19,6,100000000,18223,15081,33304
9/20/2013 4:19,6,100000000,16196,16937,33133
9/20/2013 4:20,6,100000000,17663,14985,32648
9/20/2013 4:21,6,100000000,16825,14971,31796
9/20/2013 4:22,6,100000000,18283,15182,33465
9/20/2013 4:22,6,100000000,17140,14961,32101
9/20/2013 4:23,6,100000000,18264,14822,33086
9/20/2013 4:23,8,1000,51,26,77
9/20/2013 4:23,8,1000,21,27,48
9/20/2013 4:23,8,1000,22,28,50
9/20/2013 4:23,8,1000,23,29,52
9/20/2013 4:23,8,1000,20,25,45
9/20/2013 4:23,8,1000,19,25,44
9/20/2013 4:23,8,1000,21,29,50
9/20/2013 4:23,8,1000,25,25,50
9/20/2013 4:23,8,1000,26,25,51
9/20/2013 4:23,8,1000,19,24,43
9/20/2013 4:23,8,1000,24,25,49
9/20/2013 4:23,8,1000,21,26,47
9/20/2013 4:23,8,1000,19,26,45
9/20/2013 4:23,8,1000,25,25,50
9/20/2013 4:23,8,1000,19,30,49
9/20/2013 4:23,8,1000,20,26,46
9/20/2013 4:23,8,1000,21,25,46
9/20/2013 4:23,8,1000,20,25,45
9/20/2013 4:24,8,1000,18,27,45
9/20/2013 4:24,8,1000,25,26,51
9/20/2013 4:24,8,1000,21,27,48
9/20/2013 4:24,8,1000,23,25,48
9/20/2013 4:24,8,1000,21,24,45
9/20/2013 4:24,8,1000,20,29,49
9/20/2013 4:24,8,1000,21,25,46
9/20/2013 4:24,8,1000,27,25,52
9/20/2013 4:24,8,1000,23,28,51
9/20/2013 4:24,8,1000,21,29,50
9/20/2013 4:24,8,1000,22,28,50
9/20/2013 4:24,8,1000,21,29,50
9/20/2013 4:24,8,1000,20,28,48
9/20/2013 4:24,8,1000,21,26,47
9/20/2013 4:24,8,1000,25,24,49
9/20/2013 4:24,8,1000,23,26,49
9/20/2013 4:24,8,1000,20,27,47
9/20/2013 4:24,8,1000,25,25,50
9/20/2013 4:24,8,1000,28,26,54
9/20/2013 4:24,8,1000,22,28,50
9/20/2013 4:24,8,1000,19,25,44
9/20/2013 4:24,8,1000,26,25,51
9/20/2013 4:24,8,1000,54,27,81
9/20/2013 4:24,8,1000,19,25,44
9/20/2013 4:24,8,1000,20,26,46
9/20/2013 4:24,8,1000,20,27,47
9/20/2013 4:24,8,1000,22,27,49
9/20/2013 4:24,8,1000,23,29,52
9/20/2013 4:24,8,1000,52,27,79
9/20/2013 4:24,8,1000,23,26,49
9/20/2013 4:24,8,1000,18,25,43
9/20/2013 4:25,8,1000,21,26,47
9/20/2013 4:25,8,1000,25,25,50
9/20/2013 4:25,8,1000,21,28,49
9/20/2013 4:25,8,1000,20,25,45
9/20/2013 4:25,8,1000,24,25,49
9/20/2013 4:25,8,1000,21,29,50
9/20/2013 4:25,8,1000,18,25,43
9/20/2013 4:25,8,1000,20,26,46
9/20/2013 4:25,8,1000,21,28,49
9/20/2013 4:25,8,1000,20,27,47
9/20/2013 4:25,8,1000,27,25,52
9/20/2013 4:25,8,1000,23,26,49
9/20/2013 4:25,8,1000,23,29,52
9/20/2013 4:25,8,1000,17,25,42
9/20/2013 4:25,8,1000,21,24,45
9/20/2013 4:25,8,1000,19,27,46
9/20/2013 4:25,8,1000,25,25,50
9/20/2013 4:25,8,1000,21,25,46
9/20/2013 4:25,8,1000,18,25,43
9/20/2013 4:25,8,1000,18,25,43
9/20/2013 4:25,8,1000,22,28,50
9/20/2013 4:25,8,1000,21,28,49
9/20/2013 4:25,8,1000,22,25,47
9/20/2013 4:25,8,1000,24,25,49
9/20/2013 4:25,8,1000,21,26,47
9/20/2013 4:25,8,1000,17,25,42
9/20/2013 4:25,8,1000,20,29,49
9/20/2013 4:25,8,1000,23,25,48
9/20/2013 4:25,8,1000,19,25,44
9/20/2013 4:25,8,1000,19,25,44
9/20/2013 4:26,8,1000,22,29,51
9/20/2013 4:26,8,1000,20,31,51
9/20/2013 4:26,8,1000,19,26,45
9/20/2013 4:26,8,1000,18,25,43
9/20/2013 4:26,8,1000,19,28,47
9/20/2013 4:26,8,1000,18,25,43
9/20/2013 4:42,8,1000,20,28,48
9/20/2013 4:42,8,1000,20,25,45
9/20/2013 4:42,8,1000,52,26,78
9/20/2013 4:42,8,1000,20,29,49
9/20/2013 4:43,8,1000,25,27,52
9/20/2013 4:43,8,1000,25,25,50
9/20/2013 4:43,8,1000,22,29,51
9/20/2013 4:43,8,1000,25,25,50
9/20/2013 4:43,8,1000,25,27,52
9/20/2013 4:43,8,1000,21,27,48
9/20/2013 4:43,8,1000,24,25,49
9/20/2013 4:43,8,1000,27,26,53
9/20/2013 4:43,8,1000,21,28,49
9/20/2013 4:43,8,1000,22,26,48
9/20/2013 4:43,8,1000,19,25,44
9/20/2013 4:43,8,1000,24,25,49
9/20/2013 4:43,8,1000,19,25,44
9/20/2013 4:43,8,1000,22,25,47
9/20/2013 4:43,8,1000,20,27,47
9/20/2013 4:43,8,1000,18,24,42
9/20/2013 4:43,8,1000,22,27,49
9/20/2013 4:43,8,1000,20,30,50
9/20/2013 4:43,8,1000,21,30,51
9/20/2013 4:43,8,1000,22,25,47
9/20/2013 4:43,8,1000,23,28,51
9/20/2013 4:43,8,1000,17,25,42
9/20/2013 4:43,8,1000,19,26,45
9/20/2013 4:43,8,1000,18,25,43
9/20/2013 4:43,8,1000,22,29,51
9/20/2013 4:43,8,2000,20,40,60
9/20/2013 4:43,8,2000,25,35,60
9/20/2013 4:43,8,2000,29,38,67
9/20/2013 4:43,8,2000,21,35,56
9/20/2013 4:43,8,2000,18,37,55
9/20/2013 4:43,8,2000,20,38,58
9/20/2013 4:44,8,2000,33,39,72
9/20/2013 4:44,8,2000,25,35,60
9/20/2013 4:44,8,2000,19,36,55
9/20/2013 4:44,8,2000,21,37,58
9/20/2013 4:44,8,2000,21,39,60
9/20/2013 4:44,8,2000,20,38,58
9/20/2013 4:44,8,2000,20,35,55
9/20/2013 4:44,8,2000,21,36,57
9/20/2013 4:44,8,2000,24,39,63
9/20/2013 4:44,8,2000,20,35,55
9/20/2013 4:44,8,2000,21,35,56
9/20/2013 4:44,8,2000,18,37,55
9/20/2013 4:44,8,2000,23,39,62
9/20/2013 4:44,8,2000,18,36,54
9/20/2013 4:44,8,2000,21,35,56
9/20/2013 4:44,8,2000,23,36,59
9/20/2013 4:44,8,2000,20,37,57
9/20/2013 4:44,8,2000,21,38,59
9/20/2013 4:44,8,2000,21,36,57
9/20/2013 4:44,8,2000,26,36,62
9/20/2013 4:44,8,2000,19,35,54
9/20/2013 4:44,8,2000,22,39,61
9/20/2013 4:44,8,2000,23,35,58
9/20/2013 4:44,8,2000,19,35,54
9/20/2013 4:44,8,2000,19,37,56
9/20/2013 4:44,8,2000,26,35,61
9/20/2013 4:44,8,2000,19,39,58
9/20/2013 4:44,8,2000,25,35,60
9/20/2013 4:44,8,2000,22,39,61
9/20/2013 4:44,8,2000,19,35,54
9/20/2013 4:44,8,2000,24,38,62
9/20/2013 4:45,8,2000,26,35,61
9/20/2013 4:45,8,2000,19,36,55
9/20/2013 4:45,8,2000,22,36,58
9/20/2013 4:45,8,2000,23,40,63
9/20/2013 4:45,8,2000,22,36,58
9/20/2013 4:45,8,2000,19,36,55
9/20/2013 4:45,8,2000,23,39,62
9/20/2013 4:45,8,2000,24,38,62
9/20/2013 4:45,8,2000,19,37,56
9/20/2013 4:45,8,2000,24,36,60
9/20/2013 4:45,8,2000,21,36,57
9/20/2013 4:45,8,2000,21,37,58
9/20/2013 4:45,8,2000,23,36,59
9/20/2013 4:45,8,2000,22,39,61
9/20/2013 4:45,8,2000,25,36,61
9/20/2013 4:45,8,2000,24,36,60
9/20/2013 4:45,8,2000,24,36,60
9/20/2013 4:45,8,2000,25,35,60
9/20/2013 4:45,8,2000,24,35,59
9/20/2013 4:45,8,2000,22,38,60
9/20/2013 4:45,8,2000,25,36,61
9/20/2013 4:45,8,2000,27,35,62
9/20/2013 4:45,8,2000,24,35,59
9/20/2013 4:45,8,2000,20,35,55
9/20/2013 4:45,8,2000,19,36,55
9/20/2013 4:45,8,2000,24,35,59
9/20/2013 4:45,8,2000,23,39,62
9/20/2013 4:45,8,2000,21,36,57
9/20/2013 4:45,8,2000,21,35,56
9/20/2013 4:45,8,2000,22,35,57
9/20/2013 4:45,8,2000,21,36,57
9/20/2013 4:45,8,2000,24,38,62
9/20/2013 4:46,8,2000,23,35,58
9/20/2013 4:46,8,2000,25,35,60
9/20/2013 4:46,8,2000,22,36,58
9/20/2013 4:46,8,2000,25,35,60
9/20/2013 4:46,8,2000,21,36,57
9/20/2013 4:46,8,2000,24,35,59
9/20/2013 4:46,8,2000,24,38,62
9/20/2013 4:46,8,2000,25,35,60
9/20/2013 4:46,8,2000,24,39,63
9/20/2013 4:46,8,2000,21,38,59
9/20/2013 4:46,8,2000,24,35,59
9/20/2013 4:46,8,2000,23,39,62
9/20/2013 4:46,8,2000,20,36,56
9/20/2013 4:46,8,2000,25,36,61
9/20/2013 4:46,8,2000,23,36,59
9/20/2013 4:46,8,2000,26,35,61
9/20/2013 4:46,8,2000,22,36,58
9/20/2013 4:46,8,2000,22,39,61
9/20/2013 4:46,8,2000,21,36,57
9/20/2013 4:46,8,2000,22,36,58
9/20/2013 4:46,8,2000,21,43,64
9/20/2013 4:46,8,2000,27,37,64
9/20/2013 4:46,8,2000,24,35,59
9/20/2013 4:46,8,2000,21,36,57
9/20/2013 4:46,8,2000,22,39,61
9/20/2013 4:46,8,2000,25,35,60
9/20/2013 4:46,8,2000,24,38,62
9/20/2013 4:46,8,2000,22,36,58
9/20/2013 4:46,8,2000,20,36,56
9/20/2013 4:46,8,2000,26,35,61
9/20/2013 4:46,8,2000,27,36,63
9/20/2013 4:47,8,2000,21,39,60
9/20/2013 4:47,8,2000,24,38,62
9/20/2013 4:47,8,2000,23,36,59
9/20/2013 4:47,8,2000,19,38,57
9/20/2013 4:47,8,2000,20,36,56
9/20/2013 4:47,8,2000,23,38,61
9/20/2013 4:47,8,2000,19,38,57
9/20/2013 4:47,8,2000,20,36,56
9/20/2013 4:47,8,2000,20,36,56
9/20/2013 4:47,8,2000,24,35,59
9/20/2013 4:47,8,2000,24,36,60
9/20/2013 4:47,8,2000,20,35,55
9/20/2013 4:47,8,2000,21,35,56
9/20/2013 4:47,8,2000,27,35,62
9/20/2013 4:47,8,2000,20,40,60
9/20/2013 4:47,8,3000,25,43,68
9/20/2013 4:47,8,3000,20,45,65
9/20/2013 4:47,8,3000,25,47,72
9/20/2013 4:47,8,3000,24,45,69
9/20/2013 4:47,8,3000,27,44,71
9/20/2013 4:47,8,3000,25,43,68
9/20/2013 4:47,8,3000,21,43,64
9/20/2013 4:47,8,3000,24,48,72
9/20/2013 4:47,8,3000,23,49,72
9/20/2013 4:47,8,3000,22,47,69
9/20/2013 4:47,8,3000,22,44,66
9/20/2013 4:47,8,3000,26,46,72
9/20/2013 4:47,8,3000,21,43,64
9/20/2013 4:47,8,3000,24,44,68
9/20/2013 4:47,8,3000,24,47,71
9/20/2013 4:47,8,3000,25,44,69
9/20/2013 4:48,8,3000,21,44,65
9/20/2013 4:48,8,3000,20,44,64
9/20/2013 4:48,8,3000,22,44,66
9/20/2013 4:48,8,3000,23,45,68
9/20/2013 4:48,8,3000,23,43,66
9/20/2013 4:48,8,3000,21,45,66
9/20/2013 4:48,8,3000,23,46,69
9/20/2013 4:48,8,3000,27,43,70
9/20/2013 4:48,8,3000,20,44,64
9/20/2013 4:48,8,3000,20,44,64
9/20/2013 4:48,8,3000,19,44,63
9/20/2013 4:48,8,3000,22,44,66
9/20/2013 4:48,8,3000,31,49,80
9/20/2013 4:48,8,3000,22,43,65
9/20/2013 4:48,8,3000,23,46,69
9/20/2013 4:48,8,3000,21,44,65
9/20/2013 4:48,8,3000,26,48,74
9/20/2013 4:48,8,3000,25,44,69
9/20/2013 4:48,8,3000,22,47,69
9/20/2013 4:48,8,3000,19,46,65
9/20/2013 4:48,8,3000,26,45,71
9/20/2013 4:48,8,3000,25,43,68
9/20/2013 4:48,8,3000,22,44,66
9/20/2013 4:48,8,3000,27,44,71
9/20/2013 4:48,8,3000,24,48,72
9/20/2013 4:48,8,3000,19,44,63
9/20/2013 4:48,8,3000,24,48,72
9/20/2013 4:48,8,3000,22,46,68
9/20/2013 4:48,8,3000,21,44,65
9/20/2013 4:48,8,3000,20,44,64
9/20/2013 4:48,8,3000,19,43,62
9/20/2013 4:49,8,3000,25,45,70
9/20/2013 4:49,8,3000,22,44,66
9/20/2013 4:49,8,3000,21,44,65
9/20/2013 4:49,8,3000,22,44,66
9/20/2013 4:49,8,3000,24,49,73
9/20/2013 4:49,8,3000,24,45,69
9/20/2013 4:49,8,3000,19,44,63
9/20/2013 4:49,8,3000,20,44,64
9/20/2013 4:49,8,3000,25,48,73
9/20/2013 4:49,8,3000,23,49,72
9/20/2013 4:49,8,3000,19,43,62
9/20/2013 4:49,8,3000,21,46,67
9/20/2013 4:49,8,3000,22,44,66
9/20/2013 4:49,8,3000,21,44,65
9/20/2013 4:49,8,3000,23,44,67
9/20/2013 4:49,8,3000,22,45,67
9/20/2013 4:49,8,3000,24,44,68
9/20/2013 4:49,8,3000,23,46,69
9/20/2013 4:49,8,3000,24,47,71
9/20/2013 4:49,8,3000,23,44,67
9/20/2013 4:49,8,3000,22,45,67
9/20/2013 4:49,8,3000,22,51,73
9/20/2013 4:49,8,3000,19,44,63
9/20/2013 4:49,8,3000,20,45,65
9/20/2013 4:49,8,3000,26,44,70
9/20/2013 4:49,8,3000,24,50,74
9/20/2013 4:49,8,3000,25,44,69
9/20/2013 4:49,8,3000,25,45,70
9/20/2013 4:49,8,3000,19,44,63
9/20/2013 4:49,8,3000,25,46,71
9/20/2013 4:49,8,3000,20,44,64
9/20/2013 4:50,8,3000,19,45,64
9/20/2013 4:50,8,3000,21,44,65
9/20/2013 4:50,8,3000,19,44,63
9/20/2013 4:50,8,3000,24,45,69
9/20/2013 4:50,8,3000,22,46,68
9/20/2013 4:50,8,3000,20,44,64
9/20/2013 4:50,8,3000,22,45,67
9/20/2013 4:50,8,3000,22,46,68
9/20/2013 4:50,8,3000,24,44,68
9/20/2013 4:50,8,3000,21,43,64
9/20/2013 4:50,8,3000,19,45,64
9/20/2013 4:50,8,3000,22,48,70
9/20/2013 4:50,8,3000,21,44,65
9/20/2013 4:50,8,3000,22,45,67
9/20/2013 4:50,8,3000,21,44,65
9/20/2013 4:50,8,3000,24,47,71
9/20/2013 4:50,8,3000,26,44,70
9/20/2013 4:50,8,3000,24,44,68
9/20/2013 4:50,8,3000,22,44,66
9/20/2013 4:50,8,3000,20,44,64
9/20/2013 4:50,8,3000,21,45,66
9/20/2013 4:50,8,3000,22,44,66
9/20/2013 4:50,8,3000,20,44,64
9/20/2013 4:50,8,3000,22,44,66
9/20/2013 4:50,8,3000,26,45,71
9/20/2013 4:50,8,3000,18,44,62
9/20/2013 4:50,8,3000,25,43,68
9/20/2013 4:50,8,3000,22,44,66
9/20/2013 4:50,8,3000,22,44,66
9/20/2013 4:50,8,3000,21,46,67
9/20/2013 4:50,8,3000,23,43,66
9/20/2013 4:51,8,3000,25,46,71
9/20/2013 4:51,8,3000,23,48,71
9/20/2013 4:51,8,3000,21,44,65
9/20/2013 4:51,8,3000,25,44,69
9/20/2013 4:51,8,3000,22,45,67
9/20/2013 4:51,8,3000,28,44,72
9/20/2013 4:51,8,4000,24,50,74
9/20/2013 4:51,8,4000,23,50,73
9/20/2013 4:51,8,4000,21,50,71
9/20/2013 4:51,8,4000,23,50,73
9/20/2013 4:51,8,4000,24,51,75
9/20/2013 4:51,8,4000,22,52,74
9/20/2013 4:51,8,4000,26,50,76
9/20/2013 4:51,8,4000,22,50,72
9/20/2013 4:51,8,4000,22,50,72
9/20/2013 4:51,8,4000,29,50,79
9/20/2013 4:51,8,4000,23,53,76
9/20/2013 4:51,8,4000,21,50,71
9/20/2013 4:51,8,4000,23,53,76
9/20/2013 4:51,8,4000,22,52,74
9/20/2013 4:51,8,4000,23,51,74
9/20/2013 4:51,8,4000,25,51,76
9/20/2013 4:51,8,4000,26,50,76
9/20/2013 4:51,8,4000,25,52,77
9/20/2013 5:08,8,4000,23,50,73
9/20/2013 5:08,8,4000,24,56,80
9/20/2013 5:08,8,4000,22,48,70
9/20/2013 5:08,8,4000,27,50,77
9/20/2013 5:08,8,4000,28,49,77
9/20/2013 5:08,8,4000,23,51,74
9/20/2013 5:08,8,4000,20,49,69
9/20/2013 5:08,8,4000,24,56,80
9/20/2013 5:08,8,4000,31,49,80
9/20/2013 5:08,8,4000,23,50,73
9/20/2013 5:08,8,4000,26,50,76
9/20/2013 5:08,8,4000,21,52,73
9/20/2013 5:08,8,4000,23,50,73
9/20/2013 5:08,8,4000,22,53,75
9/20/2013 5:08,8,4000,23,57,80
9/20/2013 5:08,8,4000,23,51,74
9/20/2013 5:08,8,4000,26,50,76
9/20/2013 5:09,8,4000,23,53,76
9/20/2013 5:09,8,4000,26,50,76
9/20/2013 5:09,8,4000,26,53,79
9/20/2013 5:09,8,4000,19,51,70
9/20/2013 5:09,8,4000,21,49,70
9/20/2013 5:09,8,4000,21,50,71
9/20/2013 5:09,8,4000,22,51,73
9/20/2013 5:09,8,4000,20,51,71
9/20/2013 5:09,8,4000,22,50,72
9/20/2013 5:09,8,4000,23,54,77
9/20/2013 5:09,8,4000,24,50,74
9/20/2013 5:09,8,4000,25,51,76
9/20/2013 5:09,8,4000,28,49,77
9/20/2013 5:09,8,4000,28,51,79
9/20/2013 5:09,8,4000,22,50,72
9/20/2013 5:09,8,4000,26,50,76
9/20/2013 5:09,8,4000,22,50,72
9/20/2013 5:09,8,4000,25,50,75
9/20/2013 5:09,8,4000,22,50,72
9/20/2013 5:09,8,4000,22,49,71
9/20/2013 5:09,8,4000,30,50,80
9/20/2013 5:09,8,4000,26,52,78
9/20/2013 5:09,8,4000,23,51,74
9/20/2013 5:09,8,4000,23,52,75
9/20/2013 5:09,8,4000,21,51,72
9/20/2013 5:09,8,4000,23,50,73
9/20/2013 5:09,8,4000,27,50,77
9/20/2013 5:09,8,4000,27,50,77
9/20/2013 5:09,8,4000,21,50,71
9/20/2013 5:09,8,4000,22,50,72
9/20/2013 5:09,8,4000,23,51,74
9/20/2013 5:10,8,4000,21,49,70
9/20/2013 5:10,8,4000,21,50,71
9/20/2013 5:10,8,4000,22,50,72
9/20/2013 5:10,8,4000,22,49,71
9/20/2013 5:10,8,4000,35,53,88
9/20/2013 5:10,8,4000,30,53,83
9/20/2013 5:10,8,4000,24,50,74
9/20/2013 5:10,8,4000,23,50,73
9/20/2013 5:10,8,4000,26,50,76
9/20/2013 5:10,8,4000,24,50,74
9/20/2013 5:10,8,4000,23,51,74
9/20/2013 5:10,8,4000,21,49,70
9/20/2013 5:10,8,4000,27,49,76
9/20/2013 5:10,8,4000,25,56,81
9/20/2013 5:10,8,4000,24,52,76
9/20/2013 5:10,8,4000,25,50,75
9/20/2013 5:10,8,4000,23,51,74
9/20/2013 5:10,8,4000,22,52,74
9/20/2013 5:10,8,4000,25,50,75
9/20/2013 5:10,8,4000,30,51,81
9/20/2013 5:10,8,4000,23,49,72
9/20/2013 5:10,8,4000,23,50,73
9/20/2013 5:10,8,4000,26,49,75
9/20/2013 5:10,8,4000,33,49,82
9/20/2013 5:10,8,4000,23,51,74
9/20/2013 5:10,8,4000,20,51,71
9/20/2013 5:10,8,4000,23,53,76
9/20/2013 5:10,8,4000,25,50,75
9/20/2013 5:10,8,4000,21,49,70
9/20/2013 5:10,8,4000,29,50,79
9/20/2013 5:11,8,4000,25,51,76
9/20/2013 5:11,8,4000,27,49,76
9/20/2013 5:11,8,4000,27,50,77
9/20/2013 5:11,8,4000,20,52,72
9/20/2013 5:11,8,4000,28,49,77
9/20/2013 5:11,8,4000,20,50,70
9/20/2013 5:11,8,4000,22,50,72
9/20/2013 5:11,8,4000,26,52,78
9/20/2013 5:11,8,4000,25,50,75
9/20/2013 5:11,8,4000,23,49,72
9/20/2013 5:11,8,4000,25,50,75
9/20/2013 5:11,8,4000,22,49,71
9/20/2013 5:11,8,4000,32,50,82
9/20/2013 5:11,8,4000,22,55,77
9/20/2013 5:11,8,4000,22,49,71
9/20/2013 5:11,8,4000,28,51,79
9/20/2013 5:11,8,4000,28,49,77
9/20/2013 5:11,8,4000,23,48,71
9/20/2013 5:11,8,5000,26,55,81
9/20/2013 5:11,8,5000,26,55,81
9/20/2013 5:11,8,5000,24,55,79
9/20/2013 5:11,8,5000,28,55,83
9/20/2013 5:11,8,5000,24,54,78
9/20/2013 5:11,8,5000,22,57,79
9/20/2013 5:11,8,5000,21,56,77
9/20/2013 5:11,8,5000,24,56,80
9/20/2013 5:11,8,5000,30,53,83
9/20/2013 5:11,8,5000,23,55,78
9/20/2013 5:11,8,5000,23,54,77
9/20/2013 5:11,8,5000,23,57,80
9/20/2013 5:11,8,5000,23,54,77
9/20/2013 5:12,8,5000,22,57,79
9/20/2013 5:12,8,5000,22,54,76
9/20/2013 5:12,8,5000,31,53,84
9/20/2013 5:12,8,5000,26,54,80
9/20/2013 5:12,8,5000,22,55,77
9/20/2013 5:12,8,5000,22,55,77
9/20/2013 5:12,8,5000,25,55,80
9/20/2013 5:12,8,5000,27,55,82
9/20/2013 5:12,8,5000,24,54,78
9/20/2013 5:12,8,5000,26,54,80
9/20/2013 5:12,8,5000,23,54,77
9/20/2013 5:12,8,5000,26,54,80
9/20/2013 5:12,8,5000,26,55,81
9/20/2013 5:12,8,5000,27,54,81
9/20/2013 5:12,8,5000,23,53,76
9/20/2013 5:12,8,5000,30,55,85
9/20/2013 5:12,8,5000,24,54,78
9/20/2013 5:12,8,5000,25,58,83
9/20/2013 5:12,8,5000,24,58,82
9/20/2013 5:12,8,5000,22,53,75
9/20/2013 5:12,8,5000,24,57,81
9/20/2013 5:12,8,5000,26,59,85
9/20/2013 5:12,8,5000,24,55,79
9/20/2013 5:12,8,5000,21,54,75
9/20/2013 5:12,8,5000,28,54,82
9/20/2013 5:12,8,5000,25,56,81
9/20/2013 5:12,8,5000,23,53,76
9/20/2013 5:12,8,5000,22,55,77
9/20/2013 5:12,8,5000,24,54,78
9/20/2013 5:12,8,5000,27,55,82
9/20/2013 5:12,8,5000,30,56,86
9/20/2013 5:13,8,5000,22,57,79
9/20/2013 5:13,8,5000,25,55,80
9/20/2013 5:13,8,5000,25,54,79
9/20/2013 5:13,8,5000,29,56,85
9/20/2013 5:13,8,5000,24,57,81
9/20/2013 5:13,8,5000,29,54,83
9/20/2013 5:13,8,5000,25,54,79
9/20/2013 5:13,8,5000,22,54,76
9/20/2013 5:13,8,5000,24,54,78
9/20/2013 5:13,8,5000,23,54,77
9/20/2013 5:13,8,5000,22,53,75
9/20/2013 5:13,8,5000,20,54,74
9/20/2013 5:13,8,5000,26,52,78
9/20/2013 5:13,8,5000,25,55,80
9/20/2013 5:13,8,5000,24,56,80
9/20/2013 5:13,8,5000,22,56,78
9/20/2013 5:13,8,5000,23,53,76
9/20/2013 5:13,8,5000,24,55,79
9/20/2013 5:13,8,5000,23,54,77
9/20/2013 5:13,8,5000,28,55,83
9/20/2013 5:13,8,5000,22,55,77
9/20/2013 5:13,8,5000,25,54,79
9/20/2013 5:13,8,5000,26,56,82
9/20/2013 5:13,8,5000,21,55,76
9/20/2013 5:13,8,5000,23,54,77
9/20/2013 5:13,8,5000,24,53,77
9/20/2013 5:13,8,5000,25,54,79
9/20/2013 5:13,8,5000,29,54,83
9/20/2013 5:13,8,5000,24,57,81
9/20/2013 5:13,8,5000,24,55,79
9/20/2013 5:13,8,5000,30,53,83
9/20/2013 5:14,8,5000,33,55,88
9/20/2013 5:30,8,5000,21,54,75
9/20/2013 5:30,8,5000,25,55,80
9/20/2013 5:30,8,5000,25,55,80
9/20/2013 5:30,8,5000,22,55,77
9/20/2013 5:30,8,5000,23,53,76
9/20/2013 5:30,8,5000,26,56,82
9/20/2013 5:30,8,5000,24,54,78
9/20/2013 5:30,8,5000,26,58,84
9/20/2013 5:30,8,5000,29,54,83
9/20/2013 5:31,8,5000,24,54,78
9/20/2013 5:31,8,5000,22,58,80
9/20/2013 5:31,8,5000,23,55,78
9/20/2013 5:31,8,5000,23,55,78
9/20/2013 5:31,8,5000,27,54,81
9/20/2013 5:31,8,5000,26,54,80
9/20/2013 5:31,8,5000,22,53,75
9/20/2013 5:31,8,5000,23,55,78
9/20/2013 5:31,8,5000,26,60,86
9/20/2013 5:31,8,5000,25,54,79
9/20/2013 5:31,8,5000,24,54,78
9/20/2013 5:31,8,5000,26,56,82
9/20/2013 5:31,8,5000,24,54,78
9/20/2013 5:31,8,5000,28,54,82
9/20/2013 5:31,8,5000,24,54,78
9/20/2013 5:31,8,5000,29,53,82
9/20/2013 5:31,8,5000,22,54,76
9/20/2013 5:31,8,5000,23,53,76
9/20/2013 5:31,8,5000,23,54,77
9/20/2013 5:31,8,5000,25,58,83
9/20/2013 5:31,8,5000,30,53,83
9/20/2013 5:31,8,5000,24,54,78
9/20/2013 5:31,8,5000,23,57,80
9/20/2013 5:31,8,5000,23,56,79
9/20/2013 5:31,8,5000,24,55,79
9/20/2013 5:31,8,5000,22,54,76
9/20/2013 5:31,8,5000,23,57,80
9/20/2013 5:31,8,5000,23,55,78
9/20/2013 5:31,8,5000,26,56,82
9/20/2013 5:31,8,6000,22,58,80
9/20/2013 5:31,8,6000,27,58,85
9/20/2013 5:32,8,6000,24,58,82
9/20/2013 5:32,8,6000,34,62,96
9/20/2013 5:32,8,6000,24,58,82
9/20/2013 5:32,8,6000,29,59,88
9/20/2013 5:32,8,6000,23,58,81
9/20/2013 5:32,8,6000,29,58,87
9/20/2013 5:32,8,6000,29,63,92
9/20/2013 5:32,8,6000,32,59,91
9/20/2013 5:32,8,6000,24,59,83
9/20/2013 5:32,8,6000,24,57,81
9/20/2013 5:32,8,6000,23,59,82
9/20/2013 5:32,8,6000,25,58,83
9/20/2013 5:32,8,6000,23,58,81
9/20/2013 5:32,8,6000,25,59,84
9/20/2013 5:32,8,6000,26,59,85
9/20/2013 5:32,8,6000,26,60,86
9/20/2013 5:32,8,6000,24,59,83
9/20/2013 5:32,8,6000,25,59,84
9/20/2013 5:32,8,6000,30,58,88
9/20/2013 5:32,8,6000,23,58,81
9/20/2013 5:32,8,6000,23,59,82
9/20/2013 5:32,8,6000,26,59,85
9/20/2013 5:32,8,6000,25,59,84
9/20/2013 5:32,8,6000,24,59,83
9/20/2013 5:32,8,6000,24,59,83
9/20/2013 5:32,8,6000,28,59,87
9/20/2013 5:32,8,6000,29,61,90
9/20/2013 5:32,8,6000,24,59,83
9/20/2013 5:32,8,6000,27,57,84
9/20/2013 5:32,8,6000,25,58,83
9/20/2013 5:32,8,6000,24,59,83
9/20/2013 5:33,8,6000,26,57,83
9/20/2013 5:33,8,6000,24,59,83
9/20/2013 5:33,8,6000,24,58,82
9/20/2013 5:33,8,6000,24,58,82
9/20/2013 5:33,8,6000,31,58,89
9/20/2013 5:33,8,6000,24,59,83
9/20/2013 5:33,8,6000,26,60,86
9/20/2013 5:33,8,6000,23,58,81
9/20/2013 5:33,8,6000,24,61,85
9/20/2013 5:33,8,6000,24,59,83
9/20/2013 5:33,8,6000,27,60,87
9/20/2013 5:33,8,6000,27,58,85
9/20/2013 5:33,8,6000,28,58,86
9/20/2013 5:33,8,6000,30,58,88
9/20/2013 5:33,8,6000,26,58,84
9/20/2013 5:33,8,6000,28,58,86
9/20/2013 5:33,8,6000,27,60,87
9/20/2013 5:33,8,6000,30,57,87
9/20/2013 5:33,8,6000,27,57,84
9/20/2013 5:33,8,6000,28,58,86
9/20/2013 5:33,8,6000,29,61,90
9/20/2013 5:33,8,6000,27,63,90
9/20/2013 5:33,8,6000,39,64,103
9/20/2013 5:33,8,6000,29,59,88
9/20/2013 5:33,8,6000,28,61,89
9/20/2013 5:33,8,6000,23,59,82
9/20/2013 5:33,8,6000,25,59,84
9/20/2013 5:33,8,6000,31,58,89
9/20/2013 5:33,8,6000,29,62,91
9/20/2013 5:33,8,6000,33,59,92
9/20/2013 5:34,8,6000,27,60,87
9/20/2013 5:34,8,6000,31,57,88
9/20/2013 5:34,8,6000,26,60,86
9/20/2013 5:34,8,6000,27,59,86
9/20/2013 5:34,8,6000,28,59,87
9/20/2013 5:34,8,6000,26,59,85
9/20/2013 5:34,8,6000,33,58,91
9/20/2013 5:34,8,6000,26,64,90
9/20/2013 5:34,8,6000,26,60,86
9/20/2013 5:34,8,6000,23,59,82
9/20/2013 5:34,8,6000,31,58,89
9/20/2013 5:34,8,6000,26,59,85
9/20/2013 5:34,8,6000,25,60,85
9/20/2013 5:34,8,6000,28,58,86
9/20/2013 5:34,8,6000,33,59,92
9/20/2013 5:34,8,6000,22,59,81
9/20/2013 5:34,8,6000,30,58,88
9/20/2013 5:34,8,6000,23,60,83
9/20/2013 5:34,8,6000,29,59,88
9/20/2013 5:34,8,6000,23,59,82
9/20/2013 5:34,8,6000,25,64,89
9/20/2013 5:34,8,6000,27,60,87
9/20/2013 5:34,8,6000,23,59,82
9/20/2013 5:34,8,6000,28,58,86
9/20/2013 5:34,8,6000,25,58,83
9/20/2013 5:34,8,6000,26,59,85
9/20/2013 5:34,8,6000,26,58,84
9/20/2013 5:34,8,6000,29,58,87
9/20/2013 5:34,8,6000,27,60,87
9/20/2013 5:34,8,6000,23,58,81
9/20/2013 5:34,8,6000,35,58,93
9/20/2013 5:35,8,6000,23,58,81
9/20/2013 5:35,8,6000,25,59,84
9/20/2013 5:35,8,6000,27,58,85
9/20/2013 5:35,8,6000,22,58,80
9/20/2013 5:35,8,6000,24,58,82
9/20/2013 5:35,8,6000,23,59,82
9/20/2013 5:35,8,6000,31,59,90
9/20/2013 5:35,8,6000,25,60,85
9/20/2013 5:35,8,6000,29,58,87
9/20/2013 5:35,8,6000,24,60,84
9/20/2013 5:35,8,6000,25,59,84
9/20/2013 5:35,8,6000,23,59,82
9/20/2013 5:35,8,6000,24,59,83
9/20/2013 5:35,8,6000,26,58,84
9/20/2013 5:35,8,6000,28,58,86
9/20/2013 5:35,8,6000,28,60,88
9/20/2013 5:35,8,6000,25,59,84
9/20/2013 5:35,8,6000,30,60,90
9/20/2013 5:35,8,6000,29,58,87
9/20/2013 5:35,8,6000,28,63,91
9/20/2013 5:35,8,6000,25,62,87
9/20/2013 5:35,8,7000,26,62,88
9/20/2013 5:35,8,7000,26,60,86
9/20/2013 5:35,8,7000,24,61,85
9/20/2013 5:35,8,7000,26,61,87
9/20/2013 5:35,8,7000,35,63,98
9/20/2013 5:35,8,7000,33,62,95
9/20/2013 5:35,8,7000,26,62,88
9/20/2013 5:35,8,7000,27,62,89
9/20/2013 5:35,8,7000,29,61,90
9/20/2013 5:35,8,7000,24,59,83
9/20/2013 5:36,8,7000,32,64,96
9/20/2013 5:36,8,7000,24,63,87
9/20/2013 5:36,8,7000,24,61,85
9/20/2013 5:36,8,7000,25,62,87
9/20/2013 5:36,8,7000,26,60,86
9/20/2013 5:36,8,7000,26,62,88
9/20/2013 5:36,8,7000,25,60,85
9/20/2013 5:36,8,7000,25,63,88
9/20/2013 5:36,8,7000,32,61,93
9/20/2013 5:36,8,7000,24,60,84
9/20/2013 5:36,8,7000,32,63,95
9/20/2013 5:36,8,7000,24,62,86
9/20/2013 5:36,8,7000,24,62,86
9/20/2013 5:36,8,7000,28,63,91
9/20/2013 5:36,8,7000,31,63,94
9/20/2013 5:36,8,7000,25,62,87
9/20/2013 5:36,8,7000,25,61,86
9/20/2013 5:36,8,7000,33,63,96
9/20/2013 5:36,8,7000,32,64,96
9/20/2013 5:36,8,7000,31,63,94
9/20/2013 5:36,8,7000,31,60,91
9/20/2013 5:36,8,7000,25,63,88
9/20/2013 5:36,8,7000,27,64,91
9/20/2013 5:36,8,7000,25,62,87
9/20/2013 5:36,8,7000,25,64,89
9/20/2013 5:36,8,7000,28,64,92
9/20/2013 5:36,8,7000,30,62,92
9/20/2013 5:36,8,7000,26,64,90
9/20/2013 5:36,8,7000,29,64,93
9/20/2013 5:36,8,7000,26,62,88
9/20/2013 5:36,8,7000,27,63,90
9/20/2013 5:37,8,7000,27,60,87
9/20/2013 5:37,8,7000,26,61,87
9/20/2013 5:37,8,7000,26,61,87
9/20/2013 5:37,8,7000,25,62,87
9/20/2013 5:37,8,7000,1015,64,1079
9/20/2013 5:37,8,7000,26,65,91
9/20/2013 5:37,8,7000,27,61,88
9/20/2013 5:37,8,7000,26,62,88
9/20/2013 5:37,8,7000,24,60,84
9/20/2013 5:37,8,7000,25,61,86
9/20/2013 5:37,8,7000,30,63,93
9/20/2013 5:37,8,7000,26,60,86
9/20/2013 5:37,8,7000,32,61,93
9/20/2013 5:37,8,7000,25,62,87
9/20/2013 5:37,8,7000,26,62,88
9/20/2013 5:37,8,7000,29,63,92
9/20/2013 5:37,8,7000,34,62,96
9/20/2013 5:37,8,7000,27,63,90
9/20/2013 5:37,8,7000,30,62,92
9/20/2013 5:37,8,7000,24,61,85
9/20/2013 5:37,8,7000,26,61,87
9/20/2013 5:37,8,7000,27,63,90
9/20/2013 5:37,8,7000,28,64,92
9/20/2013 5:37,8,7000,24,60,84
9/20/2013 5:37,8,7000,28,61,89
9/20/2013 5:37,8,7000,33,62,95
9/20/2013 5:37,8,7000,25,62,87
9/20/2013 5:37,8,7000,24,62,86
9/20/2013 5:37,8,7000,24,63,87
9/20/2013 5:38,8,7000,27,66,93
9/20/2013 5:38,8,7000,26,61,87
9/20/2013 5:38,8,7000,31,59,90
9/20/2013 5:38,8,7000,24,61,85
9/20/2013 5:38,8,7000,26,61,87
9/20/2013 5:38,8,7000,28,61,89
9/20/2013 5:38,8,7000,30,62,92
9/20/2013 5:38,8,7000,27,63,90
9/20/2013 5:38,8,7000,25,62,87
9/20/2013 5:38,8,7000,31,59,90
9/20/2013 5:38,8,7000,26,62,88
9/20/2013 5:38,8,7000,31,60,91
9/20/2013 5:38,8,7000,30,61,91
9/20/2013 5:38,8,7000,26,61,87
9/20/2013 5:38,8,7000,27,62,89
9/20/2013 5:38,8,7000,24,63,87
9/20/2013 5:38,8,7000,26,62,88
9/20/2013 5:38,8,7000,26,62,88
9/20/2013 5:38,8,7000,30,63,93
9/20/2013 5:38,8,7000,27,62,89
9/20/2013 5:38,8,7000,34,61,95
9/20/2013 5:38,8,7000,26,63,89
9/20/2013 5:38,8,7000,32,62,94
9/20/2013 5:38,8,7000,26,63,89
9/20/2013 5:38,8,7000,27,62,89
9/20/2013 5:38,8,7000,25,63,88
9/20/2013 5:38,8,7000,30,62,92
9/20/2013 5:38,8,7000,32,60,92
9/20/2013 5:38,8,7000,32,63,95
9/20/2013 5:38,8,7000,33,62,95
9/20/2013 5:38,8,7000,24,62,86
9/20/2013 5:39,8,7000,25,63,88
9/20/2013 5:39,8,7000,28,63,91
9/20/2013 5:39,8,7000,26,61,87
9/20/2013 5:39,8,7000,25,67,92
9/20/2013 5:39,8,7000,1016,66,1082
9/20/2013 5:39,8,7000,24,62,86
9/20/2013 5:39,8,7000,27,62,89
9/20/2013 5:39,8,7000,35,62,97
9/20/2013 5:39,8,7000,26,63,89
9/20/2013 5:39,8,7000,31,61,92
9/20/2013 5:39,8,7000,26,63,89
9/20/2013 5:39,8,7000,33,63,96
9/20/2013 5:39,8,7000,24,64,88
9/20/2013 5:39,8,7000,27,61,88
9/20/2013 5:39,8,8000,28,61,89
9/20/2013 5:39,8,8000,32,61,93
9/20/2013 5:39,8,8000,28,61,89
9/20/2013 5:39,8,8000,27,65,92
9/20/2013 5:39,8,8000,26,63,89
9/20/2013 5:39,8,8000,29,61,90
9/20/2013 5:39,8,8000,27,70,97
9/20/2013 5:39,8,8000,28,61,89
9/20/2013 5:39,8,8000,25,67,92
9/20/2013 5:39,8,8000,31,60,91
9/20/2013 5:39,8,8000,27,62,89
9/20/2013 5:39,8,8000,30,61,91
9/20/2013 5:39,8,8000,28,61,89
9/20/2013 5:39,8,8000,26,61,87
9/20/2013 5:39,8,8000,33,64,97
9/20/2013 5:39,8,8000,31,64,95
9/20/2013 5:40,8,8000,28,64,92
9/20/2013 5:40,8,8000,33,65,98
9/20/2013 5:40,8,8000,28,63,91
9/20/2013 5:40,8,8000,32,65,97
9/20/2013 5:40,8,8000,28,67,95
9/20/2013 5:40,8,8000,27,66,93
9/20/2013 5:40,8,8000,29,64,93
9/20/2013 5:40,8,8000,32,63,95
9/20/2013 5:40,8,8000,31,68,99
9/20/2013 5:40,8,8000,27,64,91
9/20/2013 5:40,8,8000,33,61,94
9/20/2013 5:40,8,8000,30,66,96
9/20/2013 5:40,8,8000,26,64,90
9/20/2013 5:40,8,8000,26,63,89
9/20/2013 5:40,8,8000,27,61,88
9/20/2013 5:40,8,8000,35,62,97
9/20/2013 5:40,8,8000,25,61,86
9/20/2013 5:40,8,8000,28,62,90
9/20/2013 5:40,8,8000,26,64,90
9/20/2013 5:40,8,8000,27,61,88
9/20/2013 5:40,8,8000,27,63,90
9/20/2013 5:40,8,8000,24,61,85
9/20/2013 5:40,8,8000,30,61,91
9/20/2013 5:40,8,8000,26,63,89
9/20/2013 5:40,8,8000,26,62,88
9/20/2013 5:40,8,8000,28,62,90
9/20/2013 5:40,8,8000,31,64,95
9/20/2013 5:40,8,8000,27,62,89
9/20/2013 5:40,8,8000,28,60,88
9/20/2013 5:40,8,8000,29,66,95
9/20/2013 5:41,8,8000,30,64,94
9/20/2013 5:41,8,8000,26,67,93
9/20/2013 5:41,8,8000,33,63,96
9/20/2013 5:41,8,8000,28,65,93
9/20/2013 5:41,8,8000,26,61,87
9/20/2013 5:41,8,8000,28,63,91
9/20/2013 5:41,8,8000,26,63,89
9/20/2013 5:41,8,8000,58,68,126
9/20/2013 5:41,8,8000,26,62,88
9/20/2013 5:41,8,8000,33,61,94
9/20/2013 5:41,8,8000,28,65,93
9/20/2013 5:41,8,8000,27,60,87
9/20/2013 5:41,8,8000,30,63,93
9/20/2013 5:41,8,8000,28,62,90
9/20/2013 5:41,8,8000,25,61,86
9/20/2013 5:41,8,8000,27,65,92
9/20/2013 5:41,8,8000,30,62,92
9/20/2013 5:41,8,8000,27,61,88
9/20/2013 5:41,8,8000,28,62,90
9/20/2013 5:41,8,8000,31,68,99
9/20/2013 5:41,8,8000,28,61,89
9/20/2013 5:41,8,8000,26,62,88
9/20/2013 5:41,8,8000,29,61,90
9/20/2013 5:41,8,8000,31,68,99
9/20/2013 5:41,8,8000,27,66,93
9/20/2013 5:41,8,8000,29,62,91
9/20/2013 5:41,8,8000,32,61,93
9/20/2013 5:41,8,8000,26,61,87
9/20/2013 5:41,8,8000,28,65,93
9/20/2013 5:41,8,8000,28,62,90
9/20/2013 5:42,8,8000,27,66,93
9/20/2013 5:42,8,8000,29,61,90
9/20/2013 5:42,8,8000,31,66,97
9/20/2013 5:42,8,8000,29,64,93
9/20/2013 5:42,8,8000,32,67,99
9/20/2013 5:42,8,8000,26,62,88
9/20/2013 5:42,8,8000,58,65,123
9/20/2013 5:42,8,8000,27,64,91
9/20/2013 5:42,8,8000,29,62,91
9/20/2013 5:42,8,8000,29,68,97
9/20/2013 5:42,8,8000,31,64,95
9/20/2013 5:42,8,8000,25,65,90
9/20/2013 5:42,8,8000,26,63,89
9/20/2013 5:42,8,8000,27,61,88
9/20/2013 5:42,8,8000,27,62,89
9/20/2013 5:42,8,8000,27,63,90
9/20/2013 5:42,8,8000,32,64,96
9/20/2013 5:42,8,8000,28,61,89
9/20/2013 5:42,8,8000,29,67,96
9/20/2013 5:42,8,8000,28,67,95
9/20/2013 5:42,8,8000,26,62,88
9/20/2013 5:42,8,8000,28,62,90
9/20/2013 5:42,8,8000,28,62,90
9/20/2013 5:42,8,8000,26,67,93
9/20/2013 5:42,8,8000,31,68,99
9/20/2013 5:42,8,8000,31,61,92
9/20/2013 5:42,8,8000,26,63,89
9/20/2013 5:42,8,8000,30,63,93
9/20/2013 5:42,8,8000,27,64,91
9/20/2013 5:42,8,8000,28,70,98
9/20/2013 5:42,8,8000,27,64,91
9/20/2013 5:43,8,8000,32,63,95
9/20/2013 5:43,8,8000,25,66,91
9/20/2013 5:43,8,8000,35,61,96
9/20/2013 5:43,8,8000,29,65,94
9/20/2013 5:43,8,8000,25,68,93
9/20/2013 5:43,8,8000,27,61,88
9/20/2013 5:43,8,8000,25,61,86
9/20/2013 5:43,8,8000,25,62,87
9/20/2013 5:43,8,9000,26,61,87
9/20/2013 5:43,8,9000,28,63,91
9/20/2013 5:43,8,9000,30,67,97
9/20/2013 5:43,8,9000,29,62,91
9/20/2013 5:43,8,9000,26,65,91
9/20/2013 5:43,8,9000,27,70,97
9/20/2013 5:43,8,9000,31,68,99
9/20/2013 5:43,8,9000,32,63,95
9/20/2013 5:43,8,9000,27,61,88
9/20/2013 5:43,8,9000,31,62,93
9/20/2013 5:43,8,9000,26,63,89
9/20/2013 5:43,8,9000,26,65,91
9/20/2013 5:43,8,9000,33,64,97
9/20/2013 5:43,8,9000,29,61,90
9/20/2013 5:43,8,9000,27,65,92
9/20/2013 5:43,8,9000,28,62,90
9/20/2013 5:43,8,9000,33,64,97
9/20/2013 5:43,8,9000,28,60,88
9/20/2013 5:43,8,9000,36,67,103
9/20/2013 5:43,8,9000,28,62,90
9/20/2013 5:43,8,9000,28,61,89
9/20/2013 5:43,8,9000,32,65,97
9/20/2013 5:44,8,9000,32,62,94
9/20/2013 5:44,8,9000,26,64,90
9/20/2013 5:44,8,9000,30,63,93
9/20/2013 5:44,8,9000,26,65,91
9/20/2013 5:44,8,9000,29,64,93
9/20/2013 5:44,8,9000,30,61,91
9/20/2013 5:44,8,9000,36,66,102
9/20/2013 5:44,8,9000,36,67,103
9/20/2013 5:44,8,9000,31,67,98
9/20/2013 5:44,8,9000,29,61,90
9/20/2013 5:44,8,9000,28,68,96
9/20/2013 5:44,8,9000,29,64,93
9/20/2013 5:44,8,9000,26,64,90
9/20/2013 5:44,8,9000,30,65,95
9/20/2013 5:44,8,9000,32,70,102
9/20/2013 5:44,8,9000,32,68,100
9/20/2013 5:44,8,9000,30,65,95
9/20/2013 5:44,8,9000,32,63,95
9/20/2013 5:44,8,9000,29,61,90
9/20/2013 5:44,8,9000,26,64,90
9/20/2013 5:44,8,9000,29,61,90
9/20/2013 5:44,8,9000,29,69,98
9/20/2013 5:44,8,9000,31,70,101
9/20/2013 5:44,8,9000,31,60,91
9/20/2013 5:44,8,9000,29,62,91
9/20/2013 5:44,8,9000,30,62,92
9/20/2013 5:44,8,9000,28,63,91
9/20/2013 5:44,8,9000,29,67,96
9/20/2013 5:44,8,9000,30,68,98
9/20/2013 5:44,8,9000,28,64,92
9/20/2013 5:44,8,9000,27,65,92
9/20/2013 5:45,8,9000,29,64,93
9/20/2013 5:45,8,9000,31,62,93
9/20/2013 5:45,8,9000,31,63,94
9/20/2013 5:45,8,9000,29,61,90
9/20/2013 5:45,8,9000,30,63,93
9/20/2013 5:45,8,9000,28,63,91
9/20/2013 5:45,8,9000,28,63,91
9/20/2013 5:45,8,9000,30,68,98
9/20/2013 5:45,8,9000,27,61,88
9/20/2013 5:45,8,9000,28,61,89
9/20/2013 5:45,8,9000,25,64,89
9/20/2013 5:45,8,9000,28,67,95
9/20/2013 5:45,8,9000,33,68,101
9/20/2013 5:45,8,9000,29,62,91
9/20/2013 5:45,8,9000,34,65,99
9/20/2013 5:45,8,9000,30,63,93
9/20/2013 5:45,8,9000,32,64,96
9/20/2013 5:45,8,9000,28,62,90
9/20/2013 5:45,8,9000,30,63,93
9/20/2013 5:45,8,9000,29,62,91
9/20/2013 5:45,8,9000,27,61,88
9/20/2013 5:45,8,9000,28,63,91
9/20/2013 5:45,8,9000,34,64,98
9/20/2013 5:45,8,9000,28,67,95
9/20/2013 5:45,8,9000,26,61,87
9/20/2013 5:45,8,9000,28,65,93
9/20/2013 5:45,8,9000,33,60,93
9/20/2013 5:45,8,9000,28,61,89
9/20/2013 5:45,8,9000,29,63,92
9/20/2013 5:45,8,9000,28,63,91
9/20/2013 5:45,8,9000,32,63,95
9/20/2013 5:46,8,9000,28,63,91
9/20/2013 5:46,8,9000,30,65,95
9/20/2013 5:46,8,9000,29,67,96
9/20/2013 5:46,8,9000,34,62,96
9/20/2013 5:46,8,9000,28,61,89
9/20/2013 5:46,8,9000,31,64,95
9/20/2013 5:46,8,9000,29,64,93
9/20/2013 5:46,8,9000,26,63,89
9/20/2013 5:46,8,9000,1027,67,1094
9/20/2013 5:46,8,9000,30,63,93
9/20/2013 5:46,8,9000,32,70,102
9/20/2013 5:46,8,9000,32,62,94
9/20/2013 5:46,8,9000,32,62,94
9/20/2013 5:46,8,9000,29,66,95
9/20/2013 5:46,8,9000,27,64,91
9/20/2013 5:46,8,9000,29,64,93
9/20/2013 5:46,8,9000,26,63,89
9/20/2013 5:46,8,9000,28,65,93
9/20/2013 5:46,8,9000,38,65,103
9/20/2013 5:46,8,9000,37,67,104
9/20/2013 5:46,8,9000,27,68,95
9/20/2013 5:46,8,9000,33,67,100
9/20/2013 5:46,8,9000,27,64,91
9/20/2013 5:46,8,9000,26,63,89
9/20/2013 5:46,8,9000,28,62,90
9/20/2013 5:46,8,9000,30,62,92
9/20/2013 5:46,8,9000,30,68,98
9/20/2013 5:46,8,9000,24,62,86
9/20/2013 5:46,8,9000,35,64,99
9/20/2013 5:46,8,9000,26,63,89
9/20/2013 5:47,8,9000,34,63,97
9/20/2013 5:47,8,10000,28,63,91
9/20/2013 5:47,8,10000,29,61,90
9/20/2013 5:47,8,10000,30,64,94
9/20/2013 5:47,8,10000,34,65,99
9/20/2013 5:47,8,10000,28,64,92
9/20/2013 5:47,8,10000,36,63,99
9/20/2013 5:47,8,10000,30,61,91
9/20/2013 5:47,8,10000,35,68,103
9/20/2013 5:47,8,10000,34,64,98
9/20/2013 5:47,8,10000,30,61,91
9/20/2013 5:47,8,10000,28,64,92
9/20/2013 5:47,8,10000,30,65,95
9/20/2013 5:47,8,10000,28,68,96
9/20/2013 5:47,8,10000,27,65,92
9/20/2013 5:47,8,10000,31,65,96
9/20/2013 5:47,8,10000,34,66,100
9/20/2013 5:47,8,10000,35,62,97
9/20/2013 5:47,8,10000,30,62,92
9/20/2013 5:47,8,10000,28,63,91
9/20/2013 5:47,8,10000,29,61,90
9/20/2013 5:47,8,10000,27,64,91
9/20/2013 5:47,8,10000,30,64,94
9/20/2013 5:47,8,10000,32,70,102
9/20/2013 5:47,8,10000,36,65,101
9/20/2013 5:47,8,10000,36,64,100
9/20/2013 5:47,8,10000,28,70,98
9/20/2013 5:47,8,10000,30,63,93
9/20/2013 5:47,8,10000,29,64,93
9/20/2013 5:47,8,10000,29,63,92
9/20/2013 5:48,8,10000,1026,71,1097
9/20/2013 5:48,8,10000,31,65,96
9/20/2013 5:48,8,10000,31,67,98
9/20/2013 5:48,8,10000,31,62,93
9/20/2013 5:48,8,10000,29,65,94
9/20/2013 5:48,8,10000,35,63,98
9/20/2013 5:48,8,10000,1022,67,1089
9/20/2013 5:48,8,10000,29,65,94
9/20/2013 5:48,8,10000,30,67,97
9/20/2013 5:48,8,10000,31,65,96
9/20/2013 5:48,8,10000,32,65,97
9/20/2013 5:48,8,10000,29,64,93
9/20/2013 5:48,8,10000,30,66,96
9/20/2013 5:48,8,10000,32,70,102
9/20/2013 5:48,8,10000,28,63,91
9/20/2013 5:48,8,10000,27,61,88
9/20/2013 5:48,8,10000,37,63,100
9/20/2013 5:48,8,10000,29,62,91
9/20/2013 5:48,8,10000,27,63,90
9/20/2013 5:48,8,10000,28,69,97
9/20/2013 5:48,8,10000,29,65,94
9/20/2013 5:48,8,10000,31,67,98
9/20/2013 5:48,8,10000,29,65,94
9/20/2013 5:48,8,10000,30,60,90
9/20/2013 5:48,8,10000,28,62,90
9/20/2013 5:48,8,10000,30,62,92
9/20/2013 5:48,8,10000,30,66,96
9/20/2013 5:48,8,10000,29,65,94
9/20/2013 5:48,8,10000,28,61,89
9/20/2013 5:48,8,10000,30,65,95
9/20/2013 5:49,8,10000,34,64,98
9/20/2013 5:49,8,10000,30,63,93
9/20/2013 5:49,8,10000,30,63,93
9/20/2013 5:49,8,10000,30,61,91
9/20/2013 5:49,8,10000,30,67,97
9/20/2013 5:49,8,10000,31,62,93
9/20/2013 5:49,8,10000,32,61,93
9/20/2013 5:49,8,10000,30,65,95
9/20/2013 5:49,8,10000,34,68,102
9/20/2013 5:49,8,10000,29,63,92
9/20/2013 5:49,8,10000,29,70,99
9/20/2013 5:49,8,10000,30,62,92
9/20/2013 5:49,8,10000,31,69,100
9/20/2013 5:49,8,10000,29,66,95
9/20/2013 5:49,8,10000,30,62,92
9/20/2013 5:49,8,10000,29,70,99
9/20/2013 5:49,8,10000,37,62,99
9/20/2013 5:49,8,10000,27,65,92
9/20/2013 5:49,8,10000,29,66,95
9/20/2013 5:49,8,10000,31,68,99
9/20/2013 5:49,8,10000,29,66,95
9/20/2013 5:49,8,10000,35,61,96
9/20/2013 5:49,8,10000,30,67,97
9/20/2013 5:49,8,10000,30,63,93
9/20/2013 5:49,8,10000,33,62,95
9/20/2013 5:49,8,10000,32,65,97
9/20/2013 5:49,8,10000,30,63,93
9/20/2013 5:49,8,10000,30,60,90
9/20/2013 5:49,8,10000,31,67,98
9/20/2013 5:49,8,10000,29,68,97
9/20/2013 5:50,8,10000,31,62,93
9/20/2013 5:50,8,10000,29,63,92
9/20/2013 5:50,8,10000,30,64,94
9/20/2013 5:50,8,10000,28,67,95
9/20/2013 5:50,8,10000,27,63,90
9/20/2013 5:50,8,10000,35,66,101
9/20/2013 5:50,8,10000,32,62,94
9/20/2013 5:50,8,10000,27,61,88
9/20/2013 5:50,8,10000,30,62,92
9/20/2013 5:50,8,10000,31,62,93
9/20/2013 5:50,8,10000,34,70,104
9/20/2013 5:50,8,10000,27,63,90
9/20/2013 5:50,8,10000,30,64,94
9/20/2013 5:50,8,10000,29,69,98
9/20/2013 5:50,8,10000,30,62,92
9/20/2013 5:50,8,10000,30,68,98
9/20/2013 5:50,8,10000,28,65,93
9/20/2013 5:50,8,10000,28,64,92
9/20/2013 5:50,8,10000,29,64,93
9/20/2013 5:50,8,10000,29,65,94
9/20/2013 5:50,8,10000,29,62,91
9/20/2013 5:50,8,10000,31,64,95
9/20/2013 5:50,8,10000,32,67,99
9/20/2013 6:07,8,10000,34,63,97
9/20/2013 6:07,8,10000,31,67,98
9/20/2013 6:07,8,10000,33,68,101
9/20/2013 6:07,8,10000,36,62,98
9/20/2013 6:07,8,10000,32,68,100
9/20/2013 6:07,8,10000,27,62,89
9/20/2013 6:07,8,10000,31,61,92
9/20/2013 6:07,8,10000,30,62,92
9/20/2013 6:07,8,10000,30,64,94
9/20/2013 6:07,8,10000,28,64,92
9/20/2013 6:07,8,10000,30,66,96
9/20/2013 6:07,8,10000,31,64,95
9/20/2013 6:07,8,10000,30,68,98
9/20/2013 6:07,8,10000,28,65,93
9/20/2013 6:07,8,10000,1028,65,1093
9/20/2013 6:07,8,10000,30,70,100
9/20/2013 6:08,8,10000,28,65,93
9/20/2013 6:08,8,10000,30,64,94
9/20/2013 6:08,8,10000,29,66,95
9/20/2013 6:08,8,10000,29,60,89
9/20/2013 6:08,8,10000,58,65,123
9/20/2013 6:08,8,10000,29,63,92
9/20/2013 6:08,8,10000,28,64,92
9/20/2013 6:08,8,10000,32,65,97
9/20/2013 6:08,8,10000,34,62,96
9/20/2013 6:08,8,10000,33,64,97
9/20/2013 6:08,8,10000,31,62,93
9/20/2013 6:08,8,10000,30,61,91
9/20/2013 6:08,8,10000,27,64,91
9/20/2013 6:08,8,10000,28,62,90
9/20/2013 6:08,8,10000,31,62,93
9/20/2013 6:08,8,10000,35,63,98
9/20/2013 6:08,8,10000,30,64,94
9/20/2013 6:08,8,10000,30,63,93
9/20/2013 6:08,8,10000,30,63,93
9/20/2013 6:08,8,10000,29,67,96
9/20/2013 6:08,8,10000,30,63,93
9/20/2013 6:08,8,10000,29,63,92
9/20/2013 6:08,8,10000,35,62,97
9/20/2013 6:08,8,10000,29,61,90
9/20/2013 6:08,8,10000,39,66,105
9/20/2013 6:08,8,10000,35,61,96
9/20/2013 6:08,8,10000,32,64,96
9/20/2013 6:08,8,10000,28,63,91
9/20/2013 6:08,8,10000,31,64,95
9/20/2013 6:08,8,10000,28,66,94
9/20/2013 6:08,8,10000,29,62,91
9/20/2013 6:09,8,10000,31,63,94
9/20/2013 6:09,8,10000,28,63,91
9/20/2013 6:09,8,10000,32,64,96
9/20/2013 6:09,8,10000,27,61,88
9/20/2013 6:09,8,10000,29,63,92
9/20/2013 6:09,8,10000,32,67,99
9/20/2013 6:09,8,10000,29,65,94
9/20/2013 6:09,8,10000,29,68,97
9/20/2013 6:09,8,10000,30,63,93
9/20/2013 6:09,8,10000,30,62,92
9/20/2013 6:09,8,10000,28,65,93
9/20/2013 6:09,8,10000,30,64,94
9/20/2013 6:09,8,10000,27,64,91
9/20/2013 6:09,8,10000,29,62,91
9/20/2013 6:09,8,10000,32,64,96
9/20/2013 6:09,8,10000,32,70,102
9/20/2013 6:09,8,10000,29,65,94
9/20/2013 6:09,8,10000,35,65,100
9/20/2013 6:09,8,10000,30,60,90
9/20/2013 6:09,8,10000,32,61,93
9/20/2013 6:09,8,10000,29,68,97
9/20/2013 6:09,8,10000,30,68,98
9/20/2013 6:09,8,10000,30,64,94
9/20/2013 6:09,8,10000,38,65,103
9/20/2013 6:09,8,10000,30,63,93
9/20/2013 6:09,8,10000,28,63,91
9/20/2013 6:09,8,10000,30,63,93
9/20/2013 6:09,8,10000,27,63,90
9/20/2013 6:09,8,10000,31,68,99
9/20/2013 6:09,8,10000,29,64,93
9/20/2013 6:10,8,10000,30,63,93
9/20/2013 6:10,8,10000,31,63,94
9/20/2013 6:10,8,10000,29,62,91
9/20/2013 6:10,8,10000,28,64,92
9/20/2013 6:10,8,10000,34,61,95
9/20/2013 6:10,8,10000,33,65,98
9/20/2013 6:10,8,10000,31,61,92
9/20/2013 6:10,8,10000,28,63,91
9/20/2013 6:10,8,10000,34,70,104
9/20/2013 6:10,8,10000,28,64,92
9/20/2013 6:10,8,10000,30,63,93
9/20/2013 6:10,8,10000,31,62,93
9/20/2013 6:10,8,10000,30,62,92
9/20/2013 6:10,8,10000,35,62,97
9/20/2013 6:10,8,10000,36,61,97
9/20/2013 6:10,8,10000,36,61,97
9/20/2013 6:10,8,10000,34,64,98
9/20/2013 6:10,8,10000,31,62,93
9/20/2013 6:10,8,10000,30,63,93
9/20/2013 6:10,8,10000,30,64,94
9/20/2013 6:10,8,10000,29,62,91
9/20/2013 6:10,8,10000,30,64,94
9/20/2013 6:10,8,10000,27,70,97
9/20/2013 6:10,8,10000,29,68,97
9/20/2013 6:10,8,10000,32,64,96
9/20/2013 6:10,8,10000,27,62,89
9/20/2013 6:10,8,10000,30,62,92
9/20/2013 6:10,8,10000,29,61,90
9/20/2013 6:10,8,10000,30,63,93
9/20/2013 6:10,8,10000,33,66,99
9/20/2013 6:10,8,10000,35,60,95
9/20/2013 6:11,8,10000,30,62,92
9/20/2013 6:11,8,10000,29,63,92
9/20/2013 6:11,8,10000,30,65,95
9/20/2013 6:11,8,10000,28,63,91
9/20/2013 6:11,8,10000,30,62,92
9/20/2013 6:11,8,10000,29,63,92
9/20/2013 6:11,8,10000,29,62,91
9/20/2013 6:11,8,10000,31,64,95
9/20/2013 6:11,8,10000,30,65,95
9/20/2013 6:11,8,20000,43,72,115
9/20/2013 6:11,8,20000,39,65,104
9/20/2013 6:11,8,20000,38,64,102
9/20/2013 6:11,8,20000,39,66,105
9/20/2013 6:11,8,20000,36,69,105
9/20/2013 6:11,8,20000,40,66,106
9/20/2013 6:11,8,20000,42,70,112
9/20/2013 6:11,8,20000,41,64,105
9/20/2013 6:11,8,20000,40,68,108
9/20/2013 6:11,8,20000,37,65,102
9/20/2013 6:11,8,20000,40,64,104
9/20/2013 6:11,8,20000,38,64,102
9/20/2013 6:11,8,20000,46,62,108
9/20/2013 6:11,8,20000,39,63,102
9/20/2013 6:11,8,20000,38,62,100
9/20/2013 6:11,8,20000,41,68,109
9/20/2013 6:11,8,20000,38,64,102
9/20/2013 6:11,8,20000,40,64,104
9/20/2013 6:11,8,20000,43,64,107
9/20/2013 6:11,8,20000,42,70,112
9/20/2013 6:11,8,20000,39,63,102
9/20/2013 6:12,8,20000,37,63,100
9/20/2013 6:12,8,20000,44,69,113
9/20/2013 6:12,8,20000,45,65,110
9/20/2013 6:12,8,20000,37,68,105
9/20/2013 6:12,8,20000,39,66,105
9/20/2013 6:12,8,20000,38,71,109
9/20/2013 6:12,8,20000,38,70,108
9/20/2013 6:12,8,20000,44,68,112
9/20/2013 6:12,8,20000,39,63,102
9/20/2013 6:12,8,20000,45,68,113
9/20/2013 6:12,8,20000,38,62,100
9/20/2013 6:12,8,20000,38,64,102
9/20/2013 6:12,8,20000,37,66,103
9/20/2013 6:12,8,20000,37,63,100
9/20/2013 6:12,8,20000,45,67,112
9/20/2013 6:12,8,20000,40,66,106
9/20/2013 6:12,8,20000,38,67,105
9/20/2013 6:12,8,20000,37,63,100
9/20/2013 6:12,8,20000,34,66,100
9/20/2013 6:12,8,20000,39,65,104
9/20/2013 6:12,8,20000,42,66,108
9/20/2013 6:12,8,20000,40,75,115
9/20/2013 6:12,8,20000,44,65,109
9/20/2013 6:12,8,20000,37,65,102
9/20/2013 6:12,8,20000,37,67,104
9/20/2013 6:12,8,20000,51,65,116
9/20/2013 6:12,8,20000,37,68,105
9/20/2013 6:12,8,20000,44,66,110
9/20/2013 6:12,8,20000,37,64,101
9/20/2013 6:12,8,20000,36,69,105
9/20/2013 6:12,8,20000,47,73,120
9/20/2013 6:13,8,20000,37,63,100
9/20/2013 6:13,8,20000,37,66,103
9/20/2013 6:13,8,20000,47,68,115
9/20/2013 6:13,8,20000,40,65,105
9/20/2013 6:13,8,20000,39,66,105
9/20/2013 6:13,8,20000,37,68,105
9/20/2013 6:13,8,20000,39,63,102
9/20/2013 6:13,8,20000,41,69,110
9/20/2013 6:13,8,20000,40,72,112
9/20/2013 6:13,8,20000,37,66,103
9/20/2013 6:13,8,20000,38,66,104
9/20/2013 6:13,8,20000,42,68,110
9/20/2013 6:13,8,20000,36,67,103
9/20/2013 6:13,8,20000,35,65,100
9/20/2013 6:13,8,20000,40,65,105
9/20/2013 6:13,8,20000,42,69,111
9/20/2013 6:13,8,20000,41,70,111
9/20/2013 6:13,8,20000,40,65,105
9/20/2013 6:13,8,20000,44,67,111
9/20/2013 6:13,8,20000,42,71,113
9/20/2013 6:13,8,20000,41,64,105
9/20/2013 6:13,8,20000,41,65,106
9/20/2013 6:13,8,20000,44,68,112
9/20/2013 6:13,8,20000,42,69,111
9/20/2013 6:13,8,20000,37,67,104
9/20/2013 6:13,8,20000,37,65,102
9/20/2013 6:13,8,20000,44,72,116
9/20/2013 6:13,8,20000,40,68,108
9/20/2013 6:13,8,20000,39,69,108
9/20/2013 6:14,8,20000,1035,70,1105
9/20/2013 6:14,8,20000,39,66,105
9/20/2013 6:14,8,20000,39,65,104
9/20/2013 6:14,8,20000,43,68,111
9/20/2013 6:14,8,20000,39,74,113
9/20/2013 6:14,8,20000,37,64,101
9/20/2013 6:14,8,20000,39,67,106
9/20/2013 6:14,8,20000,39,66,105
9/20/2013 6:14,8,20000,36,62,98
9/20/2013 6:14,8,20000,37,68,105
9/20/2013 6:14,8,20000,38,64,102
9/20/2013 6:14,8,20000,38,64,102
9/20/2013 6:14,8,20000,44,67,111
9/20/2013 6:14,8,20000,40,68,108
9/20/2013 6:14,8,20000,36,69,105
9/20/2013 6:14,8,20000,47,63,110
9/20/2013 6:14,8,20000,35,66,101
9/20/2013 6:14,8,20000,37,66,103
9/20/2013 6:14,8,20000,41,69,110
9/20/2013 6:14,8,20000,38,66,104
9/20/2013 6:14,8,20000,42,69,111
9/20/2013 6:14,8,20000,39,64,103
9/20/2013 6:14,8,20000,37,65,102
9/20/2013 6:14,8,20000,38,67,105
9/20/2013 6:14,8,20000,1030,71,1101
9/20/2013 6:14,8,20000,45,65,110
9/20/2013 6:14,8,20000,41,64,105
9/20/2013 6:14,8,20000,45,71,116
9/20/2013 6:14,8,20000,38,66,104
9/20/2013 6:15,8,20000,46,64,110
9/20/2013 6:15,8,20000,39,65,104
9/20/2013 6:15,8,20000,38,64,102
9/20/2013 6:15,8,20000,41,65,106
9/20/2013 6:15,8,20000,40,67,107
9/20/2013 6:15,8,30000,42,70,112
9/20/2013 6:15,8,30000,45,70,115
9/20/2013 6:15,8,30000,41,75,116
9/20/2013 6:15,8,30000,51,71,122
9/20/2013 6:15,8,30000,41,69,110
9/20/2013 6:15,8,30000,41,69,110
9/20/2013 6:15,8,30000,46,69,115
9/20/2013 6:15,8,30000,48,71,119
9/20/2013 6:15,8,30000,49,71,120
9/20/2013 6:15,8,30000,42,72,114
9/20/2013 6:15,8,30000,45,73,118
9/20/2013 6:15,8,30000,42,71,113
9/20/2013 6:15,8,30000,45,70,115
9/20/2013 6:15,8,30000,44,72,116
9/20/2013 6:15,8,30000,45,74,119
9/20/2013 6:15,8,30000,40,75,115
9/20/2013 6:15,8,30000,44,70,114
9/20/2013 6:15,8,30000,59,72,131
9/20/2013 6:15,8,30000,43,73,116
9/20/2013 6:15,8,30000,39,68,107
9/20/2013 6:15,8,30000,43,74,117
9/20/2013 6:15,8,30000,50,73,123
9/20/2013 6:15,8,30000,46,74,120
9/20/2013 6:15,8,30000,42,70,112
9/20/2013 6:15,8,30000,41,71,112
9/20/2013 6:16,8,30000,46,73,119
9/20/2013 6:16,8,30000,48,73,121
9/20/2013 6:16,8,30000,38,71,109
9/20/2013 6:16,8,30000,46,78,124
9/20/2013 6:16,8,30000,41,76,117
9/20/2013 6:16,8,30000,39,79,118
9/20/2013 6:16,8,30000,44,71,115
9/20/2013 6:16,8,30000,48,71,119
9/20/2013 6:16,8,30000,42,79,121
9/20/2013 6:16,8,30000,54,77,131
9/20/2013 6:16,8,30000,44,74,118
9/20/2013 6:16,8,30000,40,71,111
9/20/2013 6:16,8,30000,40,73,113
9/20/2013 6:16,8,30000,44,71,115
9/20/2013 6:16,8,30000,43,72,115
9/20/2013 6:16,8,30000,53,71,124
9/20/2013 6:16,8,30000,40,71,111
9/20/2013 6:16,8,30000,43,73,116
9/20/2013 6:16,8,30000,58,79,137
9/20/2013 6:16,8,30000,45,73,118
9/20/2013 6:16,8,30000,42,73,115
9/20/2013 6:16,8,30000,40,70,110
9/20/2013 6:16,8,30000,42,68,110
9/20/2013 6:16,8,30000,40,71,111
9/20/2013 6:16,8,30000,55,72,127
9/20/2013 6:16,8,30000,39,69,108
9/20/2013 6:16,8,30000,43,68,111
9/20/2013 6:16,8,30000,48,70,118
9/20/2013 6:16,8,30000,46,73,119
9/20/2013 6:16,8,30000,41,72,113
9/20/2013 6:17,8,30000,43,68,111
9/20/2013 6:17,8,30000,45,72,117
9/20/2013 6:17,8,30000,48,69,117
9/20/2013 6:17,8,30000,48,78,126
9/20/2013 6:17,8,30000,43,80,123
9/20/2013 6:17,8,30000,45,76,121
9/20/2013 6:17,8,30000,43,72,115
9/20/2013 6:17,8,30000,50,72,122
9/20/2013 6:17,8,30000,45,77,122
9/20/2013 6:17,8,30000,41,73,114
9/20/2013 6:17,8,30000,43,73,116
9/20/2013 6:17,8,30000,41,72,113
9/20/2013 6:17,8,30000,41,75,116
9/20/2013 6:17,8,30000,43,72,115
9/20/2013 6:17,8,30000,42,76,118
9/20/2013 6:17,8,30000,48,74,122
9/20/2013 6:17,8,30000,46,72,118
9/20/2013 6:17,8,30000,44,74,118
9/20/2013 6:17,8,30000,42,72,114
9/20/2013 6:17,8,30000,44,71,115
9/20/2013 6:17,8,30000,43,77,120
9/20/2013 6:17,8,30000,43,71,114
9/20/2013 6:17,8,30000,50,71,121
9/20/2013 6:17,8,30000,41,68,109
9/20/2013 6:17,8,30000,41,69,110
9/20/2013 6:17,8,30000,40,73,113
9/20/2013 6:17,8,30000,39,72,111
9/20/2013 6:17,8,30000,49,71,120
9/20/2013 6:17,8,30000,42,72,114
9/20/2013 6:18,8,30000,44,69,113
9/20/2013 6:18,8,30000,47,74,121
9/20/2013 6:18,8,30000,40,69,109
9/20/2013 6:18,8,30000,47,78,125
9/20/2013 6:18,8,30000,41,80,121
9/20/2013 6:18,8,30000,41,70,111
9/20/2013 6:18,8,30000,44,72,116
9/20/2013 6:18,8,30000,44,68,112
9/20/2013 6:18,8,30000,43,69,112
9/20/2013 6:18,8,30000,40,74,114
9/20/2013 6:18,8,30000,46,74,120
9/20/2013 6:18,8,30000,42,74,116
9/20/2013 6:18,8,30000,42,69,111
9/20/2013 6:18,8,30000,47,73,120
9/20/2013 6:18,8,30000,45,75,120
9/20/2013 6:18,8,30000,44,77,121
9/20/2013 6:18,8,30000,45,70,115
9/20/2013 6:18,8,30000,42,70,112
9/20/2013 6:18,8,30000,44,72,116
9/20/2013 6:18,8,30000,44,69,113
9/20/2013 6:18,8,30000,42,74,116
9/20/2013 6:18,8,30000,42,71,113
9/20/2013 6:18,8,30000,43,73,116
9/20/2013 6:18,8,30000,44,75,119
9/20/2013 6:18,8,30000,49,71,120
9/20/2013 6:18,8,30000,46,72,118
9/20/2013 6:18,8,30000,40,71,111
9/20/2013 6:18,8,30000,43,73,116
9/20/2013 6:18,8,30000,41,69,110
9/20/2013 6:18,8,30000,46,73,119
9/20/2013 6:18,8,30000,40,71,111
9/20/2013 6:19,8,40000,46,73,119
9/20/2013 6:19,8,40000,52,75,127
9/20/2013 6:19,8,40000,45,74,119
9/20/2013 6:19,8,40000,46,74,120
9/20/2013 6:19,8,40000,43,74,117
9/20/2013 6:19,8,40000,45,72,117
9/20/2013 6:19,8,40000,47,71,118
9/20/2013 6:19,8,40000,46,71,117
9/20/2013 6:19,8,40000,1037,76,1113
9/20/2013 6:19,8,40000,48,74,122
9/20/2013 6:19,8,40000,46,73,119
9/20/2013 6:19,8,40000,47,74,121
9/20/2013 6:19,8,40000,54,73,127
9/20/2013 6:19,8,40000,45,70,115
9/20/2013 6:19,8,40000,52,76,128
9/20/2013 6:19,8,40000,45,75,120
9/20/2013 6:19,8,40000,45,73,118
9/20/2013 6:19,8,40000,46,73,119
9/20/2013 6:19,8,40000,47,79,126
9/20/2013 6:19,8,40000,46,79,125
9/20/2013 6:19,8,40000,46,79,125
9/20/2013 6:19,8,40000,41,76,117
9/20/2013 6:19,8,40000,48,76,124
9/20/2013 6:19,8,40000,43,74,117
9/20/2013 6:19,8,40000,41,78,119
9/20/2013 6:19,8,40000,49,75,124
9/20/2013 6:19,8,40000,46,73,119
9/20/2013 6:19,8,40000,48,75,123
9/20/2013 6:20,8,40000,49,77,126
9/20/2013 6:20,8,40000,46,82,128
9/20/2013 6:20,8,40000,55,72,127
9/20/2013 6:20,8,40000,45,72,117
9/20/2013 6:20,8,40000,50,71,121
9/20/2013 6:20,8,40000,50,79,129
9/20/2013 6:20,8,40000,46,71,117
9/20/2013 6:20,8,40000,45,72,117
9/20/2013 6:20,8,40000,46,74,120
9/20/2013 6:20,8,40000,42,76,118
9/20/2013 6:20,8,40000,47,73,120
9/20/2013 6:20,8,40000,43,77,120
9/20/2013 6:20,8,40000,47,75,122
9/20/2013 6:20,8,40000,51,74,125
9/20/2013 6:20,8,40000,46,72,118
9/20/2013 6:20,8,40000,50,77,127
9/20/2013 6:20,8,40000,47,78,125
9/20/2013 6:20,8,40000,1043,80,1123
9/20/2013 6:20,8,40000,52,75,127
9/20/2013 6:20,8,40000,49,67,116
9/20/2013 6:20,8,40000,46,73,119
9/20/2013 6:20,8,40000,44,80,124
9/20/2013 6:20,8,40000,48,72,120
9/20/2013 6:20,8,40000,56,74,130
9/20/2013 6:20,8,40000,49,75,124
9/20/2013 6:20,8,40000,48,76,124
9/20/2013 6:20,8,40000,54,69,123
9/20/2013 6:20,8,40000,46,80,126
9/20/2013 6:20,8,40000,49,77,126
9/20/2013 6:20,8,40000,43,70,113
9/20/2013 6:21,8,40000,44,72,116
9/20/2013 6:21,8,40000,53,73,126
9/20/2013 6:21,8,40000,46,80,126
9/20/2013 6:21,8,40000,45,73,118
9/20/2013 6:21,8,40000,48,78,126
9/20/2013 6:21,8,40000,46,74,120
9/20/2013 6:21,8,40000,47,74,121
9/20/2013 6:21,8,40000,44,73,117
9/20/2013 6:21,8,40000,44,75,119
9/20/2013 6:21,8,40000,49,77,126
9/20/2013 6:21,8,40000,46,74,120
9/20/2013 6:21,8,40000,50,75,125
9/20/2013 6:21,8,40000,47,76,123
9/20/2013 6:21,8,40000,47,75,122
9/20/2013 6:21,8,40000,48,76,124
9/20/2013 6:21,8,40000,48,73,121
9/20/2013 6:21,8,40000,43,73,116
9/20/2013 6:21,8,40000,47,78,125
9/20/2013 6:21,8,40000,53,71,124
9/20/2013 6:21,8,40000,47,74,121
9/20/2013 6:21,8,40000,44,72,116
9/20/2013 6:21,8,40000,43,80,123
9/20/2013 6:21,8,40000,46,71,117
9/20/2013 6:21,8,40000,47,73,120
9/20/2013 6:21,8,40000,47,75,122
9/20/2013 6:21,8,40000,45,68,113
9/20/2013 6:21,8,40000,43,77,120
9/20/2013 6:21,8,40000,46,75,121
9/20/2013 6:21,8,40000,47,73,120
9/20/2013 6:21,8,40000,44,76,120
9/20/2013 6:22,8,40000,45,70,115
9/20/2013 6:22,8,40000,43,76,119
9/20/2013 6:22,8,40000,56,79,135
9/20/2013 6:22,8,40000,53,72,125
9/20/2013 6:22,8,40000,44,72,116
9/20/2013 6:22,8,40000,43,73,116
9/20/2013 6:22,8,40000,46,77,123
9/20/2013 6:22,8,40000,45,75,120
9/20/2013 6:22,8,40000,46,71,117
9/20/2013 6:22,8,40000,48,73,121
9/20/2013 6:22,8,40000,60,75,135
9/20/2013 6:22,8,40000,45,72,117
9/20/2013 6:22,8,40000,45,73,118
9/20/2013 6:22,8,40000,43,73,116
9/20/2013 6:22,8,40000,55,73,128
9/20/2013 6:22,8,40000,53,74,127
9/20/2013 6:22,8,40000,55,80,135
9/20/2013 6:22,8,40000,43,73,116
9/20/2013 6:22,8,40000,46,73,119
9/20/2013 6:39,8,40000,49,76,125
9/20/2013 6:39,8,40000,40,78,118
9/20/2013 6:39,8,40000,52,74,126
9/20/2013 6:39,8,40000,45,73,118
9/20/2013 6:39,8,40000,56,74,130
9/20/2013 6:39,8,40000,47,72,119
9/20/2013 6:39,8,40000,45,82,127
9/20/2013 6:39,8,50000,52,74,126
9/20/2013 6:39,8,50000,46,79,125
9/20/2013 6:39,8,50000,42,73,115
9/20/2013 6:39,8,50000,59,75,134
9/20/2013 6:39,8,50000,47,78,125
9/20/2013 6:39,8,50000,50,74,124
9/20/2013 6:39,8,50000,49,81,130
9/20/2013 6:39,8,50000,48,78,126
9/20/2013 6:39,8,50000,58,74,132
9/20/2013 6:39,8,50000,47,80,127
9/20/2013 6:39,8,50000,48,77,125
9/20/2013 6:39,8,50000,51,77,128
9/20/2013 6:39,8,50000,53,76,129
9/20/2013 6:39,8,50000,52,79,131
9/20/2013 6:40,8,50000,50,78,128
9/20/2013 6:40,8,50000,68,75,143
9/20/2013 6:40,8,50000,52,75,127
9/20/2013 6:40,8,50000,50,76,126
9/20/2013 6:40,8,50000,44,78,122
9/20/2013 6:40,8,50000,50,77,127
9/20/2013 6:40,8,50000,45,79,124
9/20/2013 6:40,8,50000,46,75,121
9/20/2013 6:40,8,50000,47,79,126
9/20/2013 6:40,8,50000,48,73,121
9/20/2013 6:40,8,50000,53,78,131
9/20/2013 6:40,8,50000,55,76,131
9/20/2013 6:40,8,50000,45,80,125
9/20/2013 6:40,8,50000,50,78,128
9/20/2013 6:40,8,50000,58,78,136
9/20/2013 6:40,8,50000,45,77,122
9/20/2013 6:40,8,50000,56,74,130
9/20/2013 6:40,8,50000,50,75,125
9/20/2013 6:40,8,50000,50,80,130
9/20/2013 6:40,8,50000,55,73,128
9/20/2013 6:40,8,50000,48,74,122
9/20/2013 6:40,8,50000,50,80,130
9/20/2013 6:40,8,50000,50,74,124
9/20/2013 6:40,8,50000,45,79,124
9/20/2013 6:40,8,50000,45,76,121
9/20/2013 6:40,8,50000,53,79,132
9/20/2013 6:40,8,50000,58,77,135
9/20/2013 6:40,8,50000,50,77,127
9/20/2013 6:40,8,50000,57,68,125
9/20/2013 6:40,8,50000,43,74,117
9/20/2013 6:41,8,50000,48,75,123
9/20/2013 6:41,8,50000,54,78,132
9/20/2013 6:41,8,50000,47,76,123
9/20/2013 6:41,8,50000,45,73,118
9/20/2013 6:41,8,50000,52,83,135
9/20/2013 6:41,8,50000,63,79,142
9/20/2013 6:41,8,50000,50,78,128
9/20/2013 6:41,8,50000,47,72,119
9/20/2013 6:41,8,50000,53,71,124
9/20/2013 6:41,8,50000,46,78,124
9/20/2013 6:41,8,50000,53,72,125
9/20/2013 6:41,8,50000,52,79,131
9/20/2013 6:41,8,50000,52,82,134
9/20/2013 6:41,8,50000,60,74,134
9/20/2013 6:41,8,50000,57,78,135
9/20/2013 6:41,8,50000,49,78,127
9/20/2013 6:41,8,50000,53,76,129
9/20/2013 6:41,8,50000,52,76,128
9/20/2013 6:41,8,50000,46,78,124
9/20/2013 6:41,8,50000,47,83,130
9/20/2013 6:41,8,50000,49,78,127
9/20/2013 6:41,8,50000,43,74,117
9/20/2013 6:41,8,50000,57,75,132
9/20/2013 6:41,8,50000,57,77,134
9/20/2013 6:41,8,50000,51,76,127
9/20/2013 6:41,8,50000,48,78,126
9/20/2013 6:41,8,50000,49,73,122
9/20/2013 6:41,8,50000,48,78,126
9/20/2013 6:41,8,50000,47,77,124
9/20/2013 6:41,8,50000,43,76,119
9/20/2013 6:42,8,50000,47,74,121
9/20/2013 6:42,8,50000,65,75,140
9/20/2013 6:42,8,50000,47,77,124
9/20/2013 6:42,8,50000,47,75,122
9/20/2013 6:42,8,50000,46,77,123
9/20/2013 6:42,8,50000,50,77,127
9/20/2013 6:42,8,50000,54,75,129
9/20/2013 6:42,8,50000,53,74,127
9/20/2013 6:42,8,50000,51,75,126
9/20/2013 6:42,8,50000,50,75,125
9/20/2013 6:42,8,50000,50,76,126
9/20/2013 6:42,8,50000,44,79,123
9/20/2013 6:42,8,50000,50,79,129
9/20/2013 6:42,8,50000,45,75,120
9/20/2013 6:42,8,50000,56,80,136
9/20/2013 6:42,8,50000,52,73,125
9/20/2013 6:42,8,50000,46,76,122
9/20/2013 6:42,8,50000,47,76,123
9/20/2013 6:42,8,50000,50,75,125
9/20/2013 6:42,8,50000,48,78,126
9/20/2013 6:42,8,50000,52,78,130
9/20/2013 6:42,8,50000,59,74,133
9/20/2013 6:42,8,50000,43,81,124
9/20/2013 6:42,8,50000,1039,78,1117
9/20/2013 6:42,8,50000,54,73,127
9/20/2013 6:42,8,50000,53,73,126
9/20/2013 6:42,8,50000,1041,78,1119
9/20/2013 6:43,8,50000,45,74,119
9/20/2013 6:43,8,50000,47,77,124
9/20/2013 6:43,8,50000,49,78,127
9/20/2013 6:43,8,50000,1036,75,1111
9/20/2013 6:43,8,50000,48,79,127
9/20/2013 6:43,8,50000,51,80,131
9/20/2013 6:43,8,50000,45,77,122
9/20/2013 6:43,8,50000,59,82,141
9/20/2013 6:43,8,50000,47,74,121
9/20/2013 6:43,8,50000,55,74,129
9/20/2013 6:43,8,50000,54,87,141
9/20/2013 6:43,8,50000,52,80,132
9/20/2013 6:43,8,50000,58,80,138
9/20/2013 6:43,8,50000,47,80,127
9/20/2013 6:43,8,60000,59,72,131
9/20/2013 6:43,8,60000,62,77,139
9/20/2013 6:43,8,60000,58,71,129
9/20/2013 6:43,8,60000,49,73,122
9/20/2013 6:43,8,60000,62,72,134
9/20/2013 6:43,8,60000,66,69,135
9/20/2013 6:43,8,60000,58,69,127
9/20/2013 6:43,8,60000,51,76,127
9/20/2013 6:43,8,60000,57,72,129
9/20/2013 6:43,8,60000,51,72,123
9/20/2013 6:43,8,60000,73,73,146
9/20/2013 6:43,8,60000,58,75,133
9/20/2013 6:44,8,60000,75,72,147
9/20/2013 6:44,8,60000,60,75,135
9/20/2013 6:44,8,60000,51,72,123
9/20/2013 6:44,8,60000,57,76,133
9/20/2013 6:44,8,60000,62,72,134
9/20/2013 6:44,8,60000,53,69,122
9/20/2013 6:44,8,60000,64,72,136
9/20/2013 6:44,8,60000,62,76,138
9/20/2013 6:44,8,60000,54,72,126
9/20/2013 6:44,8,60000,67,76,143
9/20/2013 6:44,8,60000,54,76,130
9/20/2013 6:44,8,60000,60,75,135
9/20/2013 6:44,8,60000,63,71,134
9/20/2013 6:44,8,60000,57,72,129
9/20/2013 6:44,8,60000,64,74,138
9/20/2013 6:44,8,60000,58,72,130
9/20/2013 6:44,8,60000,57,78,135
9/20/2013 6:44,8,60000,59,75,134
9/20/2013 6:44,8,60000,51,73,124
9/20/2013 6:44,8,60000,59,73,132
9/20/2013 6:44,8,60000,61,74,135
9/20/2013 6:44,8,60000,63,70,133
9/20/2013 6:44,8,60000,59,77,136
9/20/2013 6:44,8,60000,62,78,140
9/20/2013 6:44,8,60000,62,74,136
9/20/2013 6:44,8,60000,71,78,149
9/20/2013 6:44,8,60000,59,75,134
9/20/2013 6:44,8,60000,61,75,136
9/20/2013 6:44,8,60000,53,69,122
9/20/2013 6:44,8,60000,57,76,133
9/20/2013 6:45,8,60000,58,72,130
9/20/2013 6:45,8,60000,58,69,127
9/20/2013 6:45,8,60000,55,72,127
9/20/2013 6:45,8,60000,56,71,127
9/20/2013 6:45,8,60000,55,75,130
9/20/2013 6:45,8,60000,64,78,142
9/20/2013 6:45,8,60000,53,76,129
9/20/2013 6:45,8,60000,49,71,120
9/20/2013 6:45,8,60000,69,71,140
9/20/2013 6:45,8,60000,60,72,132
9/20/2013 6:45,8,60000,53,73,126
9/20/2013 6:45,8,60000,59,72,131
9/20/2013 6:45,8,60000,1054,75,1129
9/20/2013 6:45,8,60000,66,75,141
9/20/2013 6:45,8,60000,84,72,156
9/20/2013 6:45,8,60000,58,71,129
9/20/2013 6:45,8,60000,54,72,126
9/20/2013 6:45,8,60000,52,72,124
9/20/2013 6:45,8,60000,58,70,128
9/20/2013 6:45,8,60000,59,72,131
9/20/2013 6:45,8,60000,74,78,152
9/20/2013 6:45,8,60000,53,69,122
9/20/2013 6:45,8,60000,63,73,136
9/20/2013 6:45,8,60000,52,72,124
9/20/2013 6:45,8,60000,65,76,141
9/20/2013 6:45,8,60000,54,73,127
9/20/2013 6:45,8,60000,75,78,153
9/20/2013 6:45,8,60000,60,77,137
9/20/2013 6:45,8,60000,68,72,140
9/20/2013 6:46,8,60000,58,70,128
9/20/2013 6:46,8,60000,57,73,130
9/20/2013 6:46,8,60000,55,69,124
9/20/2013 6:46,8,60000,58,72,130
9/20/2013 6:46,8,60000,56,71,127
9/20/2013 6:46,8,60000,52,77,129
9/20/2013 6:46,8,60000,49,78,127
9/20/2013 6:46,8,60000,56,70,126
9/20/2013 6:46,8,60000,51,74,125
9/20/2013 6:46,8,60000,51,78,129
9/20/2013 6:46,8,60000,55,78,133
9/20/2013 6:46,8,60000,61,75,136
9/20/2013 6:46,8,60000,57,75,132
9/20/2013 6:46,8,60000,76,72,148
9/20/2013 6:46,8,60000,56,74,130
9/20/2013 6:46,8,60000,54,71,125
9/20/2013 6:46,8,60000,65,71,136
9/20/2013 6:46,8,60000,61,72,133
9/20/2013 6:46,8,60000,73,78,151
9/20/2013 6:46,8,60000,59,77,136
9/20/2013 6:46,8,60000,54,73,127
9/20/2013 6:46,8,60000,58,73,131
9/20/2013 6:46,8,60000,64,72,136
9/20/2013 6:46,8,60000,58,75,133
9/20/2013 6:46,8,60000,62,78,140
9/20/2013 6:46,8,60000,49,75,124
9/20/2013 6:46,8,60000,53,71,124
9/20/2013 6:46,8,60000,58,75,133
9/20/2013 6:46,8,60000,67,76,143
9/20/2013 6:46,8,60000,59,73,132
9/20/2013 6:47,8,60000,62,73,135
9/20/2013 6:47,8,60000,68,72,140
9/20/2013 6:47,8,60000,62,77,139
9/20/2013 6:47,8,60000,52,71,123
9/20/2013 6:47,8,60000,63,71,134
9/20/2013 6:47,8,60000,53,71,124
9/20/2013 6:47,8,60000,59,73,132
9/20/2013 6:47,8,60000,57,72,129
9/20/2013 6:47,8,60000,57,83,140
9/20/2013 6:47,8,60000,60,72,132
9/20/2013 6:47,8,60000,53,71,124
9/20/2013 6:47,8,60000,55,81,136
9/20/2013 6:47,8,60000,55,72,127
9/20/2013 6:47,8,60000,65,74,139
9/20/2013 6:47,8,70000,65,80,145
9/20/2013 6:47,8,70000,53,76,129
9/20/2013 6:47,8,70000,64,76,140
9/20/2013 6:47,8,70000,58,73,131
9/20/2013 6:47,8,70000,61,78,139
9/20/2013 6:47,8,70000,57,73,130
9/20/2013 6:47,8,70000,67,77,144
9/20/2013 6:47,8,70000,66,76,142
9/20/2013 6:47,8,70000,74,74,148
9/20/2013 6:47,8,70000,63,73,136
9/20/2013 6:47,8,70000,69,74,143
9/20/2013 6:47,8,70000,74,77,151
9/20/2013 6:47,8,70000,62,85,147
9/20/2013 6:47,8,70000,67,75,142
9/20/2013 6:47,8,70000,67,73,140
9/20/2013 6:47,8,70000,58,75,133
9/20/2013 6:48,8,70000,61,71,132
9/20/2013 6:48,8,70000,62,74,136
9/20/2013 6:48,8,70000,59,76,135
9/20/2013 6:48,8,70000,58,71,129
9/20/2013 6:48,8,70000,1061,85,1146
9/20/2013 6:48,8,70000,60,75,135
9/20/2013 6:48,8,70000,57,71,128
9/20/2013 6:48,8,70000,68,71,139
9/20/2013 6:48,8,70000,59,73,132
9/20/2013 6:48,8,70000,1059,80,1139
9/20/2013 6:48,8,70000,58,73,131
9/20/2013 6:48,8,70000,63,75,138
9/20/2013 6:48,8,70000,55,73,128
9/20/2013 6:48,8,70000,62,72,134
9/20/2013 6:48,8,70000,69,81,150
9/20/2013 6:48,8,70000,60,79,139
9/20/2013 6:48,8,70000,58,73,131
9/20/2013 6:48,8,70000,56,75,131
9/20/2013 6:48,8,70000,71,75,146
9/20/2013 6:48,8,70000,60,74,134
9/20/2013 6:48,8,70000,58,79,137
9/20/2013 6:48,8,70000,1033,76,1109
9/20/2013 6:48,8,70000,1043,78,1121
9/20/2013 6:48,8,70000,64,72,136
9/20/2013 6:48,8,70000,65,77,142
9/20/2013 6:48,8,70000,1046,76,1122
9/20/2013 6:49,8,70000,1050,75,1125
9/20/2013 6:49,8,70000,69,72,141
9/20/2013 6:49,8,70000,63,74,137
9/20/2013 6:49,8,70000,61,81,142
9/20/2013 6:49,8,70000,67,80,147
9/20/2013 6:49,8,70000,54,74,128
9/20/2013 6:49,8,70000,62,78,140
9/20/2013 6:49,8,70000,59,78,137
9/20/2013 6:49,8,70000,58,78,136
9/20/2013 6:49,8,70000,69,78,147
9/20/2013 6:49,8,70000,62,73,135
9/20/2013 6:49,8,70000,72,74,146
9/20/2013 6:49,8,70000,70,75,145
9/20/2013 6:49,8,70000,70,77,147
9/20/2013 6:49,8,70000,63,80,143
9/20/2013 6:49,8,70000,76,78,154
9/20/2013 6:49,8,70000,75,75,150
9/20/2013 6:49,8,70000,64,73,137
9/20/2013 6:49,8,70000,1057,83,1140
9/20/2013 6:49,8,70000,65,74,139
9/20/2013 6:49,8,70000,59,74,133
9/20/2013 6:49,8,70000,59,78,137
9/20/2013 6:49,8,70000,61,71,132
9/20/2013 6:49,8,70000,68,78,146
9/20/2013 6:49,8,70000,57,75,132
9/20/2013 6:49,8,70000,61,80,141
9/20/2013 6:49,8,70000,68,74,142
9/20/2013 6:49,8,70000,69,77,146
9/20/2013 6:50,8,70000,59,75,134
9/20/2013 6:50,8,70000,62,81,143
9/20/2013 6:50,8,70000,66,78,144
9/20/2013 6:50,8,70000,56,72,128
9/20/2013 6:50,8,70000,70,73,143
9/20/2013 6:50,8,70000,70,80,150
9/20/2013 6:50,8,70000,60,74,134
9/20/2013 6:50,8,70000,56,79,135
9/20/2013 6:50,8,70000,1046,76,1122
9/20/2013 6:50,8,70000,58,75,133
9/20/2013 6:50,8,70000,50,75,125
9/20/2013 6:50,8,70000,62,78,140
9/20/2013 6:50,8,70000,57,73,130
9/20/2013 6:50,8,70000,65,77,142
9/20/2013 6:50,8,70000,62,80,142
9/20/2013 6:50,8,70000,1046,77,1123
9/20/2013 6:50,8,70000,56,81,137
9/20/2013 6:50,8,70000,68,73,141
9/20/2013 6:50,8,70000,1060,75,1135
9/20/2013 6:50,8,70000,63,79,142
9/20/2013 6:50,8,70000,63,73,136
9/20/2013 6:50,8,70000,77,73,150
9/20/2013 6:50,8,70000,61,82,143
9/20/2013 6:50,8,70000,66,79,145
9/20/2013 6:50,8,70000,55,78,133
9/20/2013 6:50,8,70000,1045,78,1123
9/20/2013 6:50,8,70000,63,76,139
9/20/2013 6:51,8,70000,58,78,136
9/20/2013 6:51,8,70000,56,74,130
9/20/2013 6:51,8,70000,66,71,137
9/20/2013 6:51,8,70000,50,80,130
9/20/2013 6:51,8,70000,64,80,144
9/20/2013 6:51,8,70000,61,74,135
9/20/2013 6:51,8,70000,74,80,154
9/20/2013 6:51,8,70000,61,86,147
9/20/2013 6:51,8,70000,1059,83,1142
9/20/2013 6:51,8,70000,1049,83,1132
9/20/2013 6:51,8,70000,59,72,131
9/20/2013 6:51,8,70000,65,75,140
9/20/2013 6:51,8,70000,60,84,144
9/20/2013 6:51,8,70000,63,76,139
9/20/2013 6:51,8,70000,59,76,135
9/20/2013 6:51,8,70000,59,80,139
9/20/2013 6:51,8,70000,67,75,142
9/20/2013 6:51,8,70000,65,78,143
9/20/2013 6:51,8,80000,61,78,139
9/20/2013 6:51,8,80000,53,82,135
9/20/2013 6:51,8,80000,71,78,149
9/20/2013 6:51,8,80000,65,76,141
9/20/2013 6:51,8,80000,68,82,150
9/20/2013 6:51,8,80000,71,81,152
9/20/2013 6:51,8,80000,64,80,144
9/20/2013 6:51,8,80000,66,76,142
9/20/2013 6:51,8,80000,70,75,145
9/20/2013 6:51,8,80000,59,76,135
9/20/2013 6:52,8,80000,73,79,152
9/20/2013 6:52,8,80000,76,74,150
9/20/2013 6:52,8,80000,64,75,139
9/20/2013 6:52,8,80000,69,78,147
9/20/2013 6:52,8,80000,52,83,135
9/20/2013 6:52,8,80000,56,75,131
9/20/2013 6:52,8,80000,60,79,139
9/20/2013 6:52,8,80000,63,80,143
9/20/2013 6:52,8,80000,63,81,144
9/20/2013 6:52,8,80000,62,77,139
9/20/2013 6:52,8,80000,84,82,166
9/20/2013 6:52,8,80000,68,81,149
9/20/2013 6:52,8,80000,1058,79,1137
9/20/2013 6:52,8,80000,63,78,141
9/20/2013 6:52,8,80000,1053,85,1138
9/20/2013 6:52,8,80000,71,83,154
9/20/2013 6:52,8,80000,58,81,139
9/20/2013 6:52,8,80000,66,80,146
9/20/2013 6:52,8,80000,65,76,141
9/20/2013 6:52,8,80000,65,79,144
9/20/2013 6:52,8,80000,63,74,137
9/20/2013 6:52,8,80000,1045,79,1124
9/20/2013 6:52,8,80000,1060,82,1142
9/20/2013 6:52,8,80000,63,77,140
9/20/2013 6:52,8,80000,55,80,135
9/20/2013 6:52,8,80000,64,76,140
9/20/2013 6:53,8,80000,68,78,146
9/20/2013 6:53,8,80000,54,84,138
9/20/2013 6:53,8,80000,75,78,153
9/20/2013 6:53,8,80000,79,82,161
9/20/2013 6:53,8,80000,73,78,151
9/20/2013 6:53,8,80000,66,75,141
9/20/2013 6:53,8,80000,61,80,141
9/20/2013 6:53,8,80000,63,78,141
9/20/2013 6:53,8,80000,64,81,145
9/20/2013 6:53,8,80000,69,79,148
9/20/2013 6:53,8,80000,1056,87,1143
9/20/2013 6:53,8,80000,63,81,144
9/20/2013 6:53,8,80000,67,80,147
9/20/2013 6:53,8,80000,66,75,141
9/20/2013 6:53,8,80000,57,78,135
9/20/2013 6:53,8,80000,58,78,136
9/20/2013 6:53,8,80000,79,81,160
9/20/2013 6:53,8,80000,1053,79,1132
9/20/2013 6:53,8,80000,60,75,135
9/20/2013 6:53,8,80000,61,76,137
9/20/2013 6:53,8,80000,62,80,142
9/20/2013 6:53,8,80000,65,81,146
9/20/2013 6:53,8,80000,76,81,157
9/20/2013 6:53,8,80000,1061,87,1148
9/20/2013 6:53,8,80000,66,76,142
9/20/2013 6:53,8,80000,63,81,144
9/20/2013 6:53,8,80000,66,80,146
9/20/2013 6:54,8,80000,1068,82,1150
9/20/2013 6:54,8,80000,1043,80,1123
9/20/2013 6:54,8,80000,70,77,147
9/20/2013 6:54,8,80000,62,76,138
9/20/2013 6:54,8,80000,55,80,135
9/20/2013 6:54,8,80000,67,80,147
9/20/2013 6:54,8,80000,67,77,144
9/20/2013 6:54,8,80000,68,80,148
9/20/2013 6:54,8,80000,62,76,138
9/20/2013 6:54,8,80000,63,81,144
9/20/2013 6:54,8,80000,62,76,138
9/20/2013 6:54,8,80000,63,81,144
9/20/2013 6:54,8,80000,86,83,169
9/20/2013 6:54,8,80000,65,76,141
9/20/2013 6:54,8,80000,71,78,149
9/20/2013 6:54,8,80000,89,77,166
9/20/2013 6:54,8,80000,63,75,138
9/20/2013 6:54,8,80000,65,74,139
9/20/2013 6:54,8,80000,70,77,147
9/20/2013 6:54,8,80000,61,79,140
9/20/2013 6:54,8,80000,61,76,137
9/20/2013 6:54,8,80000,69,76,145
9/20/2013 6:54,8,80000,69,86,155
9/20/2013 6:54,8,80000,75,78,153
9/20/2013 6:54,8,80000,63,77,140
9/20/2013 6:54,8,80000,71,80,151
9/20/2013 7:11,8,80000,61,77,138
9/20/2013 7:11,8,80000,63,80,143
9/20/2013 7:11,8,80000,64,81,145
9/20/2013 7:11,8,80000,65,81,146
9/20/2013 7:11,8,80000,64,77,141
9/20/2013 7:11,8,80000,65,81,146
9/20/2013 7:11,8,80000,66,75,141
9/20/2013 7:11,8,80000,55,79,134
9/20/2013 7:11,8,80000,67,76,143
9/20/2013 7:11,8,80000,58,82,140
9/20/2013 7:11,8,80000,65,76,141
9/20/2013 7:12,8,80000,72,75,147
9/20/2013 7:12,8,80000,59,77,136
9/20/2013 7:12,8,80000,74,81,155
9/20/2013 7:12,8,80000,56,82,138
9/20/2013 7:12,8,80000,64,78,142
9/20/2013 7:12,8,80000,63,78,141
9/20/2013 7:12,8,80000,62,74,136
9/20/2013 7:12,8,80000,64,78,142
9/20/2013 7:12,8,80000,61,81,142
9/20/2013 7:12,8,80000,71,77,148
9/20/2013 7:12,8,80000,60,76,136
9/20/2013 7:12,8,80000,61,82,143
9/20/2013 7:12,8,80000,72,76,148
9/20/2013 7:12,8,80000,64,77,141
9/20/2013 7:12,8,90000,71,81,152
9/20/2013 7:12,8,90000,61,81,142
9/20/2013 7:12,8,90000,64,84,148
9/20/2013 7:12,8,90000,72,80,152
9/20/2013 7:12,8,90000,68,80,148
9/20/2013 7:12,8,90000,63,83,146
9/20/2013 7:12,8,90000,67,78,145
9/20/2013 7:12,8,90000,70,80,150
9/20/2013 7:12,8,90000,1043,82,1125
9/20/2013 7:12,8,90000,64,83,147
9/20/2013 7:12,8,90000,61,80,141
9/20/2013 7:12,8,90000,74,83,157
9/20/2013 7:12,8,90000,67,82,149
9/20/2013 7:12,8,90000,59,79,138
9/20/2013 7:12,8,90000,70,79,149
9/20/2013 7:13,8,90000,57,81,138
9/20/2013 7:13,8,90000,84,82,166
9/20/2013 7:13,8,90000,66,85,151
9/20/2013 7:13,8,90000,71,76,147
9/20/2013 7:13,8,90000,71,79,150
9/20/2013 7:13,8,90000,75,82,157
9/20/2013 7:13,8,90000,67,84,151
9/20/2013 7:13,8,90000,64,81,145
9/20/2013 7:13,8,90000,75,78,153
9/20/2013 7:13,8,90000,66,81,147
9/20/2013 7:13,8,90000,61,78,139
9/20/2013 7:13,8,90000,58,78,136
9/20/2013 7:13,8,90000,81,83,164
9/20/2013 7:13,8,90000,60,83,143
9/20/2013 7:13,8,90000,65,80,145
9/20/2013 7:13,8,90000,76,80,156
9/20/2013 7:13,8,90000,72,85,157
9/20/2013 7:13,8,90000,63,82,145
9/20/2013 7:13,8,90000,69,84,153
9/20/2013 7:13,8,90000,68,83,151
9/20/2013 7:13,8,90000,63,75,138
9/20/2013 7:13,8,90000,66,82,148
9/20/2013 7:13,8,90000,72,79,151
9/20/2013 7:13,8,90000,70,77,147
9/20/2013 7:13,8,90000,79,86,165
9/20/2013 7:13,8,90000,78,84,162
9/20/2013 7:13,8,90000,67,78,145
9/20/2013 7:13,8,90000,67,83,150
9/20/2013 7:13,8,90000,75,82,157
9/20/2013 7:13,8,90000,70,82,152
9/20/2013 7:14,8,90000,82,77,159
9/20/2013 7:14,8,90000,73,78,151
9/20/2013 7:14,8,90000,68,77,145
9/20/2013 7:14,8,90000,68,88,156
9/20/2013 7:14,8,90000,64,77,141
9/20/2013 7:14,8,90000,68,82,150
9/20/2013 7:14,8,90000,73,79,152
9/20/2013 7:14,8,90000,66,81,147
9/20/2013 7:14,8,90000,74,78,152
9/20/2013 7:14,8,90000,80,82,162
9/20/2013 7:14,8,90000,72,79,151
9/20/2013 7:14,8,90000,69,83,152
9/20/2013 7:14,8,90000,56,81,137
9/20/2013 7:14,8,90000,60,83,143
9/20/2013 7:14,8,90000,1060,81,1141
9/20/2013 7:14,8,90000,71,82,153
9/20/2013 7:14,8,90000,72,80,152
9/20/2013 7:14,8,90000,61,81,142
9/20/2013 7:14,8,90000,74,80,154
9/20/2013 7:14,8,90000,60,80,140
9/20/2013 7:14,8,90000,70,78,148
9/20/2013 7:14,8,90000,67,82,149
9/20/2013 7:14,8,90000,74,79,153
9/20/2013 7:14,8,90000,64,82,146
9/20/2013 7:14,8,90000,70,79,149
9/20/2013 7:14,8,90000,65,79,144
9/20/2013 7:14,8,90000,66,78,144
9/20/2013 7:14,8,90000,66,80,146
9/20/2013 7:15,8,90000,74,81,155
9/20/2013 7:15,8,90000,72,81,153
9/20/2013 7:15,8,90000,54,82,136
9/20/2013 7:15,8,90000,69,80,149
9/20/2013 7:15,8,90000,71,83,154
9/20/2013 7:15,8,90000,61,78,139
9/20/2013 7:15,8,90000,79,76,155
9/20/2013 7:15,8,90000,1058,77,1135
9/20/2013 7:15,8,90000,60,79,139
9/20/2013 7:15,8,90000,73,79,152
9/20/2013 7:15,8,90000,72,84,156
9/20/2013 7:15,8,90000,57,81,138
9/20/2013 7:15,8,90000,79,79,158
9/20/2013 7:15,8,90000,70,79,149
9/20/2013 7:15,8,90000,70,82,152
9/20/2013 7:15,8,90000,74,83,157
9/20/2013 7:15,8,90000,80,76,156
9/20/2013 7:15,8,90000,62,78,140
9/20/2013 7:15,8,90000,69,82,151
9/20/2013 7:15,8,90000,74,83,157
9/20/2013 7:15,8,90000,80,79,159
9/20/2013 7:15,8,90000,67,82,149
9/20/2013 7:15,8,90000,77,83,160
9/20/2013 7:15,8,90000,70,77,147
9/20/2013 7:15,8,90000,63,78,141
9/20/2013 7:15,8,90000,79,83,162
9/20/2013 7:15,8,90000,70,78,148
9/20/2013 7:15,8,90000,67,78,145
9/20/2013 7:15,8,90000,60,77,137
9/20/2013 7:16,8,90000,67,85,152
9/20/2013 7:16,8,90000,1068,82,1150
9/20/2013 7:16,8,90000,61,78,139
9/20/2013 7:16,8,90000,80,83,163
9/20/2013 7:16,8,90000,71,77,148
9/20/2013 7:16,8,90000,1060,79,1139
9/20/2013 7:16,8,90000,75,78,153
9/20/2013 7:16,8,90000,70,85,155
9/20/2013 7:16,8,90000,70,78,148
9/20/2013 7:16,8,90000,58,83,141
9/20/2013 7:16,8,90000,75,81,156
9/20/2013 7:16,8,90000,67,80,147
9/20/2013 7:16,8,90000,60,81,141
9/20/2013 7:16,8,100000,1064,88,1152
9/20/2013 7:16,8,100000,70,89,159
9/20/2013 7:16,8,100000,70,87,157
9/20/2013 7:16,8,100000,1072,86,1158
9/20/2013 7:16,8,100000,62,88,150
9/20/2013 7:16,8,100000,68,84,152
9/20/2013 7:16,8,100000,71,82,153
9/20/2013 7:16,8,100000,79,85,164
9/20/2013 7:16,8,100000,72,86,158
9/20/2013 7:16,8,100000,1066,89,1155
9/20/2013 7:16,8,100000,1064,90,1154
9/20/2013 7:17,8,100000,78,88,166
9/20/2013 7:17,8,100000,64,84,148
9/20/2013 7:17,8,100000,83,82,165
9/20/2013 7:17,8,100000,61,87,148
9/20/2013 7:17,8,100000,71,88,159
9/20/2013 7:17,8,100000,79,83,162
9/20/2013 7:17,8,100000,78,84,162
9/20/2013 7:17,8,100000,72,91,163
9/20/2013 7:17,8,100000,62,86,148
9/20/2013 7:17,8,100000,1069,85,1154
9/20/2013 7:17,8,100000,73,88,161
9/20/2013 7:17,8,100000,69,85,154
9/20/2013 7:17,8,100000,68,85,153
9/20/2013 7:17,8,100000,85,81,166
9/20/2013 7:17,8,100000,69,86,155
9/20/2013 7:17,8,100000,59,88,147
9/20/2013 7:17,8,100000,62,84,146
9/20/2013 7:17,8,100000,78,83,161
9/20/2013 7:17,8,100000,70,83,153
9/20/2013 7:17,8,100000,1054,86,1140
9/20/2013 7:17,8,100000,76,83,159
9/20/2013 7:17,8,100000,73,91,164
9/20/2013 7:17,8,100000,71,84,155
9/20/2013 7:17,8,100000,76,86,162
9/20/2013 7:17,8,100000,72,85,157
9/20/2013 7:17,8,100000,69,86,155
9/20/2013 7:17,8,100000,68,92,160
9/20/2013 7:17,8,100000,71,86,157
9/20/2013 7:18,8,100000,74,85,159
9/20/2013 7:18,8,100000,71,90,161
9/20/2013 7:18,8,100000,92,79,171
9/20/2013 7:18,8,100000,79,89,168
9/20/2013 7:18,8,100000,68,88,156
9/20/2013 7:18,8,100000,78,91,169
9/20/2013 7:18,8,100000,80,83,163
9/20/2013 7:18,8,100000,86,84,170
9/20/2013 7:18,8,100000,83,87,170
9/20/2013 7:18,8,100000,79,80,159
9/20/2013 7:18,8,100000,78,86,164
9/20/2013 7:18,8,100000,68,87,155
9/20/2013 7:18,8,100000,80,85,165
9/20/2013 7:18,8,100000,69,83,152
9/20/2013 7:18,8,100000,62,83,145
9/20/2013 7:18,8,100000,72,88,160
9/20/2013 7:18,8,100000,73,84,157
9/20/2013 7:18,8,100000,72,84,156
9/20/2013 7:18,8,100000,66,82,148
9/20/2013 7:18,8,100000,87,81,168
9/20/2013 7:18,8,100000,71,85,156
9/20/2013 7:18,8,100000,69,90,159
9/20/2013 7:18,8,100000,75,84,159
9/20/2013 7:18,8,100000,69,88,157
9/20/2013 7:18,8,100000,68,83,151
9/20/2013 7:18,8,100000,60,85,145
9/20/2013 7:18,8,100000,78,82,160
9/20/2013 7:18,8,100000,89,86,175
9/20/2013 7:18,8,100000,70,94,164
9/20/2013 7:19,8,100000,76,85,161
9/20/2013 7:19,8,100000,75,83,158
9/20/2013 7:19,8,100000,73,84,157
9/20/2013 7:19,8,100000,84,86,170
9/20/2013 7:19,8,100000,77,84,161
9/20/2013 7:19,8,100000,66,83,149
9/20/2013 7:19,8,100000,60,87,147
9/20/2013 7:19,8,100000,73,91,164
9/20/2013 7:19,8,100000,92,81,173
9/20/2013 7:19,8,100000,71,82,153
9/20/2013 7:19,8,100000,64,88,152
9/20/2013 7:19,8,100000,67,88,155
9/20/2013 7:19,8,100000,66,84,150
9/20/2013 7:19,8,100000,77,89,166
9/20/2013 7:19,8,100000,74,87,161
9/20/2013 7:19,8,100000,67,86,153
9/20/2013 7:19,8,100000,70,91,161
9/20/2013 7:19,8,100000,73,86,159
9/20/2013 7:19,8,100000,74,87,161
9/20/2013 7:19,8,100000,73,83,156
9/20/2013 7:19,8,100000,83,85,168
9/20/2013 7:19,8,100000,85,84,169
9/20/2013 7:19,8,100000,71,90,161
9/20/2013 7:19,8,100000,78,85,163
9/20/2013 7:19,8,100000,82,82,164
9/20/2013 7:19,8,100000,70,81,151
9/20/2013 7:19,8,100000,62,83,145
9/20/2013 7:19,8,100000,59,87,146
9/20/2013 7:19,8,100000,82,87,169
9/20/2013 7:19,8,100000,73,85,158
9/20/2013 7:20,8,100000,66,88,154
9/20/2013 7:20,8,100000,61,83,144
9/20/2013 7:20,8,100000,62,84,146
9/20/2013 7:20,8,100000,73,88,161
9/20/2013 7:20,8,100000,62,86,148
9/20/2013 7:20,8,100000,60,83,143
9/20/2013 7:20,8,100000,75,82,157
9/20/2013 7:20,8,100000,72,82,154
9/20/2013 7:20,8,100000,74,86,160
9/20/2013 7:20,8,100000,85,86,171
9/20/2013 7:20,8,100000,76,85,161
9/20/2013 7:20,8,100000,62,86,148
9/20/2013 7:20,8,100000,63,89,152
9/20/2013 7:20,8,100000,77,91,168
9/20/2013 7:20,8,100000,72,83,155
9/20/2013 7:20,8,100000,85,85,170
9/20/2013 7:20,8,100000,84,86,170
9/20/2013 7:20,8,100000,81,81,162
9/20/2013 7:20,8,100000,74,89,163
9/20/2013 7:20,8,100000,61,84,145
9/20/2013 7:20,8,100000,78,85,163
9/20/2013 7:20,8,100000,59,87,146
9/20/2013 7:20,8,100000,80,92,172
9/20/2013 7:20,8,100000,76,83,159
9/20/2013 7:20,8,100000,79,84,163
9/20/2013 7:20,8,100000,71,83,154
9/20/2013 7:20,8,100000,62,82,144
9/20/2013 7:20,8,100000,70,94,164
9/20/2013 7:21,8,100000,78,83,161
9/20/2013 7:21,8,100000,70,82,152
9/20/2013 7:21,8,100000,70,88,158
9/20/2013 7:21,8,100000,69,91,160
9/20/2013 7:21,8,100000,75,92,167
9/20/2013 7:21,8,100000,68,82,150
9/20/2013 7:21,8,100000,99,86,185
9/20/2013 7:21,8,100000,75,85,160
9/20/2013 7:21,8,100000,73,85,158
9/20/2013 7:21,8,100000,65,84,149
9/20/2013 7:21,8,100000,79,86,165
9/20/2013 7:21,8,100000,73,83,156
9/20/2013 7:21,8,100000,73,86,159
9/20/2013 7:21,8,100000,69,83,152
9/20/2013 7:21,8,100000,73,82,155
9/20/2013 7:21,8,100000,71,91,162
9/20/2013 7:21,8,100000,67,84,151
9/20/2013 7:21,8,100000,71,86,157
9/20/2013 7:21,8,100000,71,87,158
9/20/2013 7:21,8,100000,67,85,152
9/20/2013 7:21,8,100000,72,81,153
9/20/2013 7:21,8,100000,1058,90,1148
9/20/2013 7:21,8,100000,66,85,151
9/20/2013 7:21,8,100000,75,83,158
9/20/2013 7:21,8,100000,82,79,161
9/20/2013 7:21,8,100000,1058,83,1141
9/20/2013 7:21,8,100000,64,84,148
9/20/2013 7:21,8,100000,73,82,155
9/20/2013 7:22,8,100000,76,85,161
9/20/2013 7:22,8,100000,70,83,153
9/20/2013 7:22,8,100000,84,80,164
9/20/2013 7:22,8,100000,70,86,156
9/20/2013 7:22,8,100000,69,86,155
9/20/2013 7:22,8,100000,84,81,165
9/20/2013 7:22,8,100000,64,84,148
9/20/2013 7:22,8,100000,92,87,179
9/20/2013 7:22,8,100000,75,83,158
9/20/2013 7:22,8,100000,81,91,172
9/20/2013 7:22,8,100000,72,82,154
9/20/2013 7:22,8,100000,76,85,161
9/20/2013 7:22,8,100000,70,82,152
9/20/2013 7:22,8,100000,67,79,146
9/20/2013 7:22,8,100000,73,84,157
9/20/2013 7:22,8,100000,83,84,167
9/20/2013 7:22,8,100000,1063,90,1153
9/20/2013 7:22,8,100000,66,84,150
9/20/2013 7:22,8,100000,75,95,170
9/20/2013 7:22,8,100000,67,87,154
9/20/2013 7:22,8,100000,68,86,154
9/20/2013 7:22,8,100000,75,83,158
9/20/2013 7:22,8,100000,93,87,180
9/20/2013 7:22,8,100000,68,82,150
9/20/2013 7:22,8,100000,75,90,165
9/20/2013 7:22,8,100000,73,84,157
9/20/2013 7:22,8,100000,80,85,165
9/20/2013 7:22,8,100000,75,84,159
9/20/2013 7:22,8,100000,60,83,143
9/20/2013 7:23,8,100000,82,89,171
9/20/2013 7:23,8,100000,73,82,155
9/20/2013 7:23,8,100000,73,85,158
9/20/2013 7:23,8,100000,85,83,168
9/20/2013 7:23,8,100000,69,84,153
9/20/2013 7:23,8,100000,62,89,151
9/20/2013 7:23,8,100000,74,89,163
9/20/2013 7:23,8,100000,68,89,157
9/20/2013 7:23,8,100000,59,85,144
9/20/2013 7:23,8,100000,64,92,156
9/20/2013 7:23,8,100000,73,83,156
9/20/2013 7:23,8,100000,60,88,148
9/20/2013 7:23,8,100000,64,89,153
9/20/2013 7:23,8,100000,75,85,160
9/20/2013 7:23,8,100000,72,90,162
9/20/2013 7:23,8,100000,86,84,170
9/20/2013 7:23,8,100000,61,84,145
9/20/2013 7:23,8,100000,88,84,172
9/20/2013 7:23,8,100000,65,88,153
9/20/2013 7:23,8,100000,69,84,153
9/20/2013 7:23,8,100000,85,84,169
9/20/2013 7:23,8,100000,61,87,148
9/20/2013 7:23,8,100000,62,86,148
9/20/2013 7:23,8,100000,75,86,161
9/20/2013 7:23,8,100000,63,86,149
9/20/2013 7:23,8,100000,77,82,159
9/20/2013 7:23,8,100000,65,88,153
9/20/2013 7:23,8,100000,1050,84,1134
9/20/2013 7:23,8,100000,69,85,154
9/20/2013 7:24,8,100000,61,82,143
9/20/2013 7:24,8,100000,82,89,171
9/20/2013 7:24,8,100000,65,87,152
9/20/2013 7:24,8,100000,59,87,146
9/20/2013 7:24,8,100000,74,85,159
9/20/2013 7:24,8,100000,74,84,158
9/20/2013 7:24,8,100000,67,87,154
9/20/2013 7:24,8,100000,57,84,141
9/20/2013 7:24,8,100000,88,89,177
9/20/2013 7:24,8,100000,63,86,149
9/20/2013 7:24,8,100000,1048,88,1136
9/20/2013 7:24,8,100000,75,82,157
9/20/2013 7:24,8,100000,1064,84,1148
9/20/2013 7:24,8,100000,84,84,168
9/20/2013 7:24,8,100000,57,87,144
9/20/2013 7:24,8,100000,76,85,161
9/20/2013 7:24,8,100000,78,86,164
9/20/2013 7:24,8,100000,68,86,154
9/20/2013 7:24,8,200000,93,106,199
9/20/2013 7:24,8,200000,109,101,210
9/20/2013 7:24,8,200000,105,99,204
9/20/2013 7:24,8,200000,101,113,214
9/20/2013 7:24,8,200000,103,102,205
9/20/2013 7:24,8,200000,98,107,205
9/20/2013 7:24,8,200000,96,101,197
9/20/2013 7:24,8,200000,92,104,196
9/20/2013 7:24,8,200000,96,107,203
9/20/2013 7:25,8,200000,78,108,186
9/20/2013 7:25,8,200000,97,100,197
9/20/2013 7:25,8,200000,113,108,221
9/20/2013 7:25,8,200000,97,105,202
9/20/2013 7:25,8,200000,89,110,199
9/20/2013 7:25,8,200000,99,102,201
9/20/2013 7:25,8,200000,112,113,225
9/20/2013 7:25,8,200000,93,101,194
9/20/2013 7:25,8,200000,117,105,222
9/20/2013 7:25,8,200000,89,108,197
9/20/2013 7:25,8,200000,97,106,203
9/20/2013 7:25,8,200000,87,112,199
9/20/2013 7:25,8,200000,102,109,211
9/20/2013 7:25,8,200000,114,103,217
9/20/2013 7:25,8,200000,94,110,204
9/20/2013 7:25,8,200000,95,110,205
9/20/2013 7:25,8,200000,106,108,214
9/20/2013 7:25,8,200000,106,106,212
9/20/2013 7:25,8,200000,107,108,215
9/20/2013 7:25,8,200000,111,107,218
9/20/2013 7:25,8,200000,99,109,208
9/20/2013 7:25,8,200000,95,109,204
9/20/2013 7:25,8,200000,94,104,198
9/20/2013 7:25,8,200000,112,97,209
9/20/2013 7:25,8,200000,103,105,208
9/20/2013 7:25,8,200000,103,104,207
9/20/2013 7:25,8,200000,111,105,216
9/20/2013 7:25,8,200000,100,105,205
9/20/2013 7:26,8,200000,1094,102,1196
9/20/2013 7:26,8,200000,114,104,218
9/20/2013 7:26,8,200000,103,115,218
9/20/2013 7:26,8,200000,105,108,213
9/20/2013 7:26,8,200000,87,100,187
9/20/2013 7:26,8,200000,84,109,193
9/20/2013 7:26,8,200000,86,111,197
9/20/2013 7:26,8,200000,1104,105,1209
9/20/2013 7:26,8,200000,101,104,205
9/20/2013 7:26,8,200000,126,103,229
9/20/2013 7:26,8,200000,1086,108,1194
9/20/2013 7:26,8,200000,83,103,186
9/20/2013 7:26,8,200000,103,106,209
9/20/2013 7:26,8,200000,106,107,213
9/20/2013 7:26,8,200000,94,112,206
9/20/2013 7:26,8,200000,91,102,193
9/20/2013 7:26,8,200000,97,111,208
9/20/2013 7:26,8,200000,99,111,210
9/20/2013 7:26,8,200000,92,102,194
9/20/2013 7:26,8,200000,108,102,210
9/20/2013 7:26,8,200000,101,106,207
9/20/2013 7:26,8,200000,135,102,237
9/20/2013 7:26,8,200000,93,104,197
9/20/2013 7:26,8,200000,119,101,220
9/20/2013 7:26,8,200000,117,108,225
9/20/2013 7:26,8,200000,112,108,220
9/20/2013 7:27,8,200000,98,104,202
9/20/2013 7:27,8,200000,95,108,203
9/20/2013 7:27,8,200000,104,105,209
9/20/2013 7:27,8,200000,1091,107,1198
9/20/2013 7:27,8,200000,111,109,220
9/20/2013 7:27,8,200000,102,107,209
9/20/2013 7:27,8,200000,109,107,216
9/20/2013 7:27,8,200000,1085,101,1186
9/20/2013 7:27,8,200000,111,108,219
9/20/2013 7:27,8,200000,116,104,220
9/20/2013 7:27,8,200000,103,107,210
9/20/2013 7:27,8,200000,105,106,211
9/20/2013 7:27,8,200000,103,107,210
9/20/2013 7:27,8,200000,121,108,229
9/20/2013 7:27,8,200000,104,112,216
9/20/2013 7:27,8,200000,110,112,222
9/20/2013 7:27,8,200000,105,102,207
9/20/2013 7:27,8,200000,101,103,204
9/20/2013 7:27,8,200000,113,106,219
9/20/2013 7:27,8,200000,100,102,202
9/20/2013 7:27,8,200000,104,106,210
9/20/2013 7:27,8,200000,107,107,214
9/20/2013 7:27,8,200000,111,109,220
9/20/2013 7:27,8,200000,110,100,210
9/20/2013 7:27,8,200000,114,99,213
9/20/2013 7:27,8,200000,100,109,209
9/20/2013 7:27,8,200000,107,105,212
9/20/2013 7:27,8,200000,81,105,186
9/20/2013 7:28,8,200000,119,112,231
9/20/2013 7:28,8,200000,96,105,201
9/20/2013 7:28,8,200000,126,104,230
9/20/2013 7:28,8,200000,102,109,211
9/20/2013 7:28,8,200000,91,104,195
9/20/2013 7:28,8,200000,111,108,219
9/20/2013 7:28,8,200000,96,103,199
9/20/2013 7:28,8,200000,104,102,206
9/20/2013 7:28,8,200000,98,109,207
9/20/2013 7:28,8,200000,99,109,208
9/20/2013 7:28,8,200000,1080,113,1193
9/20/2013 7:28,8,200000,106,108,214
9/20/2013 7:28,8,200000,86,104,190
9/20/2013 7:28,8,200000,114,108,222
9/20/2013 7:28,8,200000,117,106,223
9/20/2013 7:28,8,200000,110,104,214
9/20/2013 7:28,8,200000,97,107,204
9/20/2013 7:28,8,200000,1073,108,1181
9/20/2013 7:28,8,200000,77,108,185
9/20/2013 7:28,8,200000,114,106,220
9/20/2013 7:28,8,200000,99,103,202
9/20/2013 7:28,8,200000,109,106,215
9/20/2013 7:28,8,200000,113,102,215
9/20/2013 7:28,8,200000,101,106,207
9/20/2013 7:28,8,300000,121,130,251
9/20/2013 7:28,8,300000,98,126,224
9/20/2013 7:29,8,300000,117,128,245
9/20/2013 7:29,8,300000,138,122,260
9/20/2013 7:29,8,300000,107,127,234
9/20/2013 7:29,8,300000,118,125,243
9/20/2013 7:29,8,300000,108,124,232
9/20/2013 7:29,8,300000,124,129,253
9/20/2013 7:29,8,300000,108,124,232
9/20/2013 7:29,8,300000,132,124,256
9/20/2013 7:29,8,300000,142,128,270
9/20/2013 7:29,8,300000,111,126,237
9/20/2013 7:29,8,300000,118,124,242
9/20/2013 7:29,8,300000,112,131,243
9/20/2013 7:29,8,300000,132,123,255
9/20/2013 7:29,8,300000,151,123,274
9/20/2013 7:29,8,300000,135,126,261
9/20/2013 7:29,8,300000,105,125,230
9/20/2013 7:29,8,300000,125,132,257
9/20/2013 7:29,8,300000,107,127,234
9/20/2013 7:29,8,300000,99,123,222
9/20/2013 7:29,8,300000,124,123,247
9/20/2013 7:29,8,300000,118,125,243
9/20/2013 7:29,8,300000,118,125,243
9/20/2013 7:29,8,300000,112,131,243
9/20/2013 7:29,8,300000,119,127,246
9/20/2013 7:29,8,300000,134,126,260
9/20/2013 7:29,8,300000,146,126,272
9/20/2013 7:29,8,300000,120,124,244
9/20/2013 7:29,8,300000,136,126,262
9/20/2013 7:30,8,300000,118,129,247
9/20/2013 7:30,8,300000,133,121,254
9/20/2013 7:30,8,300000,110,130,240
9/20/2013 7:30,8,300000,123,130,253
9/20/2013 7:30,8,300000,123,128,251
9/20/2013 7:30,8,300000,113,121,234
9/20/2013 7:30,8,300000,105,134,239
9/20/2013 7:30,8,300000,111,127,238
9/20/2013 7:30,8,300000,115,129,244
9/20/2013 7:30,8,300000,116,127,243
9/20/2013 7:30,8,300000,147,127,274
9/20/2013 7:30,8,300000,118,126,244
9/20/2013 7:30,8,300000,120,130,250
9/20/2013 7:30,8,300000,116,127,243
9/20/2013 7:30,8,300000,109,131,240
9/20/2013 7:30,8,300000,91,128,219
9/20/2013 7:30,8,300000,120,125,245
9/20/2013 7:30,8,300000,88,129,217
9/20/2013 7:30,8,300000,134,124,258
9/20/2013 7:30,8,300000,142,126,268
9/20/2013 7:30,8,300000,130,132,262
9/20/2013 7:30,8,300000,1109,130,1239
9/20/2013 7:30,8,300000,122,124,246
9/20/2013 7:30,8,300000,116,122,238
9/20/2013 7:30,8,300000,123,130,253
9/20/2013 7:30,8,300000,114,129,243
9/20/2013 7:30,8,300000,110,125,235
9/20/2013 7:31,8,300000,129,122,251
9/20/2013 7:31,8,300000,129,129,258
9/20/2013 7:31,8,300000,115,123,238
9/20/2013 7:31,8,300000,110,135,245
9/20/2013 7:31,8,300000,125,124,249
9/20/2013 7:31,8,300000,113,126,239
9/20/2013 7:31,8,300000,131,130,261
9/20/2013 7:31,8,300000,102,128,230
9/20/2013 7:31,8,300000,122,127,249
9/20/2013 7:31,8,300000,136,132,268
9/20/2013 7:31,8,300000,113,123,236
9/20/2013 7:31,8,300000,122,132,254
9/20/2013 7:31,8,300000,122,126,248
9/20/2013 7:31,8,300000,115,126,241
9/20/2013 7:31,8,300000,1104,124,1228
9/20/2013 7:31,8,300000,113,130,243
9/20/2013 7:31,8,300000,137,131,268
9/20/2013 7:31,8,300000,1098,124,1222
9/20/2013 7:31,8,300000,146,126,272
9/20/2013 7:31,8,300000,1098,131,1229
9/20/2013 7:31,8,300000,137,122,259
9/20/2013 7:31,8,300000,110,130,240
9/20/2013 7:31,8,300000,1105,129,1234
9/20/2013 7:32,8,300000,1107,124,1231
9/20/2013 7:32,8,300000,98,132,230
9/20/2013 7:32,8,300000,110,133,243
9/20/2013 7:32,8,300000,129,127,256
9/20/2013 7:32,8,300000,103,128,231
9/20/2013 7:32,8,300000,115,127,242
9/20/2013 7:32,8,300000,129,150,279
9/20/2013 7:32,8,300000,127,124,251
9/20/2013 7:32,8,300000,106,129,235
9/20/2013 7:32,8,300000,136,127,263
9/20/2013 7:32,8,300000,131,130,261
9/20/2013 7:32,8,300000,117,134,251
9/20/2013 7:32,8,300000,114,132,246
9/20/2013 7:32,8,300000,120,124,244
9/20/2013 7:32,8,300000,141,129,270
9/20/2013 7:32,8,300000,119,126,245
9/20/2013 7:32,8,300000,125,125,250
9/20/2013 7:32,8,300000,107,127,234
9/20/2013 7:32,8,300000,129,125,254
9/20/2013 7:32,8,300000,123,126,249
9/20/2013 7:32,8,300000,130,125,255
9/20/2013 7:32,8,300000,132,131,263
9/20/2013 7:32,8,300000,122,131,253
9/20/2013 7:32,8,300000,105,127,232
9/20/2013 7:32,8,300000,119,137,256
9/20/2013 7:32,8,300000,120,122,242
9/20/2013 7:32,8,300000,115,130,245
9/20/2013 7:33,8,300000,116,127,243
9/20/2013 7:33,8,300000,114,126,240
9/20/2013 7:33,8,300000,121,131,252
9/20/2013 7:33,8,300000,145,129,274
9/20/2013 7:33,8,300000,128,127,255
9/20/2013 7:33,8,300000,119,128,247
9/20/2013 7:33,8,300000,99,128,227
9/20/2013 7:33,8,300000,123,129,252
9/20/2013 7:33,8,400000,123,146,269
9/20/2013 7:33,8,400000,142,146,288
9/20/2013 7:33,8,400000,127,148,275
9/20/2013 7:33,8,400000,149,143,292
9/20/2013 7:33,8,400000,121,141,262
9/20/2013 7:33,8,400000,139,172,311
9/20/2013 7:33,8,400000,140,140,280
9/20/2013 7:33,8,400000,1120,141,1261
9/20/2013 7:33,8,400000,134,140,274
9/20/2013 7:33,8,400000,146,149,295
9/20/2013 7:33,8,400000,155,143,298
9/20/2013 7:33,8,400000,135,143,278
9/20/2013 7:33,8,400000,145,142,287
9/20/2013 7:33,8,400000,118,141,259
9/20/2013 7:33,8,400000,131,148,279
9/20/2013 7:33,8,400000,183,142,325
9/20/2013 7:33,8,400000,1087,145,1232
9/20/2013 7:34,8,400000,134,144,278
9/20/2013 7:34,8,400000,117,183,300
9/20/2013 7:34,8,400000,147,179,326
9/20/2013 7:34,8,400000,1116,139,1255
9/20/2013 7:34,8,400000,152,139,291
9/20/2013 7:34,8,400000,122,144,266
9/20/2013 7:34,8,400000,128,145,273
9/20/2013 7:34,8,400000,164,142,306
9/20/2013 7:34,8,400000,104,140,244
9/20/2013 7:34,8,400000,1155,143,1298
9/20/2013 7:34,8,400000,159,151,310
9/20/2013 7:34,8,400000,140,140,280
9/20/2013 7:34,8,400000,127,139,266
9/20/2013 7:34,8,400000,151,142,293
9/20/2013 7:34,8,400000,126,138,264
9/20/2013 7:34,8,400000,1099,144,1243
9/20/2013 7:34,8,400000,123,135,258
9/20/2013 7:34,8,400000,155,145,300
9/20/2013 7:34,8,400000,143,171,314
9/20/2013 7:34,8,400000,137,141,278
9/20/2013 7:34,8,400000,127,148,275
9/20/2013 7:34,8,400000,158,138,296
9/20/2013 7:34,8,400000,122,145,267
9/20/2013 7:34,8,400000,1100,142,1242
9/20/2013 7:35,8,400000,116,146,262
9/20/2013 7:35,8,400000,123,141,264
9/20/2013 7:35,8,400000,112,178,290
9/20/2013 7:35,8,400000,135,147,282
9/20/2013 7:35,8,400000,120,143,263
9/20/2013 7:35,8,400000,129,146,275
9/20/2013 7:35,8,400000,134,173,307
9/20/2013 7:35,8,400000,151,141,292
9/20/2013 7:35,8,400000,149,147,296
9/20/2013 7:35,8,400000,134,143,277
9/20/2013 7:35,8,400000,153,142,295
9/20/2013 7:35,8,400000,182,139,321
9/20/2013 7:35,8,400000,131,141,272
9/20/2013 7:35,8,400000,127,139,266
9/20/2013 7:35,8,400000,137,143,280
9/20/2013 7:35,8,400000,158,136,294
9/20/2013 7:35,8,400000,124,145,269
9/20/2013 7:35,8,400000,146,147,293
9/20/2013 7:35,8,400000,123,173,296
9/20/2013 7:35,8,400000,106,139,245
9/20/2013 7:35,8,400000,135,138,273
9/20/2013 7:35,8,400000,162,144,306
9/20/2013 7:35,8,400000,139,146,285
9/20/2013 7:35,8,400000,133,143,276
9/20/2013 7:35,8,400000,140,147,287
9/20/2013 7:35,8,400000,136,143,279
9/20/2013 7:36,8,400000,163,134,297
9/20/2013 7:36,8,400000,120,139,259
9/20/2013 7:36,8,400000,129,144,273
9/20/2013 7:36,8,400000,127,140,267
9/20/2013 7:36,8,400000,120,144,264
9/20/2013 7:36,8,400000,166,143,309
9/20/2013 7:36,8,400000,140,143,283
9/20/2013 7:36,8,400000,140,149,289
9/20/2013 7:36,8,400000,118,148,266
9/20/2013 7:36,8,400000,129,143,272
9/20/2013 7:36,8,400000,159,140,299
9/20/2013 7:36,8,400000,112,145,257
9/20/2013 7:36,8,400000,129,139,268
9/20/2013 7:36,8,400000,171,150,321
9/20/2013 7:36,8,400000,117,145,262
9/20/2013 7:36,8,400000,147,141,288
9/20/2013 7:36,8,400000,1145,142,1287
9/20/2013 7:36,8,400000,124,141,265
9/20/2013 7:36,8,400000,125,142,267
9/20/2013 7:36,8,400000,114,142,256
9/20/2013 7:36,8,400000,171,148,319
9/20/2013 7:36,8,400000,152,142,294
9/20/2013 7:36,8,400000,139,140,279
9/20/2013 7:36,8,400000,157,141,298
9/20/2013 7:36,8,400000,142,146,288
9/20/2013 7:36,8,400000,147,146,293
9/20/2013 7:37,8,400000,174,143,317
9/20/2013 7:37,8,400000,156,143,299
9/20/2013 7:37,8,400000,133,142,275
9/20/2013 7:37,8,400000,1085,142,1227
9/20/2013 7:37,8,400000,120,142,262
9/20/2013 7:37,8,400000,125,145,270
9/20/2013 7:37,8,400000,126,145,271
9/20/2013 7:37,8,400000,107,140,247
9/20/2013 7:37,8,400000,132,144,276
9/20/2013 7:37,8,400000,147,141,288
9/20/2013 7:37,8,400000,151,142,293
9/20/2013 7:37,8,400000,128,146,274
9/20/2013 7:37,8,400000,123,181,304
9/20/2013 7:37,8,400000,139,140,279
9/20/2013 7:37,8,400000,135,141,276
9/20/2013 7:37,8,400000,173,148,321
9/20/2013 7:37,8,400000,135,143,278
9/20/2013 7:37,8,400000,171,141,312
9/20/2013 7:37,8,400000,135,145,280
9/20/2013 7:37,8,400000,162,143,305
9/20/2013 7:37,8,400000,136,140,276
9/20/2013 7:37,8,400000,139,146,285
9/20/2013 7:37,8,500000,191,164,355
9/20/2013 7:37,8,500000,167,162,329
9/20/2013 7:37,8,500000,220,165,385
9/20/2013 7:37,8,500000,181,165,346
9/20/2013 7:37,8,500000,178,163,341
9/20/2013 7:38,8,500000,170,160,330
9/20/2013 7:38,8,500000,129,202,331
9/20/2013 7:38,8,500000,158,195,353
9/20/2013 7:38,8,500000,173,166,339
9/20/2013 7:38,8,500000,135,200,335
9/20/2013 7:38,8,500000,215,163,378
9/20/2013 7:38,8,500000,179,158,337
9/20/2013 7:38,8,500000,199,162,361
9/20/2013 7:38,8,500000,210,162,372
9/20/2013 7:38,8,500000,166,197,363
9/20/2013 7:38,8,500000,203,199,402
9/20/2013 7:38,8,500000,184,162,346
9/20/2013 7:38,8,500000,155,197,352
9/20/2013 7:38,8,500000,189,163,352
9/20/2013 7:38,8,500000,131,197,328
9/20/2013 7:38,8,500000,155,199,354
9/20/2013 7:38,8,500000,189,190,379
9/20/2013 7:38,8,500000,196,158,354
9/20/2013 7:38,8,500000,146,198,344
9/20/2013 7:38,8,500000,142,190,332
9/20/2013 7:38,8,500000,133,194,327
9/20/2013 7:38,8,500000,171,164,335
9/20/2013 7:38,8,500000,198,156,354
9/20/2013 7:38,8,500000,168,161,329
9/20/2013 7:38,8,500000,187,155,342
9/20/2013 7:38,8,500000,149,198,347
9/20/2013 7:39,8,500000,171,161,332
9/20/2013 7:39,8,500000,131,196,327
9/20/2013 7:39,8,500000,157,194,351
9/20/2013 7:39,8,500000,204,165,369
9/20/2013 7:39,8,500000,185,167,352
9/20/2013 7:39,8,500000,173,197,370
9/20/2013 7:39,8,500000,194,165,359
9/20/2013 7:39,8,500000,163,157,320
9/20/2013 7:39,8,500000,1101,194,1295
9/20/2013 7:39,8,500000,178,158,336
9/20/2013 7:39,8,500000,1130,195,1325
9/20/2013 7:39,8,500000,219,156,375
9/20/2013 7:39,8,500000,143,201,344
9/20/2013 7:39,8,500000,178,164,342
9/20/2013 7:39,8,500000,159,163,322
9/20/2013 7:39,8,500000,141,190,331
9/20/2013 7:39,8,500000,149,201,350
9/20/2013 7:39,8,500000,155,206,361
9/20/2013 7:39,8,500000,148,191,339
9/20/2013 7:39,8,500000,138,202,340
9/20/2013 7:39,8,500000,178,159,337
9/20/2013 7:39,8,500000,170,159,329
9/20/2013 7:39,8,500000,182,199,381
9/20/2013 7:39,8,500000,128,204,332
9/20/2013 7:39,8,500000,141,196,337
9/20/2013 7:40,8,500000,171,160,331
9/20/2013 7:40,8,500000,184,200,384
9/20/2013 7:40,8,500000,154,193,347
9/20/2013 7:40,8,500000,187,161,348
9/20/2013 7:40,8,500000,174,164,338
9/20/2013 7:40,8,500000,149,196,345
9/20/2013 7:40,8,500000,138,205,343
9/20/2013 7:40,8,500000,174,165,339
9/20/2013 7:40,8,500000,213,194,407
9/20/2013 7:40,8,500000,144,205,349
9/20/2013 7:40,8,500000,196,160,356
9/20/2013 7:40,8,500000,159,162,321
9/20/2013 7:40,8,500000,163,200,363
9/20/2013 7:40,8,500000,191,161,352
9/20/2013 7:40,8,500000,151,192,343
9/20/2013 7:40,8,500000,160,163,323
9/20/2013 7:40,8,500000,189,194,383
9/20/2013 7:40,8,500000,129,195,324
9/20/2013 7:40,8,500000,155,194,349
9/20/2013 7:40,8,500000,210,158,368
9/20/2013 7:40,8,500000,172,155,327
9/20/2013 7:40,8,500000,1124,193,1317
9/20/2013 7:40,8,500000,143,196,339
9/20/2013 7:40,8,500000,1102,198,1300
9/20/2013 7:40,8,500000,214,165,379
9/20/2013 7:41,8,500000,185,161,346
9/20/2013 7:41,8,500000,171,193,364
9/20/2013 7:41,8,500000,231,159,390
9/20/2013 7:41,8,500000,143,199,342
9/20/2013 7:41,8,500000,159,158,317
9/20/2013 7:41,8,500000,159,163,322
9/20/2013 7:41,8,500000,150,160,310
9/20/2013 7:41,8,500000,152,197,349
9/20/2013 7:41,8,500000,192,164,356
9/20/2013 7:41,8,500000,192,160,352
9/20/2013 7:41,8,500000,159,198,357
9/20/2013 7:41,8,500000,176,200,376
9/20/2013 7:41,8,500000,212,162,374
9/20/2013 7:41,8,500000,210,166,376
9/20/2013 7:41,8,500000,188,162,350
9/20/2013 7:41,8,500000,143,202,345
9/20/2013 7:41,8,500000,161,159,320
9/20/2013 7:41,8,500000,168,156,324
9/20/2013 7:41,8,500000,230,163,393
9/20/2013 7:41,8,500000,134,192,326
9/20/2013 7:41,8,500000,170,161,331
9/20/2013 7:41,8,500000,168,202,370
9/20/2013 7:41,8,500000,165,197,362
9/20/2013 7:41,8,500000,196,165,361
9/20/2013 7:41,8,500000,167,200,367
9/20/2013 7:41,8,500000,173,162,335
9/20/2013 7:42,8,500000,150,161,311
9/20/2013 7:42,8,500000,133,194,327
9/20/2013 7:42,8,500000,171,156,327
9/20/2013 7:42,8,500000,190,160,350
9/20/2013 7:42,8,500000,1127,199,1326
9/20/2013 7:42,8,500000,147,194,341
9/20/2013 7:42,8,500000,148,199,347
9/20/2013 7:42,8,500000,165,163,328
9/20/2013 7:42,8,600000,187,199,386
9/20/2013 7:42,8,600000,169,210,379
9/20/2013 7:42,8,600000,164,179,343
9/20/2013 7:42,8,600000,211,173,384
9/20/2013 7:42,8,600000,162,174,336
9/20/2013 7:42,8,600000,210,177,387
9/20/2013 7:42,8,600000,190,175,365
9/20/2013 7:42,8,600000,176,196,372
9/20/2013 7:42,8,600000,167,175,342
9/20/2013 7:42,8,600000,152,174,326
9/20/2013 7:42,8,600000,206,196,402
9/20/2013 7:42,8,600000,198,173,371
9/20/2013 7:42,8,600000,182,175,357
9/20/2013 7:42,8,600000,1152,197,1349
9/20/2013 7:42,8,600000,163,197,360
9/20/2013 7:42,8,600000,197,177,374
9/20/2013 7:43,8,600000,166,183,349
9/20/2013 7:43,8,600000,193,172,365
9/20/2013 7:43,8,600000,182,196,378
9/20/2013 7:43,8,600000,168,180,348
9/20/2013 7:43,8,600000,181,174,355
9/20/2013 7:43,8,600000,1164,178,1342
9/20/2013 7:43,8,600000,183,181,364
9/20/2013 7:43,8,600000,166,208,374
9/20/2013 7:43,8,600000,205,199,404
9/20/2013 7:43,8,600000,184,180,364
9/20/2013 7:43,8,600000,193,199,392
9/20/2013 7:43,8,600000,194,175,369
9/20/2013 7:43,8,600000,180,175,355
9/20/2013 7:43,8,600000,198,183,381
9/20/2013 7:43,8,600000,216,175,391
9/20/2013 7:43,8,600000,193,177,370
9/20/2013 7:43,8,600000,192,193,385
9/20/2013 7:43,8,600000,191,199,390
9/20/2013 7:43,8,600000,184,182,366
9/20/2013 7:43,8,600000,165,182,347
9/20/2013 7:43,8,600000,187,199,386
9/20/2013 7:43,8,600000,171,173,344
9/20/2013 7:43,8,600000,175,172,347
9/20/2013 7:43,8,600000,213,198,411
9/20/2013 7:43,8,600000,194,170,364
9/20/2013 7:44,8,600000,230,175,405
9/20/2013 7:44,8,600000,207,174,381
9/20/2013 7:44,8,600000,158,181,339
9/20/2013 7:44,8,600000,202,192,394
9/20/2013 7:44,8,600000,200,179,379
9/20/2013 7:44,8,600000,211,178,389
9/20/2013 7:44,8,600000,193,174,367
9/20/2013 7:44,8,600000,175,177,352
9/20/2013 7:44,8,600000,187,194,381
9/20/2013 7:44,8,600000,216,176,392
9/20/2013 7:44,8,600000,162,174,336
9/20/2013 7:44,8,600000,196,179,375
9/20/2013 7:44,8,600000,181,214,395
9/20/2013 7:44,8,600000,185,199,384
9/20/2013 7:44,8,600000,220,197,417
9/20/2013 7:44,8,600000,162,180,342
9/20/2013 7:44,8,600000,204,200,404
9/20/2013 7:44,8,600000,182,194,376
9/20/2013 7:44,8,600000,181,181,362
9/20/2013 7:44,8,600000,207,178,385
9/20/2013 7:44,8,600000,190,175,365
9/20/2013 7:44,8,600000,174,177,351
9/20/2013 7:44,8,600000,188,197,385
9/20/2013 7:44,8,600000,219,176,395
9/20/2013 7:44,8,600000,196,175,371
9/20/2013 7:44,8,600000,178,199,377
9/20/2013 7:45,8,600000,171,181,352
9/20/2013 7:45,8,600000,1175,202,1377
9/20/2013 7:45,8,600000,195,174,369
9/20/2013 7:45,8,600000,235,176,411
9/20/2013 7:45,8,600000,174,180,354
9/20/2013 7:45,8,600000,179,175,354
9/20/2013 7:45,8,600000,209,179,388
9/20/2013 7:45,8,600000,215,194,409
9/20/2013 7:45,8,600000,161,195,356
9/20/2013 7:45,8,600000,210,195,405
9/20/2013 7:45,8,600000,186,172,358
9/20/2013 7:45,8,600000,190,195,385
9/20/2013 7:45,8,600000,191,177,368
9/20/2013 7:45,8,600000,174,176,350
9/20/2013 7:45,8,600000,194,181,375
9/20/2013 7:45,8,600000,233,198,431
9/20/2013 7:45,8,600000,188,192,380
9/20/2013 7:45,8,600000,164,196,360
9/20/2013 7:45,8,600000,1153,202,1355
9/20/2013 7:45,8,600000,168,175,343
9/20/2013 7:45,8,600000,168,182,350
9/20/2013 7:45,8,600000,200,198,398
9/20/2013 7:45,8,600000,222,193,415
9/20/2013 7:45,8,600000,192,174,366
9/20/2013 7:46,8,600000,186,179,365
9/20/2013 7:46,8,600000,226,177,403
9/20/2013 7:46,8,600000,202,180,382
9/20/2013 7:46,8,600000,196,194,390
9/20/2013 7:46,8,600000,1159,176,1335
9/20/2013 7:46,8,600000,182,173,355
9/20/2013 7:46,8,600000,173,182,355
9/20/2013 7:46,8,600000,178,178,356
9/20/2013 7:46,8,600000,182,197,379
9/20/2013 7:46,8,600000,188,186,374
9/20/2013 7:46,8,600000,196,176,372
9/20/2013 7:46,8,600000,180,184,364
9/20/2013 7:46,8,600000,179,195,374
9/20/2013 7:46,8,600000,181,177,358
9/20/2013 7:46,8,600000,174,192,366
9/20/2013 7:46,8,600000,256,172,428
9/20/2013 7:46,8,600000,188,171,359
9/20/2013 7:46,8,600000,1189,201,1390
9/20/2013 7:46,8,600000,203,178,381
9/20/2013 7:46,8,600000,167,203,370
9/20/2013 7:46,8,600000,154,214,368
9/20/2013 7:46,8,600000,197,204,401
9/20/2013 7:46,8,600000,171,195,366
9/20/2013 7:46,8,600000,207,179,386
9/20/2013 7:46,8,700000,216,194,410
9/20/2013 7:47,8,700000,223,197,420
9/20/2013 7:47,8,700000,210,202,412
9/20/2013 7:47,8,700000,198,195,393
9/20/2013 7:47,8,700000,201,194,395
9/20/2013 7:47,8,700000,205,192,397
9/20/2013 7:47,8,700000,203,195,398
9/20/2013 7:47,8,700000,197,197,394
9/20/2013 7:47,8,700000,202,194,396
9/20/2013 7:47,8,700000,185,202,387
9/20/2013 7:47,8,700000,188,207,395
9/20/2013 7:47,8,700000,189,195,384
9/20/2013 7:47,8,700000,203,192,395
9/20/2013 7:47,8,700000,246,200,446
9/20/2013 7:47,8,700000,226,193,419
9/20/2013 7:47,8,700000,188,200,388
9/20/2013 7:47,8,700000,226,196,422
9/20/2013 7:47,8,700000,208,212,420
9/20/2013 7:47,8,700000,227,197,424
9/20/2013 7:47,8,700000,167,190,357
9/20/2013 7:47,8,700000,203,197,400
9/20/2013 7:47,8,700000,194,200,394
9/20/2013 7:47,8,700000,190,191,381
9/20/2013 7:47,8,700000,214,200,414
9/20/2013 7:47,8,700000,199,192,391
9/20/2013 7:47,8,700000,194,198,392
9/20/2013 7:48,8,700000,1153,194,1347
9/20/2013 7:48,8,700000,183,202,385
9/20/2013 7:48,8,700000,189,195,384
9/20/2013 7:48,8,700000,212,196,408
9/20/2013 7:48,8,700000,182,196,378
9/20/2013 7:48,8,700000,188,197,385
9/20/2013 7:48,8,700000,201,194,395
9/20/2013 7:48,8,700000,204,205,409
9/20/2013 7:48,8,700000,187,197,384
9/20/2013 7:48,8,700000,229,190,419
9/20/2013 7:48,8,700000,201,196,397
9/20/2013 7:48,8,700000,189,202,391
9/20/2013 7:48,8,700000,223,195,418
9/20/2013 7:48,8,700000,182,200,382
9/20/2013 7:48,8,700000,194,199,393
9/20/2013 7:48,8,700000,204,196,400
9/20/2013 7:48,8,700000,190,200,390
9/20/2013 7:48,8,700000,204,194,398
9/20/2013 7:48,8,700000,197,198,395
9/20/2013 7:48,8,700000,168,201,369
9/20/2013 7:48,8,700000,165,204,369
9/20/2013 7:48,8,700000,222,194,416
9/20/2013 7:48,8,700000,221,202,423
9/20/2013 7:48,8,700000,188,196,384
9/20/2013 7:49,8,700000,218,196,414
9/20/2013 7:49,8,700000,195,197,392
9/20/2013 7:49,8,700000,168,201,369
9/20/2013 7:49,8,700000,197,200,397
9/20/2013 7:49,8,700000,195,201,396
9/20/2013 7:49,8,700000,190,194,384
9/20/2013 7:49,8,700000,201,197,398
9/20/2013 7:49,8,700000,197,197,394
9/20/2013 7:49,8,700000,205,200,405
9/20/2013 7:49,8,700000,189,195,384
9/20/2013 7:49,8,700000,188,201,389
9/20/2013 7:49,8,700000,203,196,399
9/20/2013 7:49,8,700000,175,193,368
9/20/2013 7:49,8,700000,200,201,401
9/20/2013 7:49,8,700000,243,198,441
9/20/2013 7:49,8,700000,185,200,385
9/20/2013 7:49,8,700000,262,195,457
9/20/2013 7:49,8,700000,207,198,405
9/20/2013 7:49,8,700000,172,202,374
9/20/2013 7:49,8,700000,199,195,394
9/20/2013 7:49,8,700000,246,201,447
9/20/2013 7:49,8,700000,219,198,417
9/20/2013 7:49,8,700000,201,195,396
9/20/2013 7:49,8,700000,187,205,392
9/20/2013 7:49,8,700000,182,190,372
9/20/2013 7:50,8,700000,1164,199,1363
9/20/2013 7:50,8,700000,172,200,372
9/20/2013 7:50,8,700000,170,195,365
9/20/2013 7:50,8,700000,177,206,383
9/20/2013 7:50,8,700000,1162,198,1360
9/20/2013 7:50,8,700000,1163,197,1360
9/20/2013 7:50,8,700000,224,196,420
9/20/2013 7:50,8,700000,177,194,371
9/20/2013 7:50,8,700000,204,203,407
9/20/2013 7:50,8,700000,185,198,383
9/20/2013 7:50,8,700000,240,196,436
9/20/2013 7:50,8,700000,216,195,411
9/20/2013 7:50,8,700000,219,194,413
9/20/2013 7:50,8,700000,193,200,393
9/20/2013 7:50,8,700000,207,199,406
9/20/2013 7:50,8,700000,198,198,396
9/20/2013 7:50,8,700000,193,200,393
9/20/2013 7:50,8,700000,1178,191,1369
9/20/2013 7:50,8,700000,228,195,423
9/20/2013 7:50,8,700000,197,196,393
9/20/2013 7:50,8,700000,1158,195,1353
9/20/2013 7:50,8,700000,233,193,426
9/20/2013 7:51,8,700000,192,196,388
9/20/2013 7:51,8,700000,196,196,392
9/20/2013 7:51,8,700000,203,190,393
9/20/2013 7:51,8,700000,159,201,360
9/20/2013 7:51,8,700000,187,193,380
9/20/2013 7:51,8,700000,253,203,456
9/20/2013 7:51,8,700000,178,195,373
9/20/2013 7:51,8,700000,198,195,393
9/20/2013 7:51,8,700000,197,198,395
9/20/2013 7:51,8,700000,171,196,367
9/20/2013 7:51,8,700000,216,194,410
9/20/2013 7:51,8,700000,194,199,393
9/20/2013 7:51,8,700000,189,206,395
9/20/2013 7:51,8,700000,181,196,377
9/20/2013 7:51,8,700000,250,202,452
9/20/2013 7:51,8,700000,201,193,394
9/20/2013 7:51,8,700000,196,198,394
9/20/2013 7:51,8,700000,210,197,407
9/20/2013 7:51,8,800000,1172,230,1402
9/20/2013 7:51,8,800000,182,220,402
9/20/2013 7:51,8,800000,225,224,449
9/20/2013 7:51,8,800000,211,223,434
9/20/2013 7:51,8,800000,225,221,446
9/20/2013 7:52,8,800000,270,224,494
9/20/2013 7:52,8,800000,252,221,473
9/20/2013 7:52,8,800000,165,221,386
9/20/2013 7:52,8,800000,229,227,456
9/20/2013 7:52,8,800000,208,227,435
9/20/2013 7:52,8,800000,1204,222,1426
9/20/2013 7:52,8,800000,202,227,429
9/20/2013 7:52,8,800000,216,221,437
9/20/2013 7:52,8,800000,237,229,466
9/20/2013 7:52,8,800000,232,231,463
9/20/2013 7:52,8,800000,191,230,421
9/20/2013 7:52,8,800000,197,212,409
9/20/2013 7:52,8,800000,204,225,429
9/20/2013 7:52,8,800000,250,223,473
9/20/2013 7:52,8,800000,238,226,464
9/20/2013 7:52,8,800000,226,228,454
9/20/2013 7:52,8,800000,198,235,433
9/20/2013 7:52,8,800000,248,222,470
9/20/2013 7:52,8,800000,196,235,431
9/20/2013 7:52,8,800000,216,223,439
9/20/2013 7:52,8,800000,208,225,433
9/20/2013 7:52,8,800000,188,236,424
9/20/2013 7:52,8,800000,222,222,444
9/20/2013 7:53,8,800000,180,227,407
9/20/2013 7:53,8,800000,202,229,431
9/20/2013 7:53,8,800000,212,224,436
9/20/2013 7:53,8,800000,204,220,424
9/20/2013 7:53,8,800000,206,221,427
9/20/2013 7:53,8,800000,173,220,393
9/20/2013 7:53,8,800000,177,223,400
9/20/2013 7:53,8,800000,1152,221,1373
9/20/2013 7:53,8,800000,1165,228,1393
9/20/2013 7:53,8,800000,212,219,431
9/20/2013 7:53,8,800000,174,226,400
9/20/2013 7:53,8,800000,217,224,441
9/20/2013 7:53,8,800000,1162,238,1400
9/20/2013 7:53,8,800000,216,224,440
9/20/2013 7:53,8,800000,201,233,434
9/20/2013 7:53,8,800000,217,225,442
9/20/2013 7:53,8,800000,202,221,423
9/20/2013 7:53,8,800000,190,233,423
9/20/2013 7:53,8,800000,185,222,407
9/20/2013 7:53,8,800000,232,220,452
9/20/2013 7:53,8,800000,207,222,429
9/20/2013 7:53,8,800000,229,225,454
9/20/2013 7:53,8,800000,216,232,448
9/20/2013 7:54,8,800000,216,230,446
9/20/2013 7:54,8,800000,218,229,447
9/20/2013 7:54,8,800000,208,232,440
9/20/2013 7:54,8,800000,188,237,425
9/20/2013 7:54,8,800000,252,218,470
9/20/2013 7:54,8,800000,266,225,491
9/20/2013 7:54,8,800000,196,234,430
9/20/2013 7:54,8,800000,190,231,421
9/20/2013 7:54,8,800000,201,229,430
9/20/2013 7:54,8,800000,191,234,425
9/20/2013 7:54,8,800000,219,223,442
9/20/2013 7:54,8,800000,223,239,462
9/20/2013 7:54,8,800000,202,221,423
9/20/2013 7:54,8,800000,220,225,445
9/20/2013 7:54,8,800000,236,226,462
9/20/2013 7:54,8,800000,216,229,445
9/20/2013 7:54,8,800000,205,230,435
9/20/2013 7:54,8,800000,232,221,453
9/20/2013 7:54,8,800000,247,230,477
9/20/2013 7:54,8,800000,1134,240,1374
9/20/2013 7:54,8,800000,1194,226,1420
9/20/2013 7:54,8,800000,1191,224,1415
9/20/2013 7:54,8,800000,225,226,451
9/20/2013 7:54,8,800000,200,230,430
9/20/2013 7:55,8,800000,210,227,437
9/20/2013 7:55,8,800000,218,226,444
9/20/2013 7:55,8,800000,186,237,423
9/20/2013 7:55,8,800000,277,225,502
9/20/2013 7:55,8,800000,205,232,437
9/20/2013 7:55,8,800000,211,225,436
9/20/2013 7:55,8,800000,186,222,408
9/20/2013 7:55,8,800000,185,232,417
9/20/2013 7:55,8,800000,219,227,446
9/20/2013 7:55,8,800000,189,225,414
9/20/2013 7:55,8,800000,210,232,442
9/20/2013 7:55,8,800000,207,224,431
9/20/2013 7:55,8,800000,199,224,423
9/20/2013 7:55,8,800000,189,227,416
9/20/2013 7:55,8,800000,208,233,441
9/20/2013 7:55,8,800000,199,222,421
9/20/2013 7:55,8,800000,227,235,462
9/20/2013 7:55,8,800000,229,226,455
9/20/2013 7:55,8,800000,1188,239,1427
9/20/2013 7:55,8,800000,210,232,442
9/20/2013 7:55,8,800000,234,227,461
9/20/2013 7:55,8,800000,193,230,423
9/20/2013 7:55,8,800000,219,236,455
9/20/2013 7:55,8,800000,207,233,440
9/20/2013 7:56,8,800000,197,222,419
9/20/2013 7:56,8,800000,214,231,445
9/20/2013 7:56,8,800000,202,244,446
9/20/2013 7:56,8,800000,241,238,479
9/20/2013 7:56,8,800000,203,237,440
9/20/2013 7:56,8,800000,180,224,404
9/20/2013 7:56,8,800000,201,231,432
9/20/2013 7:56,8,800000,205,223,428
9/20/2013 7:56,8,800000,221,219,440
9/20/2013 7:56,8,800000,212,230,442
9/20/2013 7:56,8,800000,1168,241,1409
9/20/2013 7:56,8,800000,220,228,448
9/20/2013 7:56,8,800000,214,227,441
9/20/2013 7:56,8,800000,186,238,424
9/20/2013 7:56,8,800000,217,224,441
9/20/2013 7:56,8,800000,198,231,429
9/20/2013 7:56,8,900000,268,248,516
9/20/2013 7:56,8,900000,204,244,448
9/20/2013 7:56,8,900000,213,247,460
9/20/2013 7:56,8,900000,210,246,456
9/20/2013 7:56,8,900000,205,250,455
9/20/2013 7:56,8,900000,196,251,447
9/20/2013 7:56,8,900000,214,248,462
9/20/2013 7:56,8,900000,209,246,455
9/20/2013 7:57,8,900000,264,245,509
9/20/2013 7:57,8,900000,220,243,463
9/20/2013 7:57,8,900000,236,245,481
9/20/2013 7:57,8,900000,225,245,470
9/20/2013 7:57,8,900000,227,255,482
9/20/2013 7:57,8,900000,220,256,476
9/20/2013 7:57,8,900000,226,246,472
9/20/2013 7:57,8,900000,205,252,457
9/20/2013 7:57,8,900000,217,244,461
9/20/2013 7:57,8,900000,274,260,534
9/20/2013 7:57,8,900000,216,246,462
9/20/2013 7:57,8,900000,249,243,492
9/20/2013 7:57,8,900000,228,243,471
9/20/2013 7:57,8,900000,235,253,488
9/20/2013 7:57,8,900000,214,247,461
9/20/2013 7:57,8,900000,215,241,456
9/20/2013 7:57,8,900000,248,249,497
9/20/2013 7:57,8,900000,236,255,491
9/20/2013 7:57,8,900000,223,244,467
9/20/2013 7:57,8,900000,222,250,472
9/20/2013 7:57,8,900000,223,244,467
9/20/2013 7:57,8,900000,230,251,481
9/20/2013 7:57,8,900000,216,242,458
9/20/2013 7:58,8,900000,220,242,462
9/20/2013 7:58,8,900000,262,255,517
9/20/2013 7:58,8,900000,209,259,468
9/20/2013 7:58,8,900000,229,255,484
9/20/2013 7:58,8,900000,295,251,546
9/20/2013 7:58,8,900000,266,242,508
9/20/2013 7:58,8,900000,225,259,484
9/20/2013 7:58,8,900000,239,245,484
9/20/2013 7:58,8,900000,237,243,480
9/20/2013 7:58,8,900000,231,255,486
9/20/2013 7:58,8,900000,242,259,501
9/20/2013 7:58,8,900000,253,249,502
9/20/2013 7:58,8,900000,222,246,468
9/20/2013 7:58,8,900000,221,245,466
9/20/2013 7:58,8,900000,1162,252,1414
9/20/2013 7:58,8,900000,271,246,517
9/20/2013 7:58,8,900000,190,252,442
9/20/2013 7:58,8,900000,280,246,526
9/20/2013 7:58,8,900000,214,247,461
9/20/2013 7:58,8,900000,250,243,493
9/20/2013 7:58,8,900000,203,254,457
9/20/2013 7:58,8,900000,197,257,454
9/20/2013 7:58,8,900000,234,253,487
9/20/2013 7:58,8,900000,228,243,471
9/20/2013 7:59,8,900000,221,246,467
9/20/2013 7:59,8,900000,268,243,511
9/20/2013 7:59,8,900000,219,252,471
9/20/2013 7:59,8,900000,232,240,472
9/20/2013 7:59,8,900000,247,252,499
9/20/2013 7:59,8,900000,230,248,478
9/20/2013 7:59,8,900000,235,243,478
9/20/2013 7:59,8,900000,219,249,468
9/20/2013 7:59,8,900000,252,247,499
9/20/2013 7:59,8,900000,197,256,453
9/20/2013 7:59,8,900000,230,247,477
9/20/2013 7:59,8,900000,198,246,444
9/20/2013 7:59,8,900000,185,257,442
9/20/2013 7:59,8,900000,231,250,481
9/20/2013 7:59,8,900000,1232,260,1492
9/20/2013 7:59,8,900000,1188,245,1433
9/20/2013 7:59,8,900000,1163,243,1406
9/20/2013 7:59,8,900000,226,253,479
9/20/2013 7:59,8,900000,263,247,510
9/20/2013 7:59,8,900000,233,245,478
9/20/2013 7:59,8,900000,228,242,470
9/20/2013 8:00,8,900000,246,261,507
9/20/2013 8:00,8,900000,230,248,478
9/20/2013 8:00,8,900000,224,244,468
9/20/2013 8:00,8,900000,192,253,445
9/20/2013 8:00,8,900000,209,249,458
9/20/2013 8:00,8,900000,193,253,446
9/20/2013 8:00,8,900000,239,255,494
9/20/2013 8:00,8,900000,242,244,486
9/20/2013 8:00,8,900000,244,241,485
9/20/2013 8:00,8,900000,212,256,468
9/20/2013 8:00,8,900000,191,255,446
9/20/2013 8:00,8,900000,271,250,521
9/20/2013 8:00,8,900000,230,253,483
9/20/2013 8:00,8,900000,200,251,451
9/20/2013 8:00,8,900000,214,243,457
9/20/2013 8:00,8,900000,244,248,492
9/20/2013 8:00,8,900000,235,249,484
9/20/2013 8:00,8,900000,201,253,454
9/20/2013 8:00,8,900000,214,247,461
9/20/2013 8:00,8,900000,228,257,485
9/20/2013 8:00,8,900000,202,256,458
9/20/2013 8:00,8,900000,192,245,437
9/20/2013 8:00,8,900000,246,240,486
9/20/2013 8:00,8,900000,239,244,483
9/20/2013 8:00,8,900000,240,250,490
9/20/2013 8:01,8,900000,201,246,447
9/20/2013 8:01,8,900000,212,255,467
9/20/2013 8:01,8,900000,200,247,447
9/20/2013 8:01,8,900000,216,244,460
9/20/2013 8:01,8,900000,217,242,459
9/20/2013 8:01,8,900000,205,251,456
9/20/2013 8:01,8,900000,267,244,511
9/20/2013 8:01,8,900000,207,286,493
9/20/2013 8:01,8,900000,224,245,469
9/20/2013 8:01,8,900000,195,248,443
9/20/2013 8:01,8,900000,208,251,459
9/20/2013 8:01,8,900000,243,249,492
9/20/2013 8:01,8,900000,256,254,510
9/20/2013 8:01,8,900000,197,251,448
9/20/2013 8:01,8,1000000,219,258,477
9/20/2013 8:01,8,1000000,269,253,522
9/20/2013 8:01,8,1000000,242,251,493
9/20/2013 8:01,8,1000000,211,252,463
9/20/2013 8:01,8,1000000,285,265,550
9/20/2013 8:01,8,1000000,210,259,469
9/20/2013 8:01,8,1000000,230,264,494
9/20/2013 8:01,8,1000000,241,261,502
9/20/2013 8:01,8,1000000,195,300,495
9/20/2013 8:01,8,1000000,223,264,487
9/20/2013 8:02,8,1000000,217,266,483
9/20/2013 8:02,8,1000000,263,263,526
9/20/2013 8:02,8,1000000,227,254,481
9/20/2013 8:02,8,1000000,270,265,535
9/20/2013 8:02,8,1000000,274,258,532
9/20/2013 8:02,8,1000000,233,266,499
9/20/2013 8:02,8,1000000,253,264,517
9/20/2013 8:02,8,1000000,209,270,479
9/20/2013 8:02,8,1000000,247,262,509
9/20/2013 8:02,8,1000000,240,260,500
9/20/2013 8:02,8,1000000,208,256,464
9/20/2013 8:02,8,1000000,233,265,498
9/20/2013 8:02,8,1000000,212,253,465
9/20/2013 8:02,8,1000000,232,252,484
9/20/2013 8:02,8,1000000,255,260,515
9/20/2013 8:02,8,1000000,234,257,491
9/20/2013 8:02,8,1000000,243,263,506
9/20/2013 8:02,8,1000000,258,267,525
9/20/2013 8:02,8,1000000,248,254,502
9/20/2013 8:02,8,1000000,236,262,498
9/20/2013 8:02,8,1000000,254,264,518
9/20/2013 8:02,8,1000000,206,255,461
9/20/2013 8:02,8,1000000,240,256,496
9/20/2013 8:02,8,1000000,212,262,474
9/20/2013 8:03,8,1000000,224,305,529
9/20/2013 8:03,8,1000000,242,257,499
9/20/2013 8:03,8,1000000,223,266,489
9/20/2013 8:03,8,1000000,268,259,527
9/20/2013 8:03,8,1000000,218,252,470
9/20/2013 8:03,8,1000000,244,259,503
9/20/2013 8:03,8,1000000,249,262,511
9/20/2013 8:03,8,1000000,217,251,468
9/20/2013 8:03,8,1000000,228,261,489
9/20/2013 8:03,8,1000000,219,260,479
9/20/2013 8:03,8,1000000,232,266,498
9/20/2013 8:03,8,1000000,219,264,483
9/20/2013 8:03,8,1000000,263,260,523
9/20/2013 8:03,8,1000000,221,261,482
9/20/2013 8:03,8,1000000,246,255,501
9/20/2013 8:03,8,1000000,241,263,504
9/20/2013 8:03,8,1000000,238,264,502
9/20/2013 8:03,8,1000000,224,259,483
9/20/2013 8:03,8,1000000,294,257,551
9/20/2013 8:03,8,1000000,239,261,500
9/20/2013 8:03,8,1000000,260,254,514
9/20/2013 8:03,8,1000000,285,262,547
9/20/2013 8:03,8,1000000,222,261,483
9/20/2013 8:03,8,1000000,224,250,474
9/20/2013 8:03,8,1000000,267,258,525
9/20/2013 8:04,8,1000000,254,260,514
9/20/2013 8:04,8,1000000,224,269,493
9/20/2013 8:04,8,1000000,273,280,553
9/20/2013 8:04,8,1000000,199,254,453
9/20/2013 8:04,8,1000000,222,254,476
9/20/2013 8:04,8,1000000,227,257,484
9/20/2013 8:04,8,1000000,239,259,498
9/20/2013 8:04,8,1000000,230,264,494
9/20/2013 8:04,8,1000000,258,267,525
9/20/2013 8:04,8,1000000,216,260,476
9/20/2013 8:04,8,1000000,234,264,498
9/20/2013 8:04,8,1000000,213,265,478
9/20/2013 8:04,8,1000000,254,268,522
9/20/2013 8:04,8,1000000,235,271,506
9/20/2013 8:04,8,1000000,242,264,506
9/20/2013 8:04,8,1000000,246,258,504
9/20/2013 8:04,8,1000000,233,260,493
9/20/2013 8:04,8,1000000,240,258,498
9/20/2013 8:04,8,1000000,209,253,462
9/20/2013 8:04,8,1000000,249,259,508
9/20/2013 8:04,8,1000000,228,260,488
9/20/2013 8:04,8,1000000,245,261,506
9/20/2013 8:04,8,1000000,236,263,499
9/20/2013 8:04,8,1000000,244,258,502
9/20/2013 8:05,8,1000000,259,265,524
9/20/2013 8:05,8,1000000,243,263,506
9/20/2013 8:05,8,1000000,215,265,480
9/20/2013 8:05,8,1000000,222,258,480
9/20/2013 8:05,8,1000000,257,256,513
9/20/2013 8:05,8,1000000,225,271,496
9/20/2013 8:05,8,1000000,224,258,482
9/20/2013 8:05,8,1000000,295,266,561
9/20/2013 8:05,8,1000000,228,265,493
9/20/2013 8:05,8,1000000,217,251,468
9/20/2013 8:05,8,1000000,231,265,496
9/20/2013 8:05,8,1000000,284,271,555
9/20/2013 8:05,8,1000000,222,251,473
9/20/2013 8:05,8,1000000,259,260,519
9/20/2013 8:05,8,1000000,231,259,490
9/20/2013 8:05,8,1000000,214,261,475
9/20/2013 8:05,8,1000000,257,261,518
9/20/2013 8:05,8,1000000,216,266,482
9/20/2013 8:05,8,1000000,213,258,471
9/20/2013 8:05,8,1000000,231,262,493
9/20/2013 8:05,8,1000000,213,266,479
9/20/2013 8:05,8,1000000,253,263,516
9/20/2013 8:05,8,1000000,1140,268,1408
9/20/2013 8:06,8,1000000,1270,277,1547
9/20/2013 8:06,8,1000000,1178,262,1440
9/20/2013 8:06,8,1000000,250,251,501
9/20/2013 8:06,8,1000000,270,261,531
9/20/2013 8:06,8,1000000,228,263,491
9/20/2013 8:06,8,1000000,220,257,477
9/20/2013 8:06,8,1000000,255,261,516
9/20/2013 8:06,8,1000000,190,273,463
9/20/2013 8:06,8,1000000,216,256,472
9/20/2013 8:06,8,1000000,222,269,491
9/20/2013 8:06,8,1000000,220,264,484
9/20/2013 8:06,8,1000000,248,262,510
9/20/2013 8:06,8,1000000,1178,258,1436
9/20/2013 8:06,8,1000000,250,267,517
9/20/2013 8:06,8,1000000,235,265,500
9/20/2013 8:06,8,1000000,264,276,540
9/20/2013 8:06,8,1000000,201,261,462
9/20/2013 8:06,8,1000000,228,264,492
9/20/2013 8:06,8,1000000,229,256,485
9/20/2013 8:06,8,1000000,247,259,506
9/20/2013 8:06,8,1000000,204,252,456
9/20/2013 8:06,8,1000000,208,257,465
9/20/2013 8:07,8,1000000,246,258,504
9/20/2013 8:07,8,1000000,215,261,476
9/20/2013 8:07,8,1000000,205,250,455
9/20/2013 8:07,8,1000000,227,252,479
9/20/2013 8:07,8,1000000,222,263,485
9/20/2013 8:07,8,1000000,216,262,478
9/20/2013 8:07,8,1000000,243,254,497
9/20/2013 8:07,8,1000000,205,261,466
9/20/2013 8:07,8,1000000,217,270,487
9/20/2013 8:07,8,1000000,240,254,494
9/20/2013 8:07,8,1000000,218,253,471
9/20/2013 8:07,8,1000000,274,267,541
9/20/2013 8:07,8,1000000,210,263,473
9/20/2013 8:07,8,1000000,201,260,461
9/20/2013 8:07,8,1000000,246,266,512
9/20/2013 8:07,8,1000000,247,255,502
9/20/2013 8:07,8,1000000,254,259,513
9/20/2013 8:07,8,1000000,215,256,471
9/20/2013 8:07,8,1000000,242,267,509
9/20/2013 8:07,8,1000000,257,268,525
9/20/2013 8:07,8,1000000,205,264,469
9/20/2013 8:07,8,1000000,265,265,530
9/20/2013 8:07,8,1000000,252,263,515
9/20/2013 8:07,8,1000000,240,261,501
9/20/2013 8:08,8,1000000,214,261,475
9/20/2013 8:08,8,1000000,207,261,468
9/20/2013 8:08,8,1000000,242,257,499
9/20/2013 8:08,8,1000000,223,269,492
9/20/2013 8:08,8,1000000,238,263,501
9/20/2013 8:08,8,1000000,277,261,538
9/20/2013 8:08,8,1000000,216,256,472
9/20/2013 8:08,8,1000000,234,274,508
9/20/2013 8:08,8,1000000,239,275,514
9/20/2013 8:08,8,1000000,225,267,492
9/20/2013 8:08,8,1000000,273,256,529
9/20/2013 8:08,8,1000000,225,266,491
9/20/2013 8:08,8,1000000,229,265,494
9/20/2013 8:08,8,1000000,230,268,498
9/20/2013 8:08,8,1000000,222,255,477
9/20/2013 8:08,8,1000000,229,256,485
9/20/2013 8:08,8,1000000,194,253,447
9/20/2013 8:08,8,1000000,227,262,489
9/20/2013 8:08,8,1000000,222,260,482
9/20/2013 8:08,8,1000000,230,264,494
9/20/2013 8:08,8,1000000,254,269,523
9/20/2013 8:08,8,1000000,193,263,456
9/20/2013 8:08,8,1000000,250,262,512
9/20/2013 8:08,8,1000000,253,282,535
9/20/2013 8:09,8,1000000,221,260,481
9/20/2013 8:09,8,1000000,206,273,479
9/20/2013 8:09,8,1000000,222,261,483
9/20/2013 8:09,8,1000000,219,269,488
9/20/2013 8:09,8,1000000,226,269,495
9/20/2013 8:09,8,1000000,236,262,498
9/20/2013 8:09,8,1000000,240,259,499
9/20/2013 8:09,8,1000000,238,263,501
9/20/2013 8:09,8,1000000,207,257,464
9/20/2013 8:09,8,1000000,221,264,485
9/20/2013 8:09,8,1000000,221,264,485
9/20/2013 8:09,8,1000000,215,262,477
9/20/2013 8:09,8,1000000,225,251,476
9/20/2013 8:09,8,1000000,251,278,529
9/20/2013 8:09,8,1000000,216,262,478
9/20/2013 8:09,8,1000000,218,264,482
9/20/2013 8:09,8,1000000,226,261,487
9/20/2013 8:09,8,1000000,255,264,519
9/20/2013 8:09,8,1000000,283,257,540
9/20/2013 8:09,8,1000000,245,250,495
9/20/2013 8:09,8,1000000,287,261,548
9/20/2013 8:09,8,1000000,240,262,502
9/20/2013 8:09,8,1000000,209,258,467
9/20/2013 8:09,8,1000000,284,264,548
9/20/2013 8:10,8,1000000,242,253,495
9/20/2013 8:10,8,1000000,235,260,495
9/20/2013 8:10,8,1000000,229,259,488
9/20/2013 8:10,8,1000000,246,257,503
9/20/2013 8:10,8,1000000,208,265,473
9/20/2013 8:10,8,1000000,237,261,498
9/20/2013 8:10,8,1000000,239,266,505
9/20/2013 8:10,8,1000000,205,261,466
9/20/2013 8:10,8,1000000,233,264,497
9/20/2013 8:10,8,1000000,223,260,483
9/20/2013 8:10,8,1000000,260,257,517
9/20/2013 8:10,8,1000000,234,264,498
9/20/2013 8:10,8,1000000,225,275,500
9/20/2013 8:10,8,1000000,242,263,505
9/20/2013 8:10,8,1000000,228,271,499
9/20/2013 8:10,8,1000000,224,266,490
9/20/2013 8:10,8,1000000,219,253,472
9/20/2013 8:10,8,1000000,234,256,490
9/20/2013 8:10,8,1000000,267,264,531
9/20/2013 8:10,8,1000000,245,257,502
9/20/2013 8:10,8,1000000,218,256,474
9/20/2013 8:10,8,1000000,209,258,467
9/20/2013 8:10,8,1000000,216,256,472
9/20/2013 8:10,8,1000000,208,265,473
9/20/2013 8:11,8,1000000,286,260,546
9/20/2013 8:11,8,1000000,226,263,489
9/20/2013 8:11,8,1000000,239,270,509
9/20/2013 8:11,8,1000000,272,263,535
9/20/2013 8:11,8,1000000,238,279,517
9/20/2013 8:11,8,1000000,242,257,499
9/20/2013 8:11,8,2000000,335,448,783
9/20/2013 8:11,8,2000000,370,464,834
9/20/2013 8:11,8,2000000,320,455,775
9/20/2013 8:11,8,2000000,317,459,776
9/20/2013 8:11,8,2000000,370,461,831
9/20/2013 8:11,8,2000000,338,442,780
9/20/2013 8:11,8,2000000,337,453,790
9/20/2013 8:11,8,2000000,345,438,783
9/20/2013 8:11,8,2000000,351,448,799
9/20/2013 8:11,8,2000000,302,464,766
9/20/2013 8:11,8,2000000,324,448,772
9/20/2013 8:11,8,2000000,335,452,787
9/20/2013 8:11,8,2000000,336,457,793
9/20/2013 8:11,8,2000000,329,459,788
9/20/2013 8:11,8,2000000,301,459,760
9/20/2013 8:12,8,2000000,331,471,802
9/20/2013 8:12,8,2000000,335,470,805
9/20/2013 8:12,8,2000000,331,446,777
9/20/2013 8:12,8,2000000,338,471,809
9/20/2013 8:12,8,2000000,320,450,770
9/20/2013 8:12,8,2000000,346,470,816
9/20/2013 8:12,8,2000000,324,439,763
9/20/2013 8:12,8,2000000,320,454,774
9/20/2013 8:12,8,2000000,336,468,804
9/20/2013 8:12,8,2000000,355,492,847
9/20/2013 8:12,8,2000000,319,456,775
9/20/2013 8:12,8,2000000,313,470,783
9/20/2013 8:12,8,2000000,350,445,795
9/20/2013 8:12,8,2000000,306,476,782
9/20/2013 8:12,8,2000000,311,444,755
9/20/2013 8:12,8,2000000,321,459,780
9/20/2013 8:12,8,2000000,309,445,754
9/20/2013 8:12,8,2000000,332,452,784
9/20/2013 8:12,8,2000000,1314,472,1786
9/20/2013 8:13,8,2000000,339,467,806
9/20/2013 8:13,8,2000000,1214,450,1664
9/20/2013 8:13,8,2000000,325,466,791
9/20/2013 8:13,8,2000000,363,459,822
9/20/2013 8:13,8,2000000,398,464,862
9/20/2013 8:13,8,2000000,1243,446,1689
9/20/2013 8:13,8,2000000,309,459,768
9/20/2013 8:13,8,2000000,337,467,804
9/20/2013 8:13,8,2000000,1257,458,1715
9/20/2013 8:13,8,2000000,406,457,863
9/20/2013 8:13,8,2000000,552,457,1009
9/20/2013 8:13,8,2000000,337,437,774
9/20/2013 8:13,8,2000000,338,472,810
9/20/2013 8:13,8,2000000,323,445,768
9/20/2013 8:13,8,2000000,349,449,798
9/20/2013 8:13,8,2000000,324,455,779
9/20/2013 8:13,8,2000000,353,463,816
9/20/2013 8:13,8,2000000,370,449,819
9/20/2013 8:14,8,2000000,322,474,796
9/20/2013 8:14,8,2000000,316,457,773
9/20/2013 8:14,8,2000000,1262,474,1736
9/20/2013 8:14,8,2000000,331,457,788
9/20/2013 8:14,8,2000000,327,453,780
9/20/2013 8:14,8,2000000,315,467,782
9/20/2013 8:14,8,2000000,343,458,801
9/20/2013 8:14,8,2000000,386,451,837
9/20/2013 8:14,8,2000000,362,456,818
9/20/2013 8:14,8,2000000,366,481,847
9/20/2013 8:14,8,2000000,336,459,795
9/20/2013 8:14,8,2000000,289,466,755
9/20/2013 8:14,8,2000000,317,458,775
9/20/2013 8:14,8,2000000,347,451,798
9/20/2013 8:14,8,2000000,409,478,887
9/20/2013 8:14,8,2000000,347,485,832
9/20/2013 8:14,8,2000000,307,471,778
9/20/2013 8:14,8,2000000,291,460,751
9/20/2013 8:14,8,2000000,339,464,803
9/20/2013 8:14,8,2000000,340,453,793
9/20/2013 8:15,8,2000000,342,445,787
9/20/2013 8:15,8,2000000,358,472,830
9/20/2013 8:15,8,2000000,1237,447,1684
9/20/2013 8:15,8,2000000,1233,457,1690
9/20/2013 8:15,8,2000000,327,471,798
9/20/2013 8:15,8,2000000,1228,463,1691
9/20/2013 8:15,8,2000000,327,462,789
9/20/2013 8:15,8,2000000,354,449,803
9/20/2013 8:15,8,2000000,353,447,800
9/20/2013 8:15,8,2000000,333,472,805
9/20/2013 8:15,8,2000000,401,468,869
9/20/2013 8:15,8,2000000,382,461,843
9/20/2013 8:15,8,2000000,325,447,772
9/20/2013 8:15,8,2000000,378,481,859
9/20/2013 8:15,8,2000000,327,474,801
9/20/2013 8:15,8,2000000,1256,464,1720
9/20/2013 8:15,8,2000000,345,472,817
9/20/2013 8:15,8,2000000,325,465,790
9/20/2013 8:16,8,2000000,347,464,811
9/20/2013 8:16,8,2000000,1241,464,1705
9/20/2013 8:16,8,2000000,1244,450,1694
9/20/2013 8:16,8,2000000,1306,464,1770
9/20/2013 8:16,8,2000000,340,508,848
9/20/2013 8:16,8,2000000,305,455,760
9/20/2013 8:16,8,2000000,1293,453,1746
9/20/2013 8:16,8,2000000,331,458,789
9/20/2013 8:16,8,2000000,316,462,778
9/20/2013 8:16,8,2000000,368,454,822
9/20/2013 8:16,8,2000000,315,445,760
9/20/2013 8:16,8,2000000,330,470,800
9/20/2013 8:16,8,2000000,359,459,818
9/20/2013 8:16,8,2000000,344,462,806
9/20/2013 8:16,8,2000000,355,455,810
9/20/2013 8:16,8,2000000,406,445,851
9/20/2013 8:16,8,2000000,341,464,805
9/20/2013 8:16,8,2000000,359,462,821
9/20/2013 8:17,8,2000000,390,461,851
9/20/2013 8:17,8,2000000,365,484,849
9/20/2013 8:17,8,2000000,331,449,780
9/20/2013 8:17,8,2000000,380,456,836
9/20/2013 8:17,8,2000000,1232,453,1685
9/20/2013 8:17,8,2000000,1189,452,1641
9/20/2013 8:17,8,2000000,367,454,821
9/20/2013 8:17,8,3000000,453,663,1116
9/20/2013 8:17,8,3000000,481,667,1148
9/20/2013 8:17,8,3000000,500,665,1165
9/20/2013 8:17,8,3000000,452,657,1109
9/20/2013 8:17,8,3000000,550,661,1211
9/20/2013 8:17,8,3000000,1343,655,1998
9/20/2013 8:17,8,3000000,448,657,1105
9/20/2013 8:17,8,3000000,466,646,1112
9/20/2013 8:17,8,3000000,447,646,1093
9/20/2013 8:18,8,3000000,503,642,1145
9/20/2013 8:18,8,3000000,441,655,1096
9/20/2013 8:18,8,3000000,422,645,1067
9/20/2013 8:18,8,3000000,706,639,1345
9/20/2013 8:18,8,3000000,507,686,1193
9/20/2013 8:18,8,3000000,496,647,1143
9/20/2013 8:18,8,3000000,437,669,1106
9/20/2013 8:18,8,3000000,487,657,1144
9/20/2013 8:18,8,3000000,471,658,1129
9/20/2013 8:18,8,3000000,443,672,1115
9/20/2013 8:18,8,3000000,466,646,1112
9/20/2013 8:18,8,3000000,482,643,1125
9/20/2013 8:18,8,3000000,427,644,1071
9/20/2013 8:18,8,3000000,471,673,1144
9/20/2013 8:18,8,3000000,476,650,1126
9/20/2013 8:18,8,3000000,501,646,1147
9/20/2013 8:18,8,3000000,446,648,1094
9/20/2013 8:19,8,3000000,479,631,1110
9/20/2013 8:19,8,3000000,517,654,1171
9/20/2013 8:19,8,3000000,651,656,1307
9/20/2013 8:19,8,3000000,495,645,1140
9/20/2013 8:19,8,3000000,704,647,1351
9/20/2013 8:19,8,3000000,488,650,1138
9/20/2013 8:19,8,3000000,474,650,1124
9/20/2013 8:19,8,3000000,468,684,1152
9/20/2013 8:19,8,3000000,487,654,1141
9/20/2013 8:19,8,3000000,490,648,1138
9/20/2013 8:19,8,3000000,442,662,1104
9/20/2013 8:19,8,3000000,454,636,1090
9/20/2013 8:19,8,3000000,496,645,1141
9/20/2013 8:19,8,3000000,513,677,1190
9/20/2013 8:19,8,3000000,456,686,1142
9/20/2013 8:19,8,3000000,472,655,1127
9/20/2013 8:19,8,3000000,452,669,1121
9/20/2013 8:20,8,3000000,455,645,1100
9/20/2013 8:20,8,3000000,1367,657,2024
9/20/2013 8:20,8,3000000,453,622,1075
9/20/2013 8:20,8,3000000,481,647,1128
9/20/2013 8:20,8,3000000,492,642,1134
9/20/2013 8:20,8,3000000,529,654,1183
9/20/2013 8:20,8,3000000,460,649,1109
9/20/2013 8:20,8,3000000,1328,677,2005
9/20/2013 8:20,8,3000000,524,667,1191
9/20/2013 8:20,8,3000000,470,644,1114
9/20/2013 8:20,8,3000000,435,669,1104
9/20/2013 8:20,8,3000000,475,649,1124
9/20/2013 8:20,8,3000000,496,668,1164
9/20/2013 8:20,8,3000000,456,660,1116
9/20/2013 8:20,8,3000000,466,619,1085
9/20/2013 8:20,8,3000000,500,653,1153
9/20/2013 8:20,8,3000000,485,657,1142
9/20/2013 8:21,8,3000000,1380,676,2056
9/20/2013 8:21,8,3000000,544,675,1219
9/20/2013 8:21,8,3000000,546,661,1207
9/20/2013 8:21,8,3000000,525,656,1181
9/20/2013 8:21,8,3000000,435,654,1089
9/20/2013 8:21,8,3000000,1362,673,2035
9/20/2013 8:21,8,3000000,1344,649,1993
9/20/2013 8:21,8,3000000,504,674,1178
9/20/2013 8:21,8,3000000,492,651,1143
9/20/2013 8:21,8,3000000,421,679,1100
9/20/2013 8:21,8,3000000,1361,661,2022
9/20/2013 8:21,8,3000000,494,663,1157
9/20/2013 8:21,8,3000000,499,662,1161
9/20/2013 8:21,8,3000000,442,664,1106
9/20/2013 8:21,8,3000000,1349,650,1999
9/20/2013 8:22,8,3000000,485,684,1169
9/20/2013 8:22,8,3000000,478,661,1139
9/20/2013 8:22,8,3000000,481,670,1151
9/20/2013 8:22,8,3000000,477,659,1136
9/20/2013 8:22,8,3000000,476,646,1122
9/20/2013 8:22,8,3000000,461,674,1135
9/20/2013 8:22,8,3000000,574,638,1212
9/20/2013 8:22,8,3000000,477,652,1129
9/20/2013 8:22,8,3000000,500,657,1157
9/20/2013 8:22,8,3000000,448,661,1109
9/20/2013 8:22,8,3000000,463,626,1089
9/20/2013 8:22,8,3000000,449,648,1097
9/20/2013 8:22,8,3000000,506,655,1161
9/20/2013 8:22,8,3000000,519,653,1172
9/20/2013 8:22,8,3000000,471,642,1113
9/20/2013 8:22,8,3000000,513,649,1162
9/20/2013 8:22,8,3000000,463,624,1087
9/20/2013 8:22,8,3000000,452,659,1111
9/20/2013 8:23,8,3000000,448,635,1083
9/20/2013 8:23,8,3000000,493,626,1119
9/20/2013 8:23,8,3000000,710,667,1377
9/20/2013 8:23,8,3000000,472,668,1140
9/20/2013 8:23,8,3000000,495,641,1136
9/20/2013 8:23,8,3000000,464,647,1111
9/20/2013 8:23,8,3000000,467,649,1116
9/20/2013 8:23,8,3000000,495,654,1149
9/20/2013 8:23,8,3000000,459,644,1103
9/20/2013 8:23,8,3000000,473,666,1139
9/20/2013 8:23,8,3000000,474,652,1126
9/20/2013 8:23,8,3000000,482,650,1132
9/20/2013 8:23,8,3000000,1286,681,1967
9/20/2013 8:23,8,3000000,490,634,1124
9/20/2013 8:23,8,3000000,493,649,1142
9/20/2013 8:23,8,3000000,1359,691,2050
9/20/2013 8:24,8,3000000,1328,655,1983
9/20/2013 8:24,8,3000000,474,646,1120
9/20/2013 8:24,8,3000000,466,684,1150
9/20/2013 8:24,8,3000000,495,666,1161
9/20/2013 8:24,8,3000000,473,662,1135
9/20/2013 8:24,8,3000000,464,679,1143
9/20/2013 8:24,8,4000000,609,854,1463
9/20/2013 8:24,8,4000000,820,866,1686
9/20/2013 8:24,8,4000000,592,841,1433
9/20/2013 8:24,8,4000000,864,771,1635
9/20/2013 8:24,8,4000000,560,865,1425
9/20/2013 8:24,8,4000000,538,839,1377
9/20/2013 8:24,8,4000000,564,867,1431
9/20/2013 8:24,8,4000000,816,829,1645
9/20/2013 8:24,8,4000000,609,842,1451
9/20/2013 8:24,8,4000000,806,869,1675
9/20/2013 8:25,8,4000000,573,867,1440
9/20/2013 8:25,8,4000000,627,844,1471
9/20/2013 8:25,8,4000000,542,835,1377
9/20/2013 8:25,8,4000000,535,856,1391
9/20/2013 8:25,8,4000000,592,836,1428
9/20/2013 8:25,8,4000000,544,836,1380
9/20/2013 8:25,8,4000000,783,875,1658
9/20/2013 8:25,8,4000000,583,841,1424
9/20/2013 8:25,8,4000000,564,841,1405
9/20/2013 8:25,8,4000000,570,858,1428
9/20/2013 8:25,8,4000000,574,871,1445
9/20/2013 8:25,8,4000000,578,836,1414
9/20/2013 8:25,8,4000000,573,881,1454
9/20/2013 8:25,8,4000000,568,850,1418
9/20/2013 8:25,8,4000000,574,853,1427
9/20/2013 8:25,8,4000000,602,812,1414
9/20/2013 8:26,8,4000000,546,831,1377
9/20/2013 8:26,8,4000000,932,836,1768
9/20/2013 8:26,8,4000000,579,863,1442
9/20/2013 8:26,8,4000000,758,846,1604
9/20/2013 8:26,8,4000000,744,844,1588
9/20/2013 8:26,8,4000000,620,889,1509
9/20/2013 8:26,8,4000000,598,862,1460
9/20/2013 8:26,8,4000000,572,853,1425
9/20/2013 8:26,8,4000000,574,847,1421
9/20/2013 8:26,8,4000000,576,849,1425
9/20/2013 8:26,8,4000000,563,852,1415
9/20/2013 8:26,8,4000000,566,828,1394
9/20/2013 8:26,8,4000000,572,839,1411
9/20/2013 8:26,8,4000000,577,914,1491
9/20/2013 8:26,8,4000000,577,795,1372
9/20/2013 8:27,8,4000000,813,869,1682
9/20/2013 8:27,8,4000000,539,837,1376
9/20/2013 8:27,8,4000000,535,838,1373
9/20/2013 8:27,8,4000000,579,846,1425
9/20/2013 8:27,8,4000000,615,800,1415
9/20/2013 8:27,8,4000000,768,846,1614
9/20/2013 8:27,8,4000000,556,832,1388
9/20/2013 8:27,8,4000000,602,875,1477
9/20/2013 8:27,8,4000000,566,807,1373
9/20/2013 8:27,8,4000000,582,860,1442
9/20/2013 8:27,8,4000000,643,837,1480
9/20/2013 8:27,8,4000000,606,870,1476
9/20/2013 8:27,8,4000000,602,828,1430
9/20/2013 8:27,8,4000000,627,847,1474
9/20/2013 8:27,8,4000000,562,784,1346
9/20/2013 8:27,8,4000000,971,836,1807
9/20/2013 8:28,8,4000000,753,852,1605
9/20/2013 8:28,8,4000000,571,856,1427
9/20/2013 8:28,8,4000000,750,800,1550
9/20/2013 8:28,8,4000000,570,854,1424
9/20/2013 8:28,8,4000000,750,841,1591
9/20/2013 8:28,8,4000000,741,867,1608
9/20/2013 8:28,8,4000000,567,868,1435
9/20/2013 8:28,8,4000000,602,825,1427
9/20/2013 8:28,8,4000000,542,851,1393
9/20/2013 8:28,8,4000000,565,841,1406
9/20/2013 8:28,8,4000000,1458,849,2307
9/20/2013 8:28,8,4000000,564,803,1367
9/20/2013 8:28,8,4000000,593,860,1453
9/20/2013 8:28,8,4000000,602,857,1459
9/20/2013 8:28,8,4000000,582,842,1424
9/20/2013 8:29,8,4000000,566,844,1410
9/20/2013 8:29,8,4000000,525,858,1383
9/20/2013 8:29,8,4000000,1396,842,2238
9/20/2013 8:29,8,4000000,551,889,1440
9/20/2013 8:29,8,4000000,558,865,1423
9/20/2013 8:29,8,4000000,1337,836,2173
9/20/2013 8:29,8,4000000,606,848,1454
9/20/2013 8:29,8,4000000,554,842,1396
9/20/2013 8:29,8,4000000,764,835,1599
9/20/2013 8:29,8,4000000,792,838,1630
9/20/2013 8:29,8,4000000,767,844,1611
9/20/2013 8:29,8,4000000,579,874,1453
9/20/2013 8:29,8,4000000,590,798,1388
9/20/2013 8:29,8,4000000,1060,850,1910
9/20/2013 8:29,8,4000000,1395,863,2258
9/20/2013 8:30,8,4000000,559,798,1357
9/20/2013 8:30,8,4000000,612,853,1465
9/20/2013 8:30,8,4000000,781,841,1622
9/20/2013 8:30,8,4000000,782,789,1571
9/20/2013 8:30,8,4000000,522,856,1378
9/20/2013 8:30,8,4000000,569,839,1408
9/20/2013 8:30,8,4000000,765,852,1617
9/20/2013 8:30,8,4000000,797,870,1667
9/20/2013 8:30,8,4000000,573,834,1407
9/20/2013 8:30,8,4000000,552,835,1387
9/20/2013 8:30,8,4000000,841,853,1694
9/20/2013 8:30,8,4000000,574,852,1426
9/20/2013 8:30,8,4000000,576,848,1424
9/20/2013 8:30,8,4000000,591,887,1478
9/20/2013 8:30,8,4000000,598,858,1456
9/20/2013 8:31,8,4000000,533,824,1357
9/20/2013 8:31,8,4000000,561,842,1403
9/20/2013 8:31,8,4000000,542,822,1364
9/20/2013 8:31,8,4000000,577,841,1418
9/20/2013 8:31,8,4000000,595,842,1437
9/20/2013 8:31,8,4000000,624,859,1483
9/20/2013 8:31,8,4000000,782,965,1747
9/20/2013 8:31,8,4000000,548,848,1396
9/20/2013 8:31,8,4000000,648,847,1495
9/20/2013 8:31,8,4000000,589,837,1426
9/20/2013 8:31,8,4000000,584,851,1435
9/20/2013 8:31,8,4000000,556,881,1437
9/20/2013 8:31,8,4000000,561,867,1428
9/20/2013 8:31,8,5000000,760,976,1736
9/20/2013 8:31,8,5000000,682,1055,1737
9/20/2013 8:31,8,5000000,661,1050,1711
9/20/2013 8:32,8,5000000,1547,1030,2577
9/20/2013 8:32,8,5000000,892,1079,1971
9/20/2013 8:32,8,5000000,783,1068,1851
9/20/2013 8:32,8,5000000,729,986,1715
9/20/2013 8:32,8,5000000,930,1037,1967
9/20/2013 8:32,8,5000000,817,1043,1860
9/20/2013 8:32,8,5000000,766,924,1690
9/20/2013 8:32,8,5000000,947,1081,2028
9/20/2013 8:32,8,5000000,674,988,1662
9/20/2013 8:32,8,5000000,1160,1050,2210
9/20/2013 8:32,8,5000000,981,990,1971
9/20/2013 8:32,8,5000000,890,968,1858
9/20/2013 8:32,8,5000000,951,1007,1958
9/20/2013 8:33,8,5000000,697,1034,1731
9/20/2013 8:33,8,5000000,923,1009,1932
9/20/2013 8:33,8,5000000,804,1032,1836
9/20/2013 8:33,8,5000000,853,1103,1956
9/20/2013 8:33,8,5000000,719,992,1711
9/20/2013 8:33,8,5000000,684,1060,1744
9/20/2013 8:33,8,5000000,1616,970,2586
9/20/2013 8:33,8,5000000,797,1060,1857
9/20/2013 8:33,8,5000000,1583,1056,2639
9/20/2013 8:33,8,5000000,905,983,1888
9/20/2013 8:33,8,5000000,695,1064,1759
9/20/2013 8:33,8,5000000,770,927,1697
9/20/2013 8:33,8,5000000,782,1067,1849
9/20/2013 8:34,8,5000000,772,1103,1875
9/20/2013 8:34,8,5000000,705,1073,1778
9/20/2013 8:34,8,5000000,822,1047,1869
9/20/2013 8:34,8,5000000,841,927,1768
9/20/2013 8:34,8,5000000,929,978,1907
9/20/2013 8:34,8,5000000,939,1031,1970
9/20/2013 8:34,8,5000000,730,992,1722
9/20/2013 8:34,8,5000000,799,1032,1831
9/20/2013 8:34,8,5000000,870,1075,1945
9/20/2013 8:34,8,5000000,787,1065,1852
9/20/2013 8:34,8,5000000,806,983,1789
9/20/2013 8:34,8,5000000,845,1011,1856
9/20/2013 8:34,8,5000000,1025,1306,2331
9/20/2013 8:34,8,5000000,778,1003,1781
9/20/2013 8:35,8,5000000,749,1006,1755
9/20/2013 8:35,8,5000000,694,1002,1696
9/20/2013 8:35,8,5000000,778,1036,1814
9/20/2013 8:35,8,5000000,859,1083,1942
9/20/2013 8:35,8,5000000,782,1057,1839
9/20/2013 8:35,8,5000000,813,1023,1836
9/20/2013 8:35,8,5000000,784,1056,1840
9/20/2013 8:35,8,5000000,821,1040,1861
9/20/2013 8:35,8,5000000,764,1028,1792
9/20/2013 8:35,8,5000000,753,1046,1799
9/20/2013 8:35,8,5000000,750,986,1736
9/20/2013 8:35,8,5000000,797,1028,1825
9/20/2013 8:35,8,5000000,850,1069,1919
9/20/2013 8:35,8,5000000,1031,1024,2055
9/20/2013 8:36,8,5000000,788,1043,1831
9/20/2013 8:36,8,5000000,834,1029,1863
9/20/2013 8:36,8,5000000,779,992,1771
9/20/2013 8:36,8,5000000,941,978,1919
9/20/2013 8:36,8,5000000,981,1083,2064
9/20/2013 8:36,8,5000000,837,1043,1880
9/20/2013 8:36,8,5000000,705,1026,1731
9/20/2013 8:36,8,5000000,710,1011,1721
9/20/2013 8:36,8,5000000,735,1090,1825
9/20/2013 8:36,8,5000000,863,1073,1936
9/20/2013 8:36,8,5000000,752,996,1748
9/20/2013 8:36,8,5000000,981,1039,2020
9/20/2013 8:36,8,5000000,942,1047,1989
9/20/2013 8:36,8,5000000,793,1063,1856
9/20/2013 8:37,8,5000000,900,1048,1948
9/20/2013 8:37,8,5000000,763,1049,1812
9/20/2013 8:37,8,5000000,930,979,1909
9/20/2013 8:37,8,5000000,821,1067,1888
9/20/2013 8:37,8,5000000,775,979,1754
9/20/2013 8:37,8,5000000,836,1038,1874
9/20/2013 8:37,8,5000000,942,1055,1997
9/20/2013 8:37,8,5000000,770,988,1758
9/20/2013 8:37,8,5000000,812,1071,1883
9/20/2013 8:37,8,5000000,978,1079,2057
9/20/2013 8:37,8,5000000,750,1068,1818
9/20/2013 8:37,8,5000000,885,1092,1977
9/20/2013 8:37,8,5000000,786,955,1741
9/20/2013 8:37,8,5000000,1057,1064,2121
9/20/2013 8:38,8,5000000,754,1052,1806
9/20/2013 8:38,8,5000000,821,1029,1850
9/20/2013 8:38,8,5000000,807,1031,1838
9/20/2013 8:38,8,5000000,735,1042,1777
9/20/2013 8:38,8,5000000,703,1055,1758
9/20/2013 8:38,8,5000000,732,994,1726
9/20/2013 8:38,8,5000000,805,1074,1879
9/20/2013 8:38,8,5000000,912,986,1898
9/20/2013 8:38,8,5000000,777,1012,1789
9/20/2013 8:38,8,5000000,781,1000,1781
9/20/2013 8:38,8,5000000,759,1000,1759
9/20/2013 8:38,8,5000000,821,1052,1873
9/20/2013 8:38,8,5000000,789,974,1763
9/20/2013 8:38,8,5000000,712,1033,1745
9/20/2013 8:39,8,5000000,793,1074,1867
9/20/2013 8:39,8,5000000,843,977,1820
9/20/2013 8:39,8,5000000,770,1048,1818
9/20/2013 8:39,8,5000000,751,985,1736
9/20/2013 8:39,8,5000000,747,964,1711
9/20/2013 8:39,8,5000000,788,929,1717
9/20/2013 8:39,8,5000000,1051,1134,2185
9/20/2013 8:39,8,5000000,768,1004,1772
9/20/2013 8:39,8,5000000,773,985,1758
9/20/2013 8:39,8,5000000,752,978,1730
9/20/2013 8:39,8,5000000,925,1028,1953
9/20/2013 8:39,8,5000000,915,1012,1927
9/20/2013 8:39,8,5000000,773,1050,1823
9/20/2013 8:39,8,5000000,819,973,1792
9/20/2013 8:40,8,5000000,1665,1071,2736
9/20/2013 8:40,8,5000000,1033,1035,2068
9/20/2013 8:40,8,6000000,1671,1204,2875
9/20/2013 8:40,8,6000000,880,1178,2058
9/20/2013 8:40,8,6000000,1336,1149,2485
9/20/2013 8:40,8,6000000,1616,1209,2825
9/20/2013 8:40,8,6000000,937,1285,2222
9/20/2013 8:40,8,6000000,947,1127,2074
9/20/2013 8:40,8,6000000,1611,1156,2767
9/20/2013 8:40,8,6000000,841,1526,2367
9/20/2013 8:40,8,6000000,1008,1168,2176
9/20/2013 8:40,8,6000000,913,1181,2094
9/20/2013 8:41,8,6000000,850,1168,2018
9/20/2013 8:41,8,6000000,915,1156,2071
9/20/2013 8:41,8,6000000,839,1108,1947
9/20/2013 8:41,8,6000000,842,1163,2005
9/20/2013 8:41,8,6000000,804,1201,2005
9/20/2013 8:41,8,6000000,895,1152,2047
9/20/2013 8:41,8,6000000,874,1174,2048
9/20/2013 8:41,8,6000000,932,1195,2127
9/20/2013 8:41,8,6000000,988,1194,2182
9/20/2013 8:41,8,6000000,966,1096,2062
9/20/2013 8:41,8,6000000,1034,1251,2285
9/20/2013 8:41,8,6000000,918,1212,2130
9/20/2013 8:41,8,6000000,827,1158,1985
9/20/2013 8:42,8,6000000,840,1160,2000
9/20/2013 8:42,8,6000000,938,1181,2119
9/20/2013 8:42,8,6000000,927,1249,2176
9/20/2013 8:42,8,6000000,809,1162,1971
9/20/2013 8:42,8,6000000,1629,1152,2781
9/20/2013 8:42,8,6000000,1080,1165,2245
9/20/2013 8:42,8,6000000,918,1170,2088
9/20/2013 8:42,8,6000000,895,1163,2058
9/20/2013 8:42,8,6000000,850,1161,2011
9/20/2013 8:42,8,6000000,928,1203,2131
9/20/2013 8:42,8,6000000,777,1155,1932
9/20/2013 8:42,8,6000000,951,1085,2036
9/20/2013 8:43,8,6000000,916,1238,2154
9/20/2013 8:43,8,6000000,994,1198,2192
9/20/2013 8:43,8,6000000,903,1155,2058
9/20/2013 8:43,8,6000000,833,1156,1989
9/20/2013 8:43,8,6000000,877,1098,1975
9/20/2013 8:43,8,6000000,961,1170,2131
9/20/2013 8:43,8,6000000,969,1218,2187
9/20/2013 8:43,8,6000000,866,1181,2047
9/20/2013 8:43,8,6000000,932,1158,2090
9/20/2013 8:43,8,6000000,879,1161,2040
9/20/2013 8:43,8,6000000,854,1167,2021
9/20/2013 8:43,8,6000000,1092,1220,2312
9/20/2013 8:43,8,6000000,1065,1188,2253
9/20/2013 8:44,8,6000000,1035,1159,2194
9/20/2013 8:44,8,6000000,835,1113,1948
9/20/2013 8:44,8,6000000,1084,1205,2289
9/20/2013 8:44,8,6000000,768,1157,1925
9/20/2013 8:44,8,6000000,1065,1182,2247
9/20/2013 8:44,8,6000000,1030,1159,2189
9/20/2013 8:44,8,6000000,924,1200,2124
9/20/2013 8:44,8,6000000,876,1211,2087
9/20/2013 8:44,8,6000000,989,1243,2232
9/20/2013 8:44,8,6000000,866,1165,2031
9/20/2013 8:44,8,6000000,983,1178,2161
9/20/2013 8:44,8,6000000,1604,1177,2781
9/20/2013 8:45,8,6000000,845,1145,1990
9/20/2013 8:45,8,6000000,891,1167,2058
9/20/2013 8:45,8,6000000,978,1145,2123
9/20/2013 8:45,8,6000000,1007,1204,2211
9/20/2013 8:45,8,6000000,942,1149,2091
9/20/2013 8:45,8,6000000,955,1213,2168
9/20/2013 8:45,8,6000000,1108,1187,2295
9/20/2013 8:45,8,6000000,1046,1171,2217
9/20/2013 8:45,8,6000000,818,1247,2065
9/20/2013 8:45,8,6000000,1170,1177,2347
9/20/2013 8:45,8,6000000,864,1156,2020
9/20/2013 8:45,8,6000000,932,1224,2156
9/20/2013 8:45,8,6000000,897,1182,2079
9/20/2013 8:46,8,6000000,1008,1153,2161
9/20/2013 8:46,8,6000000,799,1162,1961
9/20/2013 8:46,8,6000000,1588,1491,3079
9/20/2013 8:46,8,6000000,779,1172,1951
9/20/2013 8:46,8,6000000,852,1159,2011
9/20/2013 8:46,8,6000000,1050,1155,2205
9/20/2013 8:46,8,6000000,818,1171,1989
9/20/2013 8:46,8,6000000,933,1230,2163
9/20/2013 8:46,8,6000000,792,1171,1963
9/20/2013 8:46,8,6000000,1577,1172,2749
9/20/2013 8:46,8,6000000,1154,1201,2355
9/20/2013 8:46,8,6000000,875,1149,2024
9/20/2013 8:47,8,6000000,848,1155,2003
9/20/2013 8:47,8,6000000,952,1184,2136
9/20/2013 8:47,8,6000000,908,1160,2068
9/20/2013 8:47,8,6000000,1069,1158,2227
9/20/2013 8:47,8,6000000,881,1119,2000
9/20/2013 8:47,8,6000000,983,1214,2197
9/20/2013 8:47,8,6000000,1101,1083,2184
9/20/2013 8:47,8,6000000,898,1221,2119
9/20/2013 8:47,8,6000000,1053,1168,2221
9/20/2013 8:47,8,6000000,971,1184,2155
9/20/2013 8:47,8,6000000,1117,1234,2351
9/20/2013 8:47,8,6000000,877,1195,2072
9/20/2013 8:47,8,6000000,874,1106,1980
9/20/2013 8:48,8,6000000,878,1163,2041
9/20/2013 8:48,8,6000000,1102,1232,2334
9/20/2013 8:48,8,6000000,861,1190,2051
9/20/2013 8:48,8,6000000,909,1176,2085
9/20/2013 8:48,8,6000000,913,1530,2443
9/20/2013 8:48,8,6000000,908,1199,2107
9/20/2013 8:48,8,6000000,913,1186,2099
9/20/2013 8:48,8,6000000,979,1158,2137
9/20/2013 8:48,8,6000000,993,1242,2235
9/20/2013 8:48,8,6000000,1099,1240,2339
9/20/2013 8:48,8,6000000,890,1112,2002
9/20/2013 8:48,8,6000000,884,1189,2073
9/20/2013 8:48,8,6000000,939,1163,2102
9/20/2013 8:49,8,6000000,994,1159,2153
9/20/2013 8:49,8,6000000,1043,1166,2209
9/20/2013 8:49,8,6000000,790,1175,1965
9/20/2013 8:49,8,6000000,1600,1147,2747
9/20/2013 8:49,8,7000000,899,1338,2237
9/20/2013 8:49,8,7000000,923,1350,2273
9/20/2013 8:49,8,7000000,902,1411,2313
9/20/2013 8:49,8,7000000,1232,1334,2566
9/20/2013 8:49,8,7000000,895,1333,2228
9/20/2013 8:49,8,7000000,971,1332,2303
9/20/2013 8:49,8,7000000,1224,1295,2519
9/20/2013 8:49,8,7000000,1262,1325,2587
9/20/2013 8:50,8,7000000,977,1347,2324
9/20/2013 8:50,8,7000000,970,1402,2372
9/20/2013 8:50,8,7000000,1014,1302,2316
9/20/2013 8:50,8,7000000,995,1349,2344
9/20/2013 8:50,8,7000000,1046,1314,2360
9/20/2013 8:50,8,7000000,994,1368,2362
9/20/2013 8:50,8,7000000,940,1339,2279
9/20/2013 8:50,8,7000000,885,1319,2204
9/20/2013 8:50,8,7000000,1095,1291,2386
9/20/2013 8:50,8,7000000,1006,1354,2360
9/20/2013 8:50,8,7000000,1255,1308,2563
9/20/2013 8:51,8,7000000,846,1324,2170
9/20/2013 8:51,8,7000000,1064,1331,2395
9/20/2013 8:51,8,7000000,875,1418,2293
9/20/2013 8:51,8,7000000,1227,1316,2543
9/20/2013 8:51,8,7000000,1001,1333,2334
9/20/2013 8:51,8,7000000,885,1347,2232
9/20/2013 8:51,8,7000000,959,1319,2278
9/20/2013 8:51,8,7000000,1008,1289,2297
9/20/2013 8:51,8,7000000,908,1673,2581
9/20/2013 8:51,8,7000000,1675,1380,3055
9/20/2013 8:51,8,7000000,1166,1357,2523
9/20/2013 8:51,8,7000000,1046,1416,2462
9/20/2013 8:52,8,7000000,987,1344,2331
9/20/2013 8:52,8,7000000,1103,1329,2432
9/20/2013 8:52,8,7000000,1221,1311,2532
9/20/2013 8:52,8,7000000,1372,1303,2675
9/20/2013 8:52,8,7000000,943,1347,2290
9/20/2013 8:52,8,7000000,926,1351,2277
9/20/2013 8:52,8,7000000,1091,1308,2399
9/20/2013 8:52,8,7000000,968,1362,2330
9/20/2013 8:52,8,7000000,914,1396,2310
9/20/2013 8:52,8,7000000,1007,1346,2353
9/20/2013 8:52,8,7000000,919,1392,2311
9/20/2013 8:52,8,7000000,978,1382,2360
9/20/2013 8:53,8,7000000,1710,1378,3088
9/20/2013 8:53,8,7000000,923,1359,2282
9/20/2013 8:53,8,7000000,961,1360,2321
9/20/2013 8:53,8,7000000,1061,1428,2489
9/20/2013 8:53,8,7000000,987,1371,2358
9/20/2013 8:53,8,7000000,931,1371,2302
9/20/2013 8:53,8,7000000,862,1339,2201
9/20/2013 8:53,8,7000000,1040,1312,2352
9/20/2013 8:53,8,7000000,896,1330,2226
9/20/2013 8:53,8,7000000,1053,1366,2419
9/20/2013 8:53,8,7000000,1057,1330,2387
9/20/2013 8:53,8,7000000,907,1328,2235
9/20/2013 8:54,8,7000000,1079,1326,2405
9/20/2013 8:54,8,7000000,971,1334,2305
9/20/2013 8:54,8,7000000,1102,1357,2459
9/20/2013 8:54,8,7000000,1636,1322,2958
9/20/2013 8:54,8,7000000,922,1341,2263
9/20/2013 8:54,8,7000000,914,1334,2248
9/20/2013 8:54,8,7000000,953,1342,2295
9/20/2013 8:54,8,7000000,1053,1324,2377
9/20/2013 8:54,8,7000000,1158,1351,2509
9/20/2013 8:54,8,7000000,912,1358,2270
9/20/2013 8:54,8,7000000,925,1404,2329
9/20/2013 8:55,8,7000000,1044,1280,2324
9/20/2013 8:55,8,7000000,910,1315,2225
9/20/2013 8:55,8,7000000,1091,1373,2464
9/20/2013 8:55,8,7000000,1006,1296,2302
9/20/2013 8:55,8,7000000,900,1377,2277
9/20/2013 8:55,8,7000000,1268,1329,2597
9/20/2013 8:55,8,7000000,889,1325,2214
9/20/2013 8:55,8,7000000,989,1337,2326
9/20/2013 8:55,8,7000000,861,1379,2240
9/20/2013 8:55,8,7000000,1036,1274,2310
9/20/2013 8:55,8,7000000,986,1345,2331
9/20/2013 8:55,8,7000000,1089,1332,2421
9/20/2013 8:56,8,7000000,1030,1337,2367
9/20/2013 8:56,8,7000000,968,1360,2328
9/20/2013 8:56,8,7000000,992,1348,2340
9/20/2013 8:56,8,7000000,1047,1297,2344
9/20/2013 8:56,8,7000000,1022,1359,2381
9/20/2013 8:56,8,7000000,1653,1336,2989
9/20/2013 8:56,8,7000000,1064,1391,2455
9/20/2013 8:56,8,7000000,1022,1331,2353
9/20/2013 8:56,8,7000000,948,1402,2350
9/20/2013 8:56,8,7000000,988,1348,2336
9/20/2013 8:56,8,7000000,890,1369,2259
9/20/2013 8:57,8,7000000,1232,1319,2551
9/20/2013 8:57,8,7000000,954,1361,2315
9/20/2013 8:57,8,7000000,953,1359,2312
9/20/2013 8:57,8,7000000,1058,1342,2400
9/20/2013 8:57,8,7000000,961,1327,2288
9/20/2013 8:57,8,7000000,986,1342,2328
9/20/2013 8:57,8,7000000,1042,1348,2390
9/20/2013 8:57,8,7000000,1037,1324,2361
9/20/2013 8:57,8,7000000,1119,1320,2439
9/20/2013 8:57,8,7000000,954,1337,2291
9/20/2013 8:57,8,7000000,950,1344,2294
9/20/2013 8:57,8,7000000,847,1338,2185
9/20/2013 8:58,8,7000000,937,1338,2275
9/20/2013 8:58,8,7000000,906,1319,2225
9/20/2013 8:58,8,7000000,999,1360,2359
9/20/2013 8:58,8,7000000,1040,1303,2343
9/20/2013 8:58,8,7000000,1142,1329,2471
9/20/2013 8:58,8,7000000,941,1348,2289
9/20/2013 8:58,8,7000000,968,1376,2344
9/20/2013 8:58,8,7000000,951,1370,2321
9/20/2013 8:58,8,7000000,1022,1320,2342
9/20/2013 8:58,8,7000000,1105,1313,2418
9/20/2013 8:58,8,7000000,1157,1329,2486
9/20/2013 8:58,8,7000000,929,1356,2285
9/20/2013 8:59,8,7000000,953,1312,2265
9/20/2013 8:59,8,7000000,915,1342,2257
9/20/2013 8:59,8,8000000,1262,1556,2818
9/20/2013 8:59,8,8000000,1194,1535,2729
9/20/2013 8:59,8,8000000,1290,1497,2787
9/20/2013 8:59,8,8000000,1342,1556,2898
9/20/2013 8:59,8,8000000,1093,1540,2633
9/20/2013 8:59,8,8000000,1103,1563,2666
9/20/2013 8:59,8,8000000,1653,1533,3186
9/20/2013 8:59,8,8000000,1399,1515,2914
9/20/2013 8:59,8,8000000,1123,1541,2664
9/20/2013 9:00,8,8000000,1089,1517,2606
9/20/2013 9:00,8,8000000,1256,1496,2752
9/20/2013 9:00,8,8000000,1311,1557,2868
9/20/2013 9:00,8,8000000,1279,1543,2822
9/20/2013 9:00,8,8000000,1052,1528,2580
9/20/2013 9:00,8,8000000,1207,1515,2722
9/20/2013 9:00,8,8000000,1040,1589,2629
9/20/2013 9:00,8,8000000,1345,1513,2858
9/20/2013 9:00,8,8000000,1095,1534,2629
9/20/2013 9:00,8,8000000,1166,1455,2621
9/20/2013 9:00,8,8000000,1055,1558,2613
9/20/2013 9:01,8,8000000,1270,1513,2783
9/20/2013 9:01,8,8000000,1109,1496,2605
9/20/2013 9:01,8,8000000,1156,1509,2665
9/20/2013 9:01,8,8000000,1135,1545,2680
9/20/2013 9:01,8,8000000,1245,1527,2772
9/20/2013 9:01,8,8000000,1035,1558,2593
9/20/2013 9:01,8,8000000,1140,1516,2656
9/20/2013 9:01,8,8000000,1740,1527,3267
9/20/2013 9:01,8,8000000,1294,1509,2803
9/20/2013 9:01,8,8000000,1212,1527,2739
9/20/2013 9:01,8,8000000,1031,1520,2551
9/20/2013 9:02,8,8000000,1150,1538,2688
9/20/2013 9:02,8,8000000,1149,1534,2683
9/20/2013 9:02,8,8000000,1082,1528,2610
9/20/2013 9:02,8,8000000,1148,1522,2670
9/20/2013 9:02,8,8000000,1722,1550,3272
9/20/2013 9:02,8,8000000,1050,1531,2581
9/20/2013 9:02,8,8000000,1166,1473,2639
9/20/2013 9:02,8,8000000,1006,1545,2551
9/20/2013 9:02,8,8000000,1164,1460,2624
9/20/2013 9:02,8,8000000,1140,1544,2684
9/20/2013 9:02,8,8000000,1390,1521,2911
9/20/2013 9:03,8,8000000,1067,1521,2588
9/20/2013 9:03,8,8000000,1275,1520,2795
9/20/2013 9:03,8,8000000,1132,1905,3037
9/20/2013 9:03,8,8000000,1240,1542,2782
9/20/2013 9:03,8,8000000,1135,1518,2653
9/20/2013 9:03,8,8000000,1101,1516,2617
9/20/2013 9:03,8,8000000,1116,1518,2634
9/20/2013 9:03,8,8000000,1319,1468,2787
9/20/2013 9:03,8,8000000,1197,1522,2719
9/20/2013 9:03,8,8000000,1213,1536,2749
9/20/2013 9:03,8,8000000,1142,1612,2754
9/20/2013 9:04,8,8000000,1125,1524,2649
9/20/2013 9:04,8,8000000,1208,1455,2663
9/20/2013 9:04,8,8000000,1177,1563,2740
9/20/2013 9:04,8,8000000,1128,1511,2639
9/20/2013 9:04,8,8000000,1518,1481,2999
9/20/2013 9:04,8,8000000,1096,1519,2615
9/20/2013 9:04,8,8000000,1094,1519,2613
9/20/2013 9:04,8,8000000,1510,1524,3034
9/20/2013 9:04,8,8000000,1045,1579,2624
9/20/2013 9:04,8,8000000,1283,2001,3284
9/20/2013 9:04,8,8000000,1026,1515,2541
9/20/2013 9:05,8,8000000,1225,1467,2692
9/20/2013 9:05,8,8000000,1338,1513,2851
9/20/2013 9:05,8,8000000,1250,1621,2871
9/20/2013 9:05,8,8000000,1144,1535,2679
9/20/2013 9:05,8,8000000,1745,1523,3268
9/20/2013 9:05,8,8000000,1069,1504,2573
9/20/2013 9:05,8,8000000,1077,1529,2606
9/20/2013 9:05,8,8000000,1469,1513,2982
9/20/2013 9:05,8,8000000,984,1553,2537
9/20/2013 9:05,8,8000000,1152,1533,2685
9/20/2013 9:05,8,8000000,1074,1590,2664
9/20/2013 9:06,8,8000000,1264,1460,2724
9/20/2013 9:06,8,8000000,1140,1580,2720
9/20/2013 9:06,8,8000000,1054,1548,2602
9/20/2013 9:06,8,8000000,1100,1540,2640
9/20/2013 9:06,8,8000000,1159,1526,2685
9/20/2013 9:06,8,8000000,1180,1563,2743
9/20/2013 9:06,8,8000000,1219,1567,2786
9/20/2013 9:06,8,8000000,1823,1638,3461
9/20/2013 9:06,8,8000000,1130,1525,2655
9/20/2013 9:06,8,8000000,1088,1543,2631
9/20/2013 9:07,8,8000000,1776,1465,3241
9/20/2013 9:07,8,8000000,1779,1472,3251
9/20/2013 9:07,8,8000000,1206,1452,2658
9/20/2013 9:07,8,8000000,1123,1528,2651
9/20/2013 9:07,8,8000000,1257,1523,2780
9/20/2013 9:07,8,8000000,1110,2030,3140
9/20/2013 9:07,8,8000000,1201,1604,2805
9/20/2013 9:07,8,8000000,1747,1537,3284
9/20/2013 9:07,8,8000000,974,1553,2527
9/20/2013 9:07,8,8000000,1186,1522,2708
9/20/2013 9:07,8,8000000,1168,1613,2781
9/20/2013 9:08,8,8000000,1117,1554,2671
9/20/2013 9:08,8,8000000,1116,1544,2660
9/20/2013 9:08,8,8000000,1075,1467,2542
9/20/2013 9:08,8,8000000,1352,1519,2871
9/20/2013 9:08,8,8000000,1137,1522,2659
9/20/2013 9:08,8,8000000,1208,1553,2761
9/20/2013 9:08,8,8000000,1092,1527,2619
9/20/2013 9:08,8,8000000,1080,1545,2625
9/20/2013 9:08,8,8000000,1257,1518,2775
9/20/2013 9:08,8,8000000,1182,1550,2732
9/20/2013 9:08,8,8000000,1412,1475,2887
9/20/2013 9:09,8,8000000,1261,1586,2847
9/20/2013 9:09,8,8000000,1060,1549,2609
9/20/2013 9:09,8,8000000,1322,1523,2845
9/20/2013 9:09,8,8000000,1107,1540,2647
9/20/2013 9:09,8,8000000,1141,1509,2650
9/20/2013 9:09,8,8000000,1273,1528,2801
9/20/2013 9:09,8,8000000,1235,1448,2683
9/20/2013 9:09,8,8000000,1202,1534,2736
9/20/2013 9:09,8,9000000,1676,1586,3262
9/20/2013 9:09,8,9000000,1612,1680,3292
9/20/2013 9:09,8,9000000,1487,1648,3135
9/20/2013 9:10,8,9000000,1678,1673,3351
9/20/2013 9:10,8,9000000,1627,1670,3297
9/20/2013 9:10,8,9000000,1523,2257,3780
9/20/2013 9:10,8,9000000,1615,1681,3296
9/20/2013 9:10,8,9000000,1853,1665,3518
9/20/2013 9:10,8,9000000,1741,1606,3347
9/20/2013 9:10,8,9000000,1762,1661,3423
9/20/2013 9:10,8,9000000,1854,1653,3507
9/20/2013 9:10,8,9000000,1698,1683,3381
9/20/2013 9:10,8,9000000,1616,1596,3212
9/20/2013 9:11,8,9000000,1635,1588,3223
9/20/2013 9:11,8,9000000,1957,1670,3627
9/20/2013 9:11,8,9000000,1669,2102,3771
9/20/2013 9:11,8,9000000,1581,1672,3253
9/20/2013 9:11,8,9000000,1578,1549,3127
9/20/2013 9:11,8,9000000,1713,1677,3390
9/20/2013 9:11,8,9000000,1490,1669,3159
9/20/2013 9:11,8,9000000,1543,1689,3232
9/20/2013 9:11,8,9000000,1553,1603,3156
9/20/2013 9:11,8,9000000,1539,1661,3200
9/20/2013 9:12,8,9000000,1909,1632,3541
9/20/2013 9:12,8,9000000,1485,1669,3154
9/20/2013 9:12,8,9000000,1811,1804,3615
9/20/2013 9:12,8,9000000,1612,1664,3276
9/20/2013 9:12,8,9000000,1612,1625,3237
9/20/2013 9:12,8,9000000,1709,1645,3354
9/20/2013 9:12,8,9000000,2008,1690,3698
9/20/2013 9:12,8,9000000,2217,1615,3832
9/20/2013 9:12,8,9000000,1550,1666,3216
9/20/2013 9:12,8,9000000,1631,1629,3260
9/20/2013 9:13,8,9000000,1537,1726,3263
9/20/2013 9:13,8,9000000,1575,1664,3239
9/20/2013 9:13,8,9000000,1496,1641,3137
9/20/2013 9:13,8,9000000,1603,1764,3367
9/20/2013 9:13,8,9000000,1567,1602,3169
9/20/2013 9:13,8,9000000,1594,1601,3195
9/20/2013 9:13,8,9000000,1687,1591,3278
9/20/2013 9:13,8,9000000,1594,1669,3263
9/20/2013 9:13,8,9000000,1618,1737,3355
9/20/2013 9:13,8,9000000,1593,1589,3182
9/20/2013 9:14,8,9000000,1678,1647,3325
9/20/2013 9:14,8,9000000,1902,1893,3795
9/20/2013 9:14,8,9000000,1578,1664,3242
9/20/2013 9:14,8,9000000,2184,1644,3828
9/20/2013 9:14,8,9000000,1585,1604,3189
9/20/2013 9:14,8,9000000,1725,1594,3319
9/20/2013 9:14,8,9000000,1571,1689,3260
9/20/2013 9:14,8,9000000,1970,1670,3640
9/20/2013 9:14,8,9000000,1547,1682,3229
9/20/2013 9:14,8,9000000,1556,1620,3176
9/20/2013 9:15,8,9000000,1544,1847,3391
9/20/2013 9:15,8,9000000,1753,1724,3477
9/20/2013 9:15,8,9000000,1611,1594,3205
9/20/2013 9:15,8,9000000,1703,1592,3295
9/20/2013 9:15,8,9000000,1703,1688,3391
9/20/2013 9:15,8,9000000,1831,1595,3426
9/20/2013 9:15,8,9000000,1615,1628,3243
9/20/2013 9:15,8,9000000,1470,1665,3135
9/20/2013 9:15,8,9000000,1695,1605,3300
9/20/2013 9:15,8,9000000,1559,1645,3204
9/20/2013 9:16,8,9000000,1942,1670,3612
9/20/2013 9:16,8,9000000,1580,1657,3237
9/20/2013 9:16,8,9000000,1728,1614,3342
9/20/2013 9:16,8,9000000,1577,1618,3195
9/20/2013 9:16,8,9000000,1581,1622,3203
9/20/2013 9:16,8,9000000,1639,1668,3307
9/20/2013 9:16,8,9000000,1805,1981,3786
9/20/2013 9:16,8,9000000,1595,1625,3220
9/20/2013 9:16,8,9000000,1436,1598,3034
9/20/2013 9:16,8,9000000,1823,1672,3495
9/20/2013 9:17,8,9000000,1805,2135,3940
9/20/2013 9:17,8,9000000,1653,1687,3340
9/20/2013 9:17,8,9000000,1656,1678,3334
9/20/2013 9:17,8,9000000,1503,1662,3165
9/20/2013 9:17,8,9000000,1510,1686,3196
9/20/2013 9:17,8,9000000,1719,1716,3435
9/20/2013 9:17,8,9000000,1598,1618,3216
9/20/2013 9:17,8,9000000,1542,1650,3192
9/20/2013 9:17,8,9000000,1556,1599,3155
9/20/2013 9:17,8,9000000,1632,1593,3225
9/20/2013 9:17,8,9000000,1534,1715,3249
9/20/2013 9:18,8,9000000,1537,1666,3203
9/20/2013 9:18,8,9000000,1631,1615,3246
9/20/2013 9:18,8,9000000,1584,1642,3226
9/20/2013 9:18,8,9000000,1537,1662,3199
9/20/2013 9:18,8,9000000,1616,1697,3313
9/20/2013 9:18,8,9000000,2179,1594,3773
9/20/2013 9:18,8,9000000,2175,1598,3773
9/20/2013 9:18,8,9000000,1774,1663,3437
9/20/2013 9:18,8,9000000,1667,1651,3318
9/20/2013 9:19,8,9000000,1671,1658,3329
9/20/2013 9:19,8,9000000,1578,1649,3227
9/20/2013 9:19,8,9000000,2109,1685,3794
9/20/2013 9:19,8,9000000,1650,1700,3350
9/20/2013 9:19,8,9000000,2052,1679,3731
9/20/2013 9:19,8,9000000,1604,1737,3341
9/20/2013 9:19,8,9000000,1549,1679,3228
9/20/2013 9:19,8,9000000,1671,1636,3307
9/20/2013 9:19,8,9000000,1565,1644,3209
9/20/2013 9:19,8,9000000,1563,1668,3231
9/20/2013 9:19,8,9000000,1700,1597,3297
9/20/2013 9:20,8,9000000,2184,1609,3793
9/20/2013 9:20,8,9000000,1789,1703,3492
9/20/2013 9:20,8,9000000,2274,1586,3860
9/20/2013 9:20,8,9000000,1540,1739,3279
9/20/2013 9:20,8,9000000,1618,1599,3217
9/20/2013 9:20,8,9000000,1831,1621,3452
9/20/2013 9:20,8,9000000,1771,1659,3430
9/20/2013 9:20,8,9000000,1522,1651,3173
9/20/2013 9:20,8,9000000,1575,1589,3164
9/20/2013 9:20,8,9000000,1525,1619,3144
9/20/2013 9:21,8,9000000,1511,1664,3175
9/20/2013 9:21,8,10000000,1753,1885,3638
9/20/2013 9:21,8,10000000,1792,1816,3608
9/20/2013 9:21,8,10000000,1750,1812,3562
9/20/2013 9:21,8,10000000,1801,1864,3665
9/20/2013 9:21,8,10000000,1957,1803,3760
9/20/2013 9:21,8,10000000,1722,1849,3571
9/20/2013 9:21,8,10000000,1861,1782,3643
9/20/2013 9:21,8,10000000,1836,1858,3694
9/20/2013 9:22,8,10000000,1957,1805,3762
9/20/2013 9:22,8,10000000,1768,1827,3595
9/20/2013 9:22,8,10000000,1902,1862,3764
9/20/2013 9:22,8,10000000,1929,1854,3783
9/20/2013 9:22,8,10000000,2043,1799,3842
9/20/2013 9:22,8,10000000,1804,1792,3596
9/20/2013 9:22,8,10000000,1769,1824,3593
9/20/2013 9:22,8,10000000,1736,1892,3628
9/20/2013 9:22,8,10000000,2012,1877,3889
9/20/2013 9:22,8,10000000,1803,1932,3735
9/20/2013 9:23,8,10000000,1689,1841,3530
9/20/2013 9:23,8,10000000,2099,1776,3875
9/20/2013 9:23,8,10000000,1740,1784,3524
9/20/2013 9:23,8,10000000,1821,1834,3655
9/20/2013 9:23,8,10000000,1841,1803,3644
9/20/2013 9:23,8,10000000,1872,1801,3673
9/20/2013 9:23,8,10000000,1863,1847,3710
9/20/2013 9:23,8,10000000,1863,1796,3659
9/20/2013 9:23,8,10000000,2013,1797,3810
9/20/2013 9:23,8,10000000,1832,1833,3665
9/20/2013 9:24,8,10000000,2427,1880,4307
9/20/2013 9:24,8,10000000,1923,1930,3853
9/20/2013 9:24,8,10000000,1994,1768,3762
9/20/2013 9:24,8,10000000,1917,1783,3700
9/20/2013 9:24,8,10000000,1856,1771,3627
9/20/2013 9:24,8,10000000,1824,1832,3656
9/20/2013 9:24,8,10000000,1815,1830,3645
9/20/2013 9:24,8,10000000,2110,1798,3908
9/20/2013 9:24,8,10000000,1902,1794,3696
9/20/2013 9:25,8,10000000,1772,1880,3652
9/20/2013 9:25,8,10000000,2156,1842,3998
9/20/2013 9:25,8,10000000,1839,1846,3685
9/20/2013 9:25,8,10000000,2021,1845,3866
9/20/2013 9:25,8,10000000,1791,1842,3633
9/20/2013 9:25,8,10000000,1902,1792,3694
9/20/2013 9:25,8,10000000,1851,1765,3616
9/20/2013 9:25,8,10000000,1807,1893,3700
9/20/2013 9:25,8,10000000,1779,1844,3623
9/20/2013 9:26,8,10000000,1897,1814,3711
9/20/2013 9:26,8,10000000,1883,1852,3735
9/20/2013 9:26,8,10000000,1935,1854,3789
9/20/2013 9:26,8,10000000,1886,1844,3730
9/20/2013 9:26,8,10000000,1911,2098,4009
9/20/2013 9:26,8,10000000,1947,1850,3797
9/20/2013 9:26,8,10000000,1771,1802,3573
9/20/2013 9:26,8,10000000,2057,1776,3833
9/20/2013 9:26,8,10000000,1913,1813,3726
9/20/2013 9:26,8,10000000,1709,1920,3629
9/20/2013 9:27,8,10000000,2077,1901,3978
9/20/2013 9:27,8,10000000,1915,1783,3698
9/20/2013 9:27,8,10000000,1762,1862,3624
9/20/2013 9:27,8,10000000,1790,1856,3646
9/20/2013 9:27,8,10000000,1880,1907,3787
9/20/2013 9:27,8,10000000,1900,2378,4278
9/20/2013 9:27,8,10000000,1856,2429,4285
9/20/2013 9:27,8,10000000,1917,1784,3701
9/20/2013 9:27,8,10000000,1958,2048,4006
9/20/2013 9:28,8,10000000,1833,1762,3595
9/20/2013 9:28,8,10000000,1869,1795,3664
9/20/2013 9:28,8,10000000,1864,1889,3753
9/20/2013 9:28,8,10000000,1887,1800,3687
9/20/2013 9:28,8,10000000,1934,1757,3691
9/20/2013 9:28,8,10000000,2052,1774,3826
9/20/2013 9:28,8,10000000,1765,1847,3612
9/20/2013 9:28,8,10000000,1798,1834,3632
9/20/2013 9:28,8,10000000,2167,1944,4111
9/20/2013 9:28,8,10000000,1849,1876,3725
9/20/2013 9:29,8,10000000,1858,1785,3643
9/20/2013 9:29,8,10000000,2029,1768,3797
9/20/2013 9:29,8,10000000,1793,1805,3598
9/20/2013 9:29,8,10000000,1944,1779,3723
9/20/2013 9:29,8,10000000,1901,1794,3695
9/20/2013 9:29,8,10000000,1812,1786,3598
9/20/2013 9:29,8,10000000,1932,1794,3726
9/20/2013 9:29,8,10000000,1892,1789,3681
9/20/2013 9:29,8,10000000,1889,1807,3696
9/20/2013 9:30,8,10000000,1893,1795,3688
9/20/2013 9:30,8,10000000,1842,1893,3735
9/20/2013 9:30,8,10000000,1779,1894,3673
9/20/2013 9:30,8,10000000,1709,1793,3502
9/20/2013 9:30,8,10000000,1981,1826,3807
9/20/2013 9:30,8,10000000,1803,1862,3665
9/20/2013 9:30,8,10000000,2005,1851,3856
9/20/2013 9:30,8,10000000,1737,1878,3615
9/20/2013 9:30,8,10000000,1819,1779,3598
9/20/2013 9:30,8,10000000,1852,1789,3641
9/20/2013 9:31,8,10000000,1767,1807,3574
9/20/2013 9:31,8,10000000,1856,1794,3650
9/20/2013 9:31,8,10000000,1783,1978,3761
9/20/2013 9:31,8,10000000,1832,1887,3719
9/20/2013 9:31,8,10000000,1909,1790,3699
9/20/2013 9:31,8,10000000,1868,1863,3731
9/20/2013 9:31,8,10000000,2075,1791,3866
9/20/2013 9:31,8,10000000,1743,1838,3581
9/20/2013 9:31,8,10000000,2443,1797,4240
9/20/2013 9:32,8,10000000,2031,1783,3814
9/20/2013 9:32,8,10000000,1786,1799,3585
9/20/2013 9:32,8,10000000,1939,1787,3726
9/20/2013 9:32,8,10000000,1948,1838,3786
9/20/2013 9:32,8,10000000,1748,1911,3659
9/20/2013 9:32,8,10000000,1812,1804,3616
9/20/2013 9:32,8,10000000,2048,1802,3850
9/20/2013 9:32,8,10000000,1803,1777,3580
9/20/2013 9:32,8,10000000,1750,1823,3573
9/20/2013 9:32,8,10000000,1968,1814,3782
9/20/2013 9:33,8,10000000,1809,1786,3595
9/20/2013 9:33,8,10000000,2014,1837,3851
9/20/2013 9:33,8,10000000,2153,1780,3933
9/20/2013 9:33,8,10000000,1667,1864,3531
9/20/2013 9:33,8,10000000,1759,1836,3595
9/20/2013 9:33,8,10000000,1900,1778,3678
9/20/2013 9:33,8,10000000,1867,1786,3653
9/20/2013 9:33,8,10000000,1733,1883,3616
9/20/2013 9:33,8,10000000,2036,1845,3881
9/20/2013 9:34,8,10000000,2087,1840,3927
9/20/2013 9:34,8,10000000,1835,1979,3814
9/20/2013 9:34,8,10000000,1809,1786,3595
9/20/2013 9:34,8,10000000,1918,1853,3771
9/20/2013 9:34,8,10000000,2181,1858,4039
9/20/2013 9:34,8,10000000,2064,1800,3864
9/20/2013 9:34,8,10000000,1990,1826,3816
9/20/2013 9:34,8,10000000,2006,1828,3834
9/20/2013 9:34,8,10000000,2103,1786,3889
9/20/2013 9:35,8,10000000,1702,1844,3546
9/20/2013 9:35,8,10000000,1872,1796,3668
9/20/2013 9:35,8,10000000,1716,1873,3589
9/20/2013 9:35,8,10000000,1931,1814,3745
9/20/2013 9:35,8,10000000,2009,1791,3800
9/20/2013 9:35,8,10000000,2091,1846,3937
9/20/2013 9:35,8,10000000,2250,1860,4110
9/20/2013 9:35,8,10000000,1804,1841,3645
9/20/2013 9:35,8,10000000,2410,1891,4301
9/20/2013 9:35,8,10000000,1785,1796,3581
9/20/2013 9:36,8,10000000,2266,1829,4095
9/20/2013 9:36,8,10000000,1787,1849,3636
9/20/2013 9:36,8,10000000,1933,2196,4129
9/20/2013 9:36,8,10000000,1834,1774,3608
9/20/2013 9:36,8,10000000,1782,1860,3642
9/20/2013 9:36,8,10000000,1895,1789,3684
9/20/2013 9:36,8,10000000,1880,1817,3697
9/20/2013 9:36,8,10000000,1861,1949,3810
9/20/2013 9:36,8,10000000,1924,1920,3844
9/20/2013 9:37,8,10000000,1856,1779,3635
9/20/2013 9:37,8,10000000,1950,1848,3798
9/20/2013 9:37,8,10000000,1758,1786,3544
9/20/2013 9:37,8,10000000,2114,1780,3894
9/20/2013 9:37,8,10000000,1739,1771,3510
9/20/2013 9:37,8,10000000,1835,1801,3636
9/20/2013 9:37,8,10000000,1753,1792,3545
9/20/2013 9:37,8,10000000,2214,1712,3926
9/20/2013 9:37,8,10000000,1813,1902,3715
9/20/2013 9:37,8,10000000,1918,1775,3693
9/20/2013 9:38,8,10000000,1984,2080,4064
9/20/2013 9:38,8,10000000,1842,1794,3636
9/20/2013 9:38,8,10000000,1804,1894,3698
9/20/2013 9:38,8,10000000,1719,1876,3595
9/20/2013 9:38,8,10000000,1978,1795,3773
9/20/2013 9:38,8,10000000,2005,1784,3789
9/20/2013 9:38,8,10000000,1778,1840,3618
9/20/2013 9:38,8,10000000,1740,1841,3581
9/20/2013 9:38,8,10000000,1872,1784,3656
9/20/2013 9:39,8,10000000,1854,1792,3646
9/20/2013 9:39,8,10000000,1903,1933,3836
9/20/2013 9:39,8,10000000,1816,1851,3667
9/20/2013 9:39,8,10000000,1883,1750,3633
9/20/2013 9:39,8,10000000,1806,1823,3629
9/20/2013 9:39,8,10000000,1888,1804,3692
9/20/2013 9:39,8,10000000,2259,1847,4106
9/20/2013 9:39,8,10000000,1873,1822,3695
9/20/2013 9:39,8,10000000,1890,1865,3755
9/20/2013 9:39,8,10000000,2125,1867,3992
9/20/2013 9:40,8,10000000,1782,1933,3715
9/20/2013 9:40,8,10000000,1840,1937,3777
9/20/2013 9:40,8,10000000,1915,1762,3677
9/20/2013 9:40,8,10000000,1977,2130,4107
9/20/2013 9:40,8,10000000,1789,1821,3610
9/20/2013 9:40,8,10000000,1773,1927,3700
9/20/2013 9:40,8,10000000,1753,1908,3661
9/20/2013 9:40,8,10000000,1673,1875,3548
9/20/2013 9:40,8,10000000,1840,1907,3747
9/20/2013 9:41,8,10000000,1863,1828,3691
9/20/2013 9:41,8,10000000,1776,1879,3655
9/20/2013 9:41,8,10000000,1855,1943,3798
9/20/2013 9:41,8,10000000,1835,1792,3627
9/20/2013 9:41,8,10000000,1872,1797,3669
9/20/2013 9:41,8,10000000,1765,1846,3611
9/20/2013 9:41,8,10000000,1923,1802,3725
9/20/2013 9:41,8,10000000,1864,1911,3775
9/20/2013 9:41,8,10000000,1871,1909,3780
9/20/2013 9:42,8,10000000,1702,1858,3560
9/20/2013 9:42,8,10000000,1804,1808,3612
9/20/2013 9:42,8,10000000,1681,1872,3553
9/20/2013 9:42,8,10000000,1829,1857,3686
9/20/2013 9:42,8,10000000,1906,1851,3757
9/20/2013 9:42,8,10000000,2059,1793,3852
9/20/2013 9:42,8,10000000,1739,1886,3625
9/20/2013 9:42,8,10000000,2004,1856,3860
9/20/2013 9:42,8,10000000,1879,1945,3824
9/20/2013 9:42,8,10000000,2043,1855,3898
9/20/2013 9:43,8,10000000,1832,1861,3693
9/20/2013 9:43,8,10000000,2519,1826,4345
9/20/2013 9:43,8,10000000,1786,1805,3591
9/20/2013 9:43,8,10000000,1875,1848,3723
9/20/2013 9:43,8,10000000,2082,1898,3980
9/20/2013 9:43,8,10000000,1735,1830,3565
9/20/2013 9:43,8,10000000,2083,1769,3852
9/20/2013 9:43,8,10000000,2050,1783,3833
9/20/2013 9:43,8,10000000,2116,1814,3930
9/20/2013 9:44,8,10000000,1728,1852,3580
9/20/2013 9:44,8,10000000,1898,1798,3696
9/20/2013 9:44,8,10000000,1769,1843,3612
9/20/2013 9:44,8,10000000,1955,1857,3812
9/20/2013 9:44,8,10000000,1867,1801,3668
9/20/2013 9:44,8,10000000,1914,1798,3712
9/20/2013 9:44,8,10000000,2021,1790,3811
9/20/2013 9:44,8,10000000,2067,1803,3870
9/20/2013 9:44,8,10000000,1937,1835,3772
9/20/2013 9:44,8,10000000,1809,1809,3618
9/20/2013 9:45,8,10000000,1910,1855,3765
9/20/2013 9:45,8,10000000,1810,1790,3600
9/20/2013 9:45,8,10000000,1751,1875,3626
9/20/2013 9:45,8,10000000,2106,1814,3920
9/20/2013 9:45,8,20000000,3636,3471,7107
9/20/2013 9:45,8,20000000,3628,3550,7178
9/20/2013 9:45,8,20000000,3618,3634,7252
9/20/2013 9:46,8,20000000,3461,4106,7567
9/20/2013 9:46,8,20000000,3639,3652,7291
9/20/2013 9:46,8,20000000,3788,3527,7315
9/20/2013 9:46,8,20000000,3707,3602,7309
9/20/2013 9:46,8,20000000,3502,3478,6980
9/20/2013 9:46,8,20000000,3820,3446,7266
9/20/2013 9:47,8,20000000,3663,3501,7164
9/20/2013 9:47,8,20000000,3739,3528,7267
9/20/2013 9:47,8,20000000,3778,3594,7372
9/20/2013 9:47,8,20000000,3498,3608,7106
9/20/2013 9:47,8,20000000,3660,3657,7317
9/20/2013 9:48,8,20000000,4006,3473,7479
9/20/2013 9:48,8,20000000,3478,3600,7078
9/20/2013 9:48,8,20000000,3551,3556,7107
9/20/2013 9:48,8,20000000,3493,3589,7082
9/20/2013 9:48,8,20000000,3457,3655,7112
9/20/2013 9:48,8,20000000,3671,3611,7282
9/20/2013 9:49,8,20000000,3706,3662,7368
9/20/2013 9:49,8,20000000,3689,3464,7153
9/20/2013 9:49,8,20000000,3480,3804,7284
9/20/2013 9:49,8,20000000,3583,3596,7179
9/20/2013 9:49,8,20000000,3466,3564,7030
9/20/2013 9:49,8,20000000,3484,3523,7007
9/20/2013 9:50,8,20000000,3546,3530,7076
9/20/2013 9:50,8,20000000,3545,3533,7078
9/20/2013 9:50,8,20000000,3448,3577,7025
9/20/2013 9:50,8,20000000,3608,3510,7118
9/20/2013 9:50,8,20000000,3603,3576,7179
9/20/2013 9:50,8,20000000,3651,3547,7198
9/20/2013 9:51,8,20000000,3508,3586,7094
9/20/2013 9:51,8,20000000,3566,3581,7147
9/20/2013 9:51,8,20000000,3621,3896,7517
9/20/2013 9:51,8,20000000,3592,3617,7209
9/20/2013 9:51,8,20000000,3753,3594,7347
9/20/2013 9:52,8,20000000,3621,3494,7115
9/20/2013 9:52,8,20000000,3603,3615,7218
9/20/2013 9:52,8,20000000,3485,3607,7092
9/20/2013 9:52,8,20000000,3538,3788,7326
9/20/2013 9:52,8,20000000,3574,3597,7171
9/20/2013 9:52,8,20000000,3745,3476,7221
9/20/2013 9:53,8,20000000,3327,3663,6990
9/20/2013 9:53,8,20000000,3783,3474,7257
9/20/2013 9:53,8,20000000,3641,3594,7235
9/20/2013 9:53,8,20000000,3713,3471,7184
9/20/2013 9:53,8,20000000,3601,3462,7063
9/20/2013 9:53,8,20000000,3812,3679,7491
9/20/2013 9:54,8,20000000,3465,3496,6961
9/20/2013 9:54,8,20000000,3950,3548,7498
9/20/2013 9:54,8,20000000,3578,3596,7174
9/20/2013 9:54,8,20000000,3726,3540,7266
9/20/2013 9:54,8,20000000,3668,3567,7235
9/20/2013 9:54,8,20000000,3494,3591,7085
9/20/2013 9:55,8,20000000,3701,3583,7284
9/20/2013 9:55,8,20000000,3483,3590,7073
9/20/2013 9:55,8,20000000,3658,3473,7131
9/20/2013 9:55,8,20000000,3732,3465,7197
9/20/2013 9:55,8,20000000,3646,3488,7134
9/20/2013 9:56,8,20000000,3459,3614,7073
9/20/2013 9:56,8,20000000,3452,3589,7041
9/20/2013 9:56,8,20000000,3771,3634,7405
9/20/2013 9:56,8,20000000,3808,3518,7326
9/20/2013 9:56,8,20000000,3740,3530,7270
9/20/2013 9:56,8,20000000,3621,3791,7412
9/20/2013 9:57,8,20000000,3612,3618,7230
9/20/2013 9:57,8,20000000,3639,3601,7240
9/20/2013 9:57,8,20000000,3676,3497,7173
9/20/2013 9:57,8,20000000,3762,3462,7224
9/20/2013 9:57,8,20000000,3642,3586,7228
9/20/2013 9:57,8,20000000,3907,3626,7533
9/20/2013 9:58,8,20000000,3682,3485,7167
9/20/2013 9:58,8,20000000,3826,3576,7402
9/20/2013 9:58,8,20000000,3500,3460,6960
9/20/2013 9:58,8,20000000,3551,3522,7073
9/20/2013 9:58,8,20000000,3704,3475,7179
9/20/2013 9:58,8,20000000,3825,3591,7416
9/20/2013 9:59,8,20000000,3852,3481,7333
9/20/2013 9:59,8,20000000,3765,3467,7232
9/20/2013 9:59,8,20000000,3632,3643,7275
9/20/2013 9:59,8,20000000,3776,3560,7336
9/20/2013 9:59,8,20000000,3670,3488,7158
9/20/2013 10:00,8,20000000,3840,3689,7529
9/20/2013 10:00,8,20000000,3533,3486,7019
9/20/2013 10:00,8,20000000,3394,3646,7040
9/20/2013 10:00,8,20000000,3619,3636,7255
9/20/2013 10:00,8,20000000,3612,3516,7128
9/20/2013 10:00,8,20000000,3588,3465,7053
9/20/2013 10:01,8,20000000,3875,3460,7335
9/20/2013 10:01,8,20000000,3926,3530,7456
9/20/2013 10:01,8,20000000,3471,3634,7105
9/20/2013 10:01,8,20000000,3483,3586,7069
9/20/2013 10:01,8,20000000,3528,3453,6981
9/20/2013 10:01,8,20000000,3551,3587,7138
9/20/2013 10:02,8,20000000,3501,3665,7166
9/20/2013 10:02,8,20000000,3643,3483,7126
9/20/2013 10:02,8,20000000,3559,3615,7174
9/20/2013 10:02,8,20000000,3695,3477,7172
9/20/2013 10:02,8,20000000,3683,3591,7274
9/20/2013 10:02,8,20000000,3520,3648,7168
9/20/2013 10:03,8,20000000,3680,3652,7332
9/20/2013 10:03,8,20000000,3614,3579,7193
9/20/2013 10:03,8,20000000,3798,3447,7245
9/20/2013 10:03,8,20000000,3609,3553,7162
9/20/2013 10:03,8,20000000,3925,4268,8193
9/20/2013 10:04,8,20000000,3737,3774,7511
9/20/2013 10:04,8,20000000,3697,3674,7371
9/20/2013 10:04,8,20000000,3479,3600,7079
9/20/2013 10:04,8,20000000,3511,3450,6961
9/20/2013 10:04,8,20000000,3668,3490,7158
9/20/2013 10:04,8,20000000,3791,3515,7306
9/20/2013 10:05,8,20000000,3673,3541,7214
9/20/2013 10:05,8,20000000,3524,3664,7188
9/20/2013 10:05,8,20000000,3645,3492,7137
9/20/2013 10:05,8,30000000,4882,5456,10338
9/20/2013 10:05,8,30000000,5011,5194,10205
9/20/2013 10:06,8,30000000,4676,5321,9997
9/20/2013 10:06,8,30000000,4957,5176,10133
9/20/2013 10:06,8,30000000,4957,5165,10122
9/20/2013 10:06,8,30000000,5071,5360,10431
9/20/2013 10:07,8,30000000,5045,5289,10334
9/20/2013 10:07,8,30000000,5182,5184,10366
9/20/2013 10:07,8,30000000,4918,5317,10235
9/20/2013 10:07,8,30000000,4622,5353,9975
9/20/2013 10:08,8,30000000,4890,5322,10212
9/20/2013 10:08,8,30000000,4791,5440,10231
9/20/2013 10:08,8,30000000,4880,5281,10161
9/20/2013 10:08,8,30000000,4939,5248,10187
9/20/2013 10:08,8,30000000,5014,5153,10167
9/20/2013 10:09,8,30000000,5027,5381,10408
9/20/2013 10:09,8,30000000,4853,5174,10027
9/20/2013 10:09,8,30000000,4940,5136,10076
9/20/2013 10:09,8,30000000,4960,5204,10164
9/20/2013 10:10,8,30000000,4938,5270,10208
9/20/2013 10:10,8,30000000,5042,5190,10232
9/20/2013 10:10,8,30000000,4719,5330,10049
9/20/2013 10:10,8,30000000,4800,5406,10206
9/20/2013 10:11,8,30000000,5214,5190,10404
9/20/2013 10:11,8,30000000,5080,5120,10200
9/20/2013 10:11,8,30000000,4837,5300,10137
9/20/2013 10:11,8,30000000,4705,5188,9893
9/20/2013 10:11,8,30000000,5088,5185,10273
9/20/2013 10:12,8,30000000,4807,5282,10089
9/20/2013 10:12,8,30000000,4832,5377,10209
9/20/2013 10:12,8,30000000,4706,5306,10012
9/20/2013 10:12,8,30000000,4678,5370,10048
9/20/2013 10:13,8,30000000,5009,5248,10257
9/20/2013 10:13,8,30000000,4796,5335,10131
9/20/2013 10:13,8,30000000,4656,5317,9973
9/20/2013 10:13,8,30000000,5091,5631,10722
9/20/2013 10:14,8,30000000,4702,5335,10037
9/20/2013 10:14,8,30000000,4737,5464,10201
9/20/2013 10:14,8,30000000,5213,5191,10404
9/20/2013 10:14,8,30000000,4711,5329,10040
9/20/2013 10:15,8,30000000,5295,5265,10560
9/20/2013 10:15,8,30000000,4919,5269,10188
9/20/2013 10:15,8,30000000,4875,5184,10059
9/20/2013 10:15,8,30000000,5076,5325,10401
9/20/2013 10:15,8,30000000,4743,5279,10022
9/20/2013 10:16,8,30000000,4978,5204,10182
9/20/2013 10:16,8,30000000,4958,5388,10346
9/20/2013 10:16,8,30000000,4923,5290,10213
9/20/2013 10:16,8,30000000,4867,5268,10135
9/20/2013 10:17,8,30000000,4757,5255,10012
9/20/2013 10:17,8,30000000,4791,5383,10174
9/20/2013 10:17,8,30000000,5228,5286,10514
9/20/2013 10:17,8,30000000,5121,5298,10419
9/20/2013 10:18,8,30000000,4750,5264,10014
9/20/2013 10:18,8,30000000,5203,5324,10527
9/20/2013 10:18,8,30000000,4908,5274,10182
9/20/2013 10:18,8,30000000,4794,5407,10201
9/20/2013 10:19,8,30000000,4966,5240,10206
9/20/2013 10:19,8,30000000,4964,5247,10211
9/20/2013 10:19,8,30000000,4946,5241,10187
9/20/2013 10:19,8,30000000,5033,5171,10204
9/20/2013 10:19,8,30000000,4872,5438,10310
9/20/2013 10:20,8,30000000,4943,5352,10295
9/20/2013 10:20,8,30000000,4902,5264,10166
9/20/2013 10:20,8,30000000,5133,5156,10289
9/20/2013 10:20,8,30000000,4937,5330,10267
9/20/2013 10:21,8,30000000,4593,5183,9776
9/20/2013 10:21,8,30000000,4767,5385,10152
9/20/2013 10:21,8,30000000,4728,5188,9916
9/20/2013 10:21,8,30000000,5084,5329,10413
9/20/2013 10:22,8,30000000,4992,5166,10158
9/20/2013 10:22,8,30000000,4895,5383,10278
9/20/2013 10:22,8,30000000,5103,5266,10369
9/20/2013 10:22,8,30000000,4880,5275,10155
9/20/2013 10:23,8,30000000,4997,5347,10344
9/20/2013 10:23,8,30000000,4719,5173,9892
9/20/2013 10:23,8,30000000,5068,5166,10234
9/20/2013 10:23,8,30000000,4707,5256,9963
9/20/2013 10:23,8,30000000,4719,5265,9984
9/20/2013 10:24,8,30000000,5049,5189,10238
9/20/2013 10:24,8,30000000,4713,5273,9986
9/20/2013 10:24,8,30000000,4937,5170,10107
9/20/2013 10:24,8,30000000,4774,5325,10099
9/20/2013 10:25,8,30000000,4810,5596,10406
9/20/2013 10:25,8,30000000,4895,5240,10135
9/20/2013 10:25,8,30000000,4796,5388,10184
9/20/2013 10:25,8,30000000,4895,5325,10220
9/20/2013 10:26,8,30000000,5247,5178,10425
9/20/2013 10:26,8,30000000,5258,5263,10521
9/20/2013 10:26,8,30000000,4895,5324,10219
9/20/2013 10:26,8,30000000,4976,5230,10206
9/20/2013 10:26,8,30000000,4777,5159,9936
9/20/2013 10:27,8,30000000,4853,5439,10292
9/20/2013 10:27,8,30000000,4873,5313,10186
9/20/2013 10:27,8,30000000,4913,5211,10124
9/20/2013 10:27,8,30000000,5060,5147,10207
9/20/2013 10:28,8,30000000,4799,5268,10067
9/20/2013 10:28,8,30000000,4859,5389,10248
9/20/2013 10:28,8,30000000,4633,5295,9928
9/20/2013 10:28,8,30000000,4968,5247,10215
9/20/2013 10:29,8,30000000,4546,5522,10068
9/20/2013 10:29,8,30000000,5100,5165,10265
9/20/2013 10:29,8,30000000,4968,5164,10132
9/20/2013 10:29,8,30000000,4934,5316,10250
9/20/2013 10:30,8,30000000,4832,5440,10272
9/20/2013 10:30,8,30000000,4658,5326,9984
9/20/2013 10:30,8,30000000,5270,5427,10697
9/20/2013 10:30,8,30000000,4776,5360,10136
9/20/2013 10:30,8,30000000,4798,5414,10212
9/20/2013 10:31,8,30000000,4785,5194,9979
9/20/2013 10:31,8,30000000,5030,5184,10214
9/20/2013 10:31,8,30000000,4905,5312,10217
9/20/2013 10:31,8,30000000,5100,5337,10437
9/20/2013 10:32,8,30000000,4684,5194,9878
9/20/2013 10:32,8,30000000,5027,5302,10329
9/20/2013 10:32,8,40000000,7099,6942,14041
9/20/2013 10:33,8,40000000,7536,7206,14742
9/20/2013 10:33,8,40000000,7480,6953,14433
9/20/2013 10:33,8,40000000,7077,8378,15455
9/20/2013 10:33,8,40000000,7282,7633,14915
9/20/2013 10:34,8,40000000,7283,7022,14305
9/20/2013 10:34,8,40000000,7092,6931,14023
9/20/2013 10:34,8,40000000,7580,7147,14727
9/20/2013 10:35,8,40000000,6992,6977,13969
9/20/2013 10:35,8,40000000,6955,7319,14274
9/20/2013 10:35,8,40000000,7334,7097,14431
9/20/2013 10:36,8,40000000,7326,7172,14498
9/20/2013 10:36,8,40000000,7431,7161,14592
9/20/2013 10:36,8,40000000,7380,7190,14570
9/20/2013 10:37,8,40000000,7627,6938,14565
9/20/2013 10:37,8,40000000,7475,7310,14785
9/20/2013 10:37,8,40000000,7543,6931,14474
9/20/2013 10:38,8,40000000,7205,8423,15628
9/20/2013 10:38,8,40000000,7287,7168,14455
9/20/2013 10:38,8,40000000,7217,7416,14633
9/20/2013 10:39,8,40000000,7318,7194,14512
9/20/2013 10:39,8,40000000,7418,7275,14693
9/20/2013 10:39,8,40000000,7163,7094,14257
9/20/2013 10:40,8,40000000,6868,7364,14232
9/20/2013 10:40,8,40000000,7453,7503,14956
9/20/2013 10:40,8,40000000,7571,7200,14771
9/20/2013 10:40,8,40000000,7459,7357,14816
9/20/2013 10:41,8,40000000,6987,7244,14231
9/20/2013 10:41,8,40000000,7364,7154,14518
9/20/2013 10:41,8,40000000,7467,7204,14671
9/20/2013 10:42,8,40000000,7198,7317,14515
9/20/2013 10:42,8,40000000,7056,7426,14482
9/20/2013 10:42,8,40000000,7558,7158,14716
9/20/2013 10:43,8,40000000,7710,7180,14890
9/20/2013 10:43,8,40000000,7113,6900,14013
9/20/2013 10:43,8,40000000,7492,6959,14451
9/20/2013 10:44,8,40000000,7440,7028,14468
9/20/2013 10:44,8,40000000,7461,6957,14418
9/20/2013 10:44,8,40000000,7173,7373,14546
9/20/2013 10:45,8,40000000,7789,6894,14683
9/20/2013 10:45,8,40000000,7111,7179,14290
9/20/2013 10:45,8,40000000,7527,7844,15371
9/20/2013 10:46,8,40000000,6990,7374,14364
9/20/2013 10:46,8,40000000,7466,6922,14388
9/20/2013 10:46,8,40000000,7246,7229,14475
9/20/2013 10:47,8,40000000,7142,7312,14454
9/20/2013 10:47,8,40000000,7104,7084,14188
9/20/2013 10:47,8,40000000,7074,7346,14420
9/20/2013 10:47,8,40000000,7526,7140,14666
9/20/2013 10:48,8,40000000,7216,7304,14520
9/20/2013 10:48,8,40000000,7572,6956,14528
9/20/2013 10:48,8,40000000,7254,6922,14176
9/20/2013 10:49,8,40000000,7946,6934,14880
9/20/2013 10:49,8,40000000,7606,7151,14757
9/20/2013 10:49,8,40000000,7698,6983,14681
9/20/2013 10:50,8,40000000,7625,6919,14544
9/20/2013 10:50,8,40000000,6899,7164,14063
9/20/2013 10:50,8,40000000,7140,6879,14019
9/20/2013 10:51,8,40000000,7557,6931,14488
9/20/2013 10:51,8,40000000,7196,6941,14137
9/20/2013 10:51,8,40000000,7287,6920,14207
9/20/2013 10:52,8,40000000,7067,6948,14015
9/20/2013 10:52,8,40000000,7646,7043,14689
9/20/2013 10:52,8,40000000,7306,6958,14264
9/20/2013 10:53,8,40000000,7057,6937,13994
9/20/2013 10:53,8,40000000,7398,6905,14303
9/20/2013 10:53,8,40000000,7321,6941,14262
9/20/2013 10:53,8,40000000,7014,7374,14388
9/20/2013 10:54,8,40000000,6981,7192,14173
9/20/2013 10:54,8,40000000,7439,6931,14370
9/20/2013 10:54,8,40000000,7490,7169,14659
9/20/2013 10:55,8,40000000,7182,7124,14306
9/20/2013 10:55,8,40000000,7536,6978,14514
9/20/2013 10:55,8,40000000,7360,7542,14902
9/20/2013 10:56,8,40000000,7050,7177,14227
9/20/2013 10:56,8,40000000,7540,7059,14599
9/20/2013 10:56,8,40000000,7745,6942,14687
9/20/2013 10:57,8,40000000,7065,7249,14314
9/20/2013 10:57,8,40000000,7390,6905,14295
9/20/2013 10:57,8,40000000,7241,6939,14180
9/20/2013 10:58,8,40000000,7470,6973,14443
9/20/2013 10:58,8,40000000,7166,7373,14539
9/20/2013 10:58,8,40000000,7918,7149,15067
9/20/2013 10:59,8,40000000,7179,6981,14160
9/20/2013 10:59,8,40000000,7507,6921,14428
9/20/2013 10:59,8,40000000,6926,6978,13904
9/20/2013 10:59,8,40000000,7223,6926,14149
9/20/2013 11:00,8,40000000,7162,7188,14350
9/20/2013 11:00,8,40000000,7196,6937,14133
9/20/2013 11:00,8,40000000,7461,7145,14606
9/20/2013 11:01,8,40000000,7450,6951,14401
9/20/2013 11:01,8,40000000,7206,7323,14529
9/20/2013 11:01,8,40000000,7282,7194,14476
9/20/2013 11:02,8,40000000,6972,7385,14357
9/20/2013 11:02,8,40000000,7296,7312,14608
9/20/2013 11:02,8,40000000,7296,7153,14449
9/20/2013 11:03,8,40000000,7039,7285,14324
9/20/2013 11:03,8,40000000,7295,6893,14188
9/20/2013 11:03,8,40000000,7101,6952,14053
9/20/2013 11:04,8,40000000,7467,7164,14631
9/20/2013 11:04,8,40000000,7418,6933,14351
9/20/2013 11:04,8,40000000,7166,7258,14424
9/20/2013 11:04,8,40000000,7067,7373,14440
9/20/2013 11:05,8,40000000,7357,7301,14658
9/20/2013 11:05,8,40000000,7526,6966,14492
9/20/2013 11:05,8,40000000,7061,6963,14024
9/20/2013 11:06,8,40000000,7889,7324,15213
9/20/2013 11:06,8,40000000,7512,7205,14717
9/20/2013 11:06,8,40000000,7215,7149,14364
9/20/2013 11:07,8,40000000,7302,6983,14285
9/20/2013 11:07,8,40000000,6823,7148,13971
9/20/2013 11:07,8,40000000,7352,7188,14540
9/20/2013 11:08,8,40000000,7666,6952,14618
9/20/2013 11:08,8,40000000,7690,6943,14633
9/20/2013 11:08,8,40000000,7519,7157,14676
9/20/2013 11:09,8,50000000,8844,9212,18056
9/20/2013 11:09,8,50000000,8404,9640,18044
9/20/2013 11:09,8,50000000,8716,9700,18416
9/20/2013 11:10,8,50000000,8885,9220,18105
9/20/2013 11:10,8,50000000,8314,8913,17227
9/20/2013 11:11,8,50000000,8367,9621,17988
9/20/2013 11:11,8,50000000,8378,9205,17583
9/20/2013 11:11,8,50000000,8659,9292,17951
9/20/2013 11:12,8,50000000,8634,8820,17454
9/20/2013 11:12,8,50000000,8533,8939,17472
9/20/2013 11:13,8,50000000,8268,9221,17489
9/20/2013 11:13,8,50000000,9044,9230,18274
9/20/2013 11:13,8,50000000,8488,9575,18063
9/20/2013 11:14,8,50000000,8417,9297,17714
9/20/2013 11:14,8,50000000,8624,9329,17953
9/20/2013 11:14,8,50000000,8942,9334,18276
9/20/2013 11:15,8,50000000,8940,9186,18126
9/20/2013 11:15,8,50000000,9055,9248,18303
9/20/2013 11:16,8,50000000,8418,9569,17987
9/20/2013 11:16,8,50000000,8176,9726,17902
9/20/2013 11:16,8,50000000,9221,9244,18465
9/20/2013 11:17,8,50000000,8170,9253,17423
9/20/2013 11:17,8,50000000,8964,9639,18603
9/20/2013 11:18,8,50000000,8722,9213,17935
9/20/2013 11:18,8,50000000,8553,9995,18548
9/20/2013 11:18,8,50000000,8901,8793,17694
9/20/2013 11:19,8,50000000,9016,8972,17988
9/20/2013 11:19,8,50000000,8926,8868,17794
9/20/2013 11:19,8,50000000,8799,8857,17656
9/20/2013 11:20,8,50000000,8132,9211,17343
9/20/2013 11:20,8,50000000,9254,9318,18572
9/20/2013 11:21,8,50000000,8467,9280,17747
9/20/2013 11:21,8,50000000,8079,9583,17662
9/20/2013 11:21,8,50000000,8975,9413,18388
9/20/2013 11:22,8,50000000,8873,9568,18441
9/20/2013 11:22,8,50000000,8904,9377,18281
9/20/2013 11:23,8,50000000,8516,9283,17799
9/20/2013 11:23,8,50000000,8318,9182,17500
9/20/2013 11:23,8,50000000,8288,9301,17589
9/20/2013 11:24,8,50000000,8280,9226,17506
9/20/2013 11:24,8,50000000,8920,9176,18096
9/20/2013 11:25,8,50000000,9186,9200,18386
9/20/2013 11:25,8,50000000,8900,9096,17996
9/20/2013 11:25,8,50000000,9317,8939,18256
9/20/2013 11:26,8,50000000,9146,9057,18203
9/20/2013 11:26,8,50000000,9000,9225,18225
9/20/2013 11:26,8,50000000,8207,9287,17494
9/20/2013 11:27,8,50000000,9649,9112,18761
9/20/2013 11:27,8,50000000,9184,9315,18499
9/20/2013 11:28,8,50000000,8676,9546,18222
9/20/2013 11:28,8,50000000,8588,9205,17793
9/20/2013 11:28,8,50000000,8545,9842,18387
9/20/2013 11:29,8,50000000,9141,8832,17973
9/20/2013 11:29,8,50000000,8167,9308,17475
9/20/2013 11:30,8,50000000,8676,9194,17870
9/20/2013 11:30,8,50000000,8424,9168,17592
9/20/2013 11:30,8,50000000,8864,8848,17712
9/20/2013 11:31,8,50000000,8613,9550,18163
9/20/2013 11:31,8,50000000,8673,8992,17665
9/20/2013 11:31,8,50000000,8475,9295,17770
9/20/2013 11:32,8,50000000,8710,9999,18709
9/20/2013 11:32,8,50000000,8442,9618,18060
9/20/2013 11:33,8,50000000,8743,9168,17911
9/20/2013 11:33,8,50000000,8334,9288,17622
9/20/2013 11:33,8,50000000,9304,9491,18795
9/20/2013 11:34,8,50000000,8872,9016,17888
9/20/2013 11:34,8,50000000,8926,9096,18022
9/20/2013 11:35,8,50000000,8389,8900,17289
9/20/2013 11:35,8,50000000,8638,8888,17526
9/20/2013 11:35,8,50000000,9101,8938,18039
9/20/2013 11:36,8,50000000,9318,8875,18193
9/20/2013 11:36,8,50000000,8803,9271,18074
9/20/2013 11:36,8,50000000,8591,8881,17472
9/20/2013 11:37,8,50000000,8409,9050,17459
9/20/2013 11:37,8,50000000,9011,9239,18250
9/20/2013 11:38,8,50000000,8665,8905,17570
9/20/2013 11:38,8,50000000,8705,8884,17589
9/20/2013 11:38,8,50000000,8178,9272,17450
9/20/2013 11:39,8,50000000,8439,8862,17301
9/20/2013 11:39,8,50000000,8690,8855,17545
9/20/2013 11:40,8,50000000,8660,9604,18264
9/20/2013 11:40,8,50000000,9090,8884,17974
9/20/2013 11:40,8,50000000,8862,9231,18093
9/20/2013 11:41,8,50000000,8712,9144,17856
9/20/2013 11:41,8,50000000,8781,8798,17579
9/20/2013 11:41,8,50000000,8314,8827,17141
9/20/2013 11:42,8,50000000,8386,9322,17708
9/20/2013 11:42,8,50000000,8326,9176,17502
9/20/2013 11:43,8,50000000,8409,9188,17597
9/20/2013 12:00,8,50000000,9076,8961,18037
9/20/2013 12:00,8,50000000,8679,9190,17869
9/20/2013 12:01,8,50000000,8843,8829,17672
9/20/2013 12:01,8,50000000,8379,9274,17653
9/20/2013 12:01,8,50000000,9235,9004,18239
9/20/2013 12:02,8,50000000,8907,9272,18179
9/20/2013 12:02,8,50000000,9117,8903,18020
9/20/2013 12:03,8,50000000,8606,9197,17803
9/20/2013 12:03,8,50000000,8504,9854,18358
9/20/2013 12:03,8,50000000,8263,10013,18276
9/20/2013 12:04,8,50000000,9338,9349,18687
9/20/2013 12:04,8,50000000,8198,9610,17808
9/20/2013 12:21,8,50000000,8649,9383,18032
9/20/2013 12:22,8,50000000,8854,9285,18139
9/20/2013 12:22,8,50000000,8290,9662,17952
9/20/2013 12:23,8,50000000,9393,9038,18431
9/20/2013 12:23,8,50000000,9039,9682,18721
9/20/2013 12:23,8,50000000,8591,9611,18202
9/20/2013 12:24,8,50000000,9024,9023,18047
9/20/2013 12:24,8,50000000,8613,9806,18419
9/20/2013 12:25,8,50000000,8563,9731,18294
9/20/2013 12:25,8,50000000,8891,8826,17717
9/20/2013 12:25,8,50000000,8799,9229,18028
9/20/2013 12:26,8,50000000,8518,9549,18067
9/20/2013 12:26,8,60000000,9485,10155,19640
9/20/2013 12:27,8,60000000,10443,10282,20725
9/20/2013 12:27,8,60000000,10073,10526,20599
9/20/2013 12:28,8,60000000,10127,10163,20290
9/20/2013 12:28,8,60000000,9850,10142,19992
9/20/2013 12:28,8,60000000,9980,10352,20332
9/20/2013 12:29,8,60000000,10101,10163,20264
9/20/2013 12:29,8,60000000,10575,10246,20821
9/20/2013 12:30,8,60000000,10259,10435,20694
9/20/2013 12:30,8,60000000,10098,10511,20609
9/20/2013 12:31,8,60000000,9584,13573,23157
9/20/2013 12:31,8,60000000,9740,10183,19923
9/20/2013 12:31,8,60000000,9868,10597,20465
9/20/2013 12:32,8,60000000,10060,10958,21018
9/20/2013 12:32,8,60000000,10223,10133,20356
9/20/2013 12:33,8,60000000,10929,10493,21422
9/20/2013 12:33,8,60000000,10217,10749,20966
9/20/2013 12:34,8,60000000,10043,10131,20174
9/20/2013 12:34,8,60000000,10428,10118,20546
9/20/2013 12:35,8,60000000,9937,10105,20042
9/20/2013 12:35,8,60000000,9861,10509,20370
9/20/2013 12:35,8,60000000,10000,10677,20677
9/20/2013 12:36,8,60000000,10423,10138,20561
9/20/2013 12:36,8,60000000,9675,10204,19879
9/20/2013 12:37,8,60000000,11453,10230,21683
9/20/2013 12:37,8,60000000,9990,10438,20428
9/20/2013 12:38,8,60000000,10594,10191,20785
9/20/2013 12:38,8,60000000,9774,10269,20043
9/20/2013 12:39,8,60000000,9929,10127,20056
9/20/2013 12:39,8,60000000,10929,10185,21114
9/20/2013 12:39,8,60000000,10035,10581,20616
9/20/2013 12:40,8,60000000,10347,10167,20514
9/20/2013 12:40,8,60000000,9547,10131,19678
9/20/2013 12:41,8,60000000,9806,10282,20088
9/20/2013 12:41,8,60000000,11308,10212,21520
9/20/2013 12:42,8,60000000,10084,10564,20648
9/20/2013 12:42,8,60000000,10894,10234,21128
9/20/2013 12:42,8,60000000,10069,10164,20233
9/20/2013 12:43,8,60000000,10045,13967,24012
9/20/2013 12:43,8,60000000,10135,10176,20311
9/20/2013 12:44,8,60000000,10223,10759,20982
9/20/2013 12:44,8,60000000,9674,10171,19845
9/20/2013 12:45,8,60000000,10044,10270,20314
9/20/2013 12:45,8,60000000,9982,10246,20228
9/20/2013 12:46,8,60000000,11125,10289,21414
9/20/2013 12:46,8,60000000,10093,10837,20930
9/20/2013 12:47,8,60000000,10025,10403,20428
9/20/2013 12:47,8,60000000,10996,10364,21360
9/20/2013 12:47,8,60000000,9691,11128,20819
9/20/2013 12:48,8,60000000,9934,10167,20101
9/20/2013 12:48,8,60000000,10922,10144,21066
9/20/2013 12:49,8,60000000,9679,10060,19739
9/20/2013 12:49,8,60000000,11077,10554,21631
9/20/2013 12:50,8,60000000,9481,10422,19903
9/20/2013 12:50,8,60000000,9846,10179,20025
9/20/2013 12:50,8,60000000,10989,10245,21234
9/20/2013 12:51,8,60000000,9390,10764,20154
9/20/2013 12:51,8,60000000,9557,10179,19736
9/20/2013 12:52,8,60000000,10162,10189,20351
9/20/2013 12:52,8,60000000,9676,10208,19884
9/20/2013 12:53,8,60000000,10334,10165,20499
9/20/2013 12:53,8,60000000,10297,10153,20450
9/20/2013 12:54,8,60000000,10338,10496,20834
9/20/2013 12:54,8,60000000,10186,10267,20453
9/20/2013 12:54,8,60000000,10415,10547,20962
9/20/2013 12:55,8,60000000,10486,10217,20703
9/20/2013 12:55,8,60000000,10078,10119,20197
9/20/2013 12:56,8,60000000,10308,10534,20842
9/20/2013 12:56,8,60000000,9821,10553,20374
9/20/2013 12:57,8,60000000,10272,13949,24221
9/20/2013 12:57,8,60000000,9928,10450,20378
9/20/2013 12:58,8,60000000,10889,10103,20992
9/20/2013 12:58,8,60000000,9947,10527,20474
9/20/2013 12:58,8,60000000,10332,10324,20656
9/20/2013 12:59,8,60000000,10808,10499,21307
9/20/2013 12:59,8,60000000,10322,10244,20566
9/20/2013 1:00,8,60000000,9349,10502,19851
9/20/2013 1:00,8,60000000,10002,10059,20061
9/20/2013 1:01,8,60000000,10749,10112,20861
9/20/2013 1:01,8,60000000,9892,10348,20240
9/20/2013 1:01,8,60000000,9751,10164,19915
9/20/2013 1:02,8,60000000,9992,10099,20091
9/20/2013 1:02,8,60000000,9550,10535,20085
9/20/2013 1:03,8,60000000,10654,10773,21427
9/20/2013 1:03,8,60000000,9815,10157,19972
9/20/2013 1:04,8,60000000,9635,10796,20431
9/20/2013 1:04,8,60000000,10782,10091,20873
9/20/2013 1:05,8,60000000,10736,10383,21119
9/20/2013 1:05,8,60000000,9886,10509,20395
9/20/2013 1:05,8,60000000,10477,10171,20648
9/20/2013 1:06,8,60000000,9676,10432,20108
9/20/2013 1:06,8,60000000,10834,10257,21091
9/20/2013 1:07,8,60000000,10118,11667,21785
9/20/2013 1:07,8,60000000,10368,10171,20539
9/20/2013 1:08,8,60000000,10552,10215,20767
9/20/2013 1:08,8,60000000,9349,10617,19966
9/20/2013 1:09,8,60000000,9714,10502,20216
9/20/2013 1:09,8,60000000,10278,10131,20409
9/20/2013 1:09,8,60000000,9993,10129,20122
9/20/2013 1:10,8,60000000,11188,10179,21367
9/20/2013 1:10,8,60000000,9811,10154,19965
9/20/2013 1:11,8,60000000,9918,10215,20133
9/20/2013 1:11,8,60000000,9945,10132,20077
9/20/2013 1:12,8,60000000,9832,10597,20429
9/20/2013 1:12,8,60000000,9705,10473,20178
9/20/2013 1:12,8,60000000,9841,10221,20062
9/20/2013 1:13,8,60000000,9808,10326,20134
9/20/2013 1:13,8,60000000,10361,10486,20847
9/20/2013 1:14,8,60000000,9579,10516,20095
9/20/2013 1:14,8,60000000,9616,10182,19798
9/20/2013 1:15,8,60000000,10725,10563,21288
9/20/2013 1:15,8,60000000,10397,10580,20977
9/20/2013 1:16,8,60000000,9735,10131,19866
9/20/2013 1:16,8,60000000,10312,10704,21016
9/20/2013 1:16,8,60000000,10722,10512,21234
9/20/2013 1:17,8,70000000,10764,12515,23279
9/20/2013 1:17,8,70000000,11102,12279,23381
9/20/2013 1:18,8,70000000,12276,12227,24503
9/20/2013 1:19,8,70000000,11841,17330,29171
9/20/2013 1:19,8,70000000,11773,16813,28586
9/20/2013 1:20,8,70000000,11875,12168,24043
9/20/2013 1:20,8,70000000,11463,12137,23600
9/20/2013 1:21,8,70000000,11864,12230,24094
9/20/2013 1:21,8,70000000,11063,12225,23288
9/20/2013 1:22,8,70000000,11041,12189,23230
9/20/2013 1:22,8,70000000,11650,12653,24303
9/20/2013 1:23,8,70000000,11748,12246,23994
9/20/2013 1:23,8,70000000,11355,12254,23609
9/20/2013 1:24,8,70000000,12200,12218,24418
9/20/2013 1:24,8,70000000,11024,12597,23621
9/20/2013 1:25,8,70000000,11077,13041,24118
9/20/2013 1:25,8,70000000,11551,12202,23753
9/20/2013 1:26,8,70000000,10859,16787,27646
9/20/2013 1:26,8,70000000,11693,12293,23986
9/20/2013 1:27,8,70000000,11148,12134,23282
9/20/2013 1:27,8,70000000,11040,12084,23124
9/20/2013 1:28,8,70000000,11539,12175,23714
9/20/2013 1:28,8,70000000,11353,12283,23636
9/20/2013 1:29,8,70000000,12017,12223,24240
9/20/2013 1:29,8,70000000,11856,12146,24002
9/20/2013 1:30,8,70000000,11264,12372,23636
9/20/2013 1:30,8,70000000,11346,12256,23602
9/20/2013 1:31,8,70000000,10670,12534,23204
9/20/2013 1:31,8,70000000,12524,12257,24781
9/20/2013 1:32,8,70000000,11105,12587,23692
9/20/2013 1:32,8,70000000,11958,12253,24211
9/20/2013 1:33,8,70000000,11000,12456,23456
9/20/2013 1:33,8,70000000,10858,12527,23385
9/20/2013 1:34,8,70000000,11308,12497,23805
9/20/2013 1:34,8,70000000,11050,12584,23634
9/20/2013 1:35,8,70000000,11191,12921,24112
9/20/2013 1:35,8,70000000,11233,12151,23384
9/20/2013 1:36,8,70000000,10872,12216,23088
9/20/2013 1:36,8,70000000,11131,13000,24131
9/20/2013 1:37,8,70000000,11628,12597,24225
9/20/2013 1:37,8,70000000,12205,12293,24498
9/20/2013 1:38,8,70000000,11526,12201,23727
9/20/2013 1:38,8,70000000,11346,12170,23516
9/20/2013 1:39,8,70000000,11695,12276,23971
9/20/2013 1:39,8,70000000,12304,12282,24586
9/20/2013 1:40,8,70000000,11164,12259,23423
9/20/2013 1:40,8,70000000,11560,12498,24058
9/20/2013 1:41,8,70000000,11479,16250,27729
9/20/2013 1:41,8,70000000,10884,12241,23125
9/20/2013 1:42,8,70000000,11206,12208,23414
9/20/2013 1:42,8,70000000,10769,12191,22960
9/20/2013 1:43,8,70000000,11230,12428,23658
9/20/2013 1:43,8,70000000,11124,12153,23277
9/20/2013 1:44,8,70000000,11437,12518,23955
9/20/2013 1:44,8,70000000,11357,12273,23630
9/20/2013 1:45,8,70000000,12146,12399,24545
9/20/2013 1:45,8,70000000,11346,12661,24007
9/20/2013 1:46,8,70000000,11375,12518,23893
9/20/2013 1:47,8,70000000,12114,16218,28332
9/20/2013 1:47,8,70000000,11562,12470,24032
9/20/2013 1:48,8,70000000,11228,12160,23388
9/20/2013 1:48,8,70000000,11200,12241,23441
9/20/2013 1:49,8,70000000,12146,12311,24457
9/20/2013 1:49,8,70000000,11794,12525,24319
9/20/2013 1:50,8,70000000,11628,12238,23866
9/20/2013 1:50,8,70000000,12361,12219,24580
9/20/2013 1:51,8,70000000,11373,12585,23958
9/20/2013 1:51,8,70000000,12383,12290,24673
9/20/2013 1:52,8,70000000,11298,12505,23803
9/20/2013 1:52,8,70000000,11421,12193,23614
9/20/2013 1:53,8,70000000,10963,12079,23042
9/20/2013 1:53,8,70000000,12340,12250,24590
9/20/2013 1:54,8,70000000,10399,12799,23198
9/20/2013 1:54,8,70000000,11527,12556,24083
9/20/2013 1:55,8,70000000,11900,12236,24136
9/20/2013 1:55,8,70000000,11398,12253,23651
9/20/2013 1:56,8,70000000,10445,12512,22957
9/20/2013 1:56,8,70000000,11059,12246,23305
9/20/2013 1:57,8,70000000,12051,12162,24213
9/20/2013 1:57,8,70000000,12015,12840,24855
9/20/2013 1:58,8,70000000,12155,12431,24586
9/20/2013 1:58,8,70000000,11952,12192,24144
9/20/2013 1:59,8,70000000,11583,13148,24731
9/20/2013 1:59,8,70000000,11900,12190,24090
9/20/2013 2:00,8,70000000,11988,12221,24209
9/20/2013 2:00,8,70000000,11152,12535,23687
9/20/2013 2:01,8,70000000,12017,12250,24267
9/20/2013 2:01,8,70000000,10777,12342,23119
9/20/2013 2:02,8,70000000,11266,12206,23472
9/20/2013 2:02,8,70000000,11575,12226,23801
9/20/2013 2:03,8,70000000,11203,12144,23347
9/20/2013 2:03,8,70000000,10942,12243,23185
9/20/2013 2:04,8,70000000,11101,16988,28089
9/20/2013 2:04,8,70000000,11181,12200,23381
9/20/2013 2:05,8,70000000,11280,12059,23339
9/20/2013 2:05,8,70000000,12267,12265,24532
9/20/2013 2:06,8,70000000,11788,12532,24320
9/20/2013 2:06,8,70000000,12230,12259,24489
9/20/2013 2:07,8,70000000,10976,12182,23158
9/20/2013 2:07,8,70000000,11109,12572,23681
9/20/2013 2:08,8,70000000,10730,12652,23382
9/20/2013 2:08,8,70000000,12056,12217,24273
9/20/2013 2:09,8,70000000,12283,12098,24381
9/20/2013 2:09,8,70000000,11240,12141,23381
9/20/2013 2:10,8,70000000,11161,12525,23686
9/20/2013 2:10,8,70000000,12938,12259,25197
9/20/2013 2:11,8,70000000,11903,12274,24177
9/20/2013 2:11,8,70000000,12523,12246,24769
9/20/2013 2:12,8,70000000,11525,12035,23560
9/20/2013 2:12,8,70000000,11175,12216,23391
9/20/2013 2:13,8,70000000,12074,12486,24560
9/20/2013 2:13,8,70000000,10998,12515,23513
9/20/2013 2:14,8,70000000,11973,12179,24152
9/20/2013 2:15,8,70000000,12093,12154,24247
9/20/2013 2:15,8,70000000,11113,12138,23251
9/20/2013 2:16,8,80000000,15678,13675,29353
9/20/2013 2:16,8,80000000,15105,13829,28934
9/20/2013 2:17,8,80000000,14915,13691,28606
9/20/2013 2:17,8,80000000,14820,13668,28488
9/20/2013 2:18,8,80000000,15748,13895,29643
9/20/2013 2:19,8,80000000,15218,13649,28867
9/20/2013 2:19,8,80000000,15655,13559,29214
9/20/2013 2:20,8,80000000,15753,13635,29388
9/20/2013 2:20,8,80000000,15343,14117,29460
9/20/2013 2:21,8,80000000,15211,13907,29118
9/20/2013 2:22,8,80000000,14988,14111,29099
9/20/2013 2:22,8,80000000,14988,14152,29140
9/20/2013 2:23,8,80000000,15791,13575,29366
9/20/2013 2:23,8,80000000,14719,14152,28871
9/20/2013 2:24,8,80000000,15174,14078,29252
9/20/2013 2:25,8,80000000,15789,13679,29468
9/20/2013 2:25,8,80000000,14490,14075,28565
9/20/2013 2:26,8,80000000,15464,13774,29238
9/20/2013 2:27,8,80000000,15476,13662,29138
9/20/2013 2:27,8,80000000,16061,13843,29904
9/20/2013 2:28,8,80000000,14894,13633,28527
9/20/2013 2:28,8,80000000,15582,13694,29276
9/20/2013 2:29,8,80000000,15181,13642,28823
9/20/2013 2:30,8,80000000,15479,13623,29102
9/20/2013 2:30,8,80000000,15520,13536,29056
9/20/2013 2:31,8,80000000,14828,13974,28802
9/20/2013 2:31,8,80000000,14696,13542,28238
9/20/2013 2:32,8,80000000,15826,13688,29514
9/20/2013 2:33,8,80000000,14236,13831,28067
9/20/2013 2:33,8,80000000,15348,13610,28958
9/20/2013 2:34,8,80000000,15153,13783,28936
9/20/2013 2:34,8,80000000,15330,13735,29065
9/20/2013 2:35,8,80000000,14885,14064,28949
9/20/2013 2:36,8,80000000,15114,13605,28719
9/20/2013 2:36,8,80000000,14867,13778,28645
9/20/2013 2:37,8,80000000,14720,13724,28444
9/20/2013 2:37,8,80000000,15027,13651,28678
9/20/2013 2:38,8,80000000,14215,13623,27838
9/20/2013 2:39,8,80000000,15269,13704,28973
9/20/2013 2:39,8,80000000,15621,14098,29719
9/20/2013 2:40,8,80000000,16065,13937,30002
9/20/2013 2:40,8,80000000,14741,13646,28387
9/20/2013 2:41,8,80000000,15696,14172,29868
9/20/2013 2:42,8,80000000,15686,13616,29302
9/20/2013 2:42,8,80000000,15433,14212,29645
9/20/2013 2:43,8,80000000,14367,13696,28063
9/20/2013 2:43,8,80000000,15260,13769,29029
9/20/2013 2:44,8,80000000,15944,13753,29697
9/20/2013 2:45,8,80000000,14056,14123,28179
9/20/2013 2:45,8,80000000,14974,14095,29069
9/20/2013 2:46,8,80000000,15039,13741,28780
9/20/2013 2:46,8,80000000,15600,13647,29247
9/20/2013 2:47,8,80000000,15190,14474,29664
9/20/2013 2:48,8,80000000,15651,14191,29842
9/20/2013 2:48,8,80000000,15619,13594,29213
9/20/2013 2:49,8,80000000,15946,14095,30041
9/20/2013 2:49,8,80000000,15405,13813,29218
9/20/2013 2:50,8,80000000,15081,13995,29076
9/20/2013 2:51,8,80000000,15639,13510,29149
9/20/2013 2:51,8,80000000,15994,13862,29856
9/20/2013 2:52,8,80000000,14882,14031,28913
9/20/2013 2:53,8,80000000,15162,14180,29342
9/20/2013 2:53,8,80000000,16130,13624,29754
9/20/2013 2:54,8,80000000,15349,13956,29305
9/20/2013 2:54,8,80000000,14437,13711,28148
9/20/2013 2:55,8,80000000,15330,13876,29206
9/20/2013 2:56,8,80000000,14731,13631,28362
9/20/2013 2:56,8,80000000,15082,13676,28758
9/20/2013 2:57,8,80000000,14940,14353,29293
9/20/2013 2:57,8,80000000,15449,14196,29645
9/20/2013 2:58,8,80000000,15992,14037,30029
9/20/2013 2:59,8,80000000,14770,13728,28498
9/20/2013 2:59,8,80000000,16398,13733,30131
9/20/2013 3:00,8,80000000,14856,13757,28613
9/20/2013 3:00,8,80000000,15371,13823,29194
9/20/2013 3:01,8,80000000,15154,13691,28845
9/20/2013 3:02,8,80000000,14947,13709,28656
9/20/2013 3:02,8,80000000,14517,13828,28345
9/20/2013 3:03,8,80000000,15227,13785,29012
9/20/2013 3:03,8,80000000,14770,13647,28417
9/20/2013 3:04,8,80000000,15654,13659,29313
9/20/2013 3:05,8,80000000,15370,13715,29085
9/20/2013 3:05,8,80000000,14863,14216,29079
9/20/2013 3:06,8,80000000,15101,13692,28793
9/20/2013 3:06,8,80000000,15441,13650,29091
9/20/2013 3:07,8,80000000,15759,13809,29568
9/20/2013 3:08,8,80000000,14699,13662,28361
9/20/2013 3:08,8,80000000,14837,14139,28976
9/20/2013 3:09,8,80000000,14722,13852,28574
9/20/2013 3:09,8,80000000,15820,14922,30742
9/20/2013 3:10,8,80000000,15127,14074,29201
9/20/2013 3:11,8,80000000,14019,14066,28085
9/20/2013 3:11,8,80000000,14532,13787,28319
9/20/2013 3:12,8,80000000,15642,13701,29343
9/20/2013 3:12,8,80000000,14830,13636,28466
9/20/2013 3:13,8,80000000,15358,13819,29177
9/20/2013 3:14,8,80000000,14931,13614,28545
9/20/2013 3:14,8,80000000,14347,14235,28582
9/20/2013 3:15,8,80000000,11580,14396,25976
9/20/2013 3:15,8,80000000,14289,13784,28073
9/20/2013 3:16,8,80000000,15723,14474,30197
9/20/2013 3:17,8,80000000,16396,13747,30143
9/20/2013 3:17,8,80000000,14573,13748,28321
9/20/2013 3:18,8,80000000,15303,13672,28975
9/20/2013 3:18,8,80000000,15416,14163,29579
9/20/2013 3:19,8,80000000,14438,13642,28080
9/20/2013 3:20,8,80000000,15128,13525,28653
9/20/2013 3:20,8,80000000,14859,13703,28562
9/20/2013 3:21,8,80000000,14788,13747,28535
9/20/2013 3:21,8,80000000,15112,13724,28836
9/20/2013 3:22,8,80000000,15920,14464,30384
9/20/2013 3:23,8,80000000,15591,13710,29301
9/20/2013 3:23,8,80000000,15989,13752,29741
9/20/2013 3:24,8,80000000,15950,14054,30004
9/20/2013 3:24,8,80000000,14667,13749,28416
9/20/2013 3:25,8,90000000,16910,15864,32774
9/20/2013 3:26,8,90000000,15762,15443,31205
9/20/2013 3:26,8,90000000,16482,16586,33068
9/20/2013 3:27,8,90000000,16382,15651,32033
9/20/2013 3:28,8,90000000,16132,15493,31625
9/20/2013 3:28,8,90000000,16611,15468,32079
9/20/2013 3:29,8,90000000,15829,15423,31252
9/20/2013 3:30,8,90000000,17111,15442,32553
9/20/2013 3:30,8,90000000,15237,15790,31027
9/20/2013 3:31,8,90000000,16582,16005,32587
9/20/2013 3:32,8,90000000,17010,15966,32976
9/20/2013 3:32,8,90000000,16167,15652,31819
9/20/2013 3:33,8,90000000,17089,16074,33163
9/20/2013 3:34,8,90000000,16408,15417,31825
9/20/2013 3:34,8,90000000,16525,15655,32180
9/20/2013 3:35,8,90000000,16765,15350,32115
9/20/2013 3:36,8,90000000,16642,15592,32234
9/20/2013 3:36,8,90000000,15686,15435,31121
9/20/2013 3:37,8,90000000,16571,15430,32001
9/20/2013 3:38,8,90000000,16389,15659,32048
9/20/2013 3:38,8,90000000,16368,15991,32359
9/20/2013 3:39,8,90000000,16507,15687,32194
9/20/2013 3:40,8,90000000,16421,20625,37046
9/20/2013 3:41,8,90000000,16988,15764,32752
9/20/2013 3:41,8,90000000,17413,15514,32927
9/20/2013 3:42,8,90000000,17309,15618,32927
9/20/2013 3:43,8,90000000,16326,15879,32205
9/20/2013 3:43,8,90000000,16517,15451,31968
9/20/2013 3:44,8,90000000,16731,15505,32236
9/20/2013 3:45,8,90000000,16869,15553,32422
9/20/2013 3:45,8,90000000,16204,15943,32147
9/20/2013 3:46,8,90000000,15986,15561,31547
9/20/2013 3:47,8,90000000,15875,15938,31813
9/20/2013 3:47,8,90000000,17096,15605,32701
9/20/2013 3:48,8,90000000,16211,15313,31524
9/20/2013 3:49,8,90000000,17438,15527,32965
9/20/2013 3:49,8,90000000,15691,16244,31935
9/20/2013 3:50,8,90000000,16006,15556,31562
9/20/2013 3:51,8,90000000,16781,15811,32592
9/20/2013 3:51,8,90000000,17446,15585,33031
9/20/2013 3:52,8,90000000,15796,17146,32942
9/20/2013 3:53,8,90000000,16922,15569,32491
9/20/2013 3:53,8,90000000,16453,15442,31895
9/20/2013 3:54,8,90000000,17054,16577,33631
9/20/2013 3:55,8,90000000,16684,15500,32184
9/20/2013 3:55,8,90000000,16491,15774,32265
9/20/2013 3:56,8,90000000,16017,15399,31416
9/20/2013 3:57,8,90000000,15909,15845,31754
9/20/2013 3:57,8,90000000,16262,15967,32229
9/20/2013 3:58,8,90000000,16477,15543,32020
9/20/2013 3:59,8,90000000,16110,15615,31725
9/20/2013 3:59,8,90000000,17403,15854,33257
9/20/2013 4:00,8,90000000,16278,15799,32077
9/20/2013 4:01,8,90000000,16354,15468,31822
9/20/2013 4:01,8,90000000,17391,15572,32963
9/20/2013 4:02,8,90000000,16991,15703,32694
9/20/2013 4:03,8,90000000,16825,15303,32128
9/20/2013 4:03,8,90000000,16317,15548,31865
9/20/2013 4:04,8,90000000,16239,15621,31860
9/20/2013 4:05,8,90000000,17029,15624,32653
9/20/2013 4:05,8,90000000,16042,15582,31624
9/20/2013 4:06,8,90000000,16762,15649,32411
9/20/2013 4:07,8,90000000,16743,15926,32669
9/20/2013 4:07,8,90000000,16301,15538,31839
9/20/2013 4:08,8,90000000,16605,15943,32548
9/20/2013 4:09,8,90000000,16832,15814,32646
9/20/2013 4:09,8,90000000,16726,15667,32393
9/20/2013 4:10,8,90000000,16438,15599,32037
9/20/2013 4:11,8,90000000,16237,15503,31740
9/20/2013 4:11,8,90000000,16447,15845,32292
9/20/2013 4:12,8,90000000,16658,15368,32026
9/20/2013 4:13,8,90000000,16612,15596,32208
9/20/2013 4:13,8,90000000,15934,15988,31922
9/20/2013 4:14,8,90000000,17417,15825,33242
9/20/2013 4:15,8,90000000,15309,16587,31896
9/20/2013 4:15,8,90000000,16275,15791,32066
9/20/2013 4:16,8,90000000,16729,15587,32316
9/20/2013 4:17,8,90000000,17115,15610,32725
9/20/2013 4:17,8,90000000,16329,15670,31999
9/20/2013 4:18,8,90000000,17519,15594,33113
9/20/2013 4:19,8,90000000,17729,15654,33383
9/20/2013 4:19,8,90000000,16663,15585,32248
9/20/2013 4:20,8,90000000,16937,15558,32495
9/20/2013 4:21,8,90000000,17416,15806,33222
9/20/2013 4:21,8,90000000,17054,15383,32437
9/20/2013 4:22,8,90000000,16732,15446,32178
9/20/2013 4:23,8,90000000,17383,15562,32945
9/20/2013 4:23,8,90000000,16130,15697,31827
9/20/2013 4:24,8,90000000,16186,15420,31606
9/20/2013 4:25,8,90000000,15917,16224,32141
9/20/2013 4:25,8,90000000,17196,16026,33222
9/20/2013 4:26,8,90000000,15448,15362,30810
9/20/2013 4:27,8,90000000,17609,15808,33417
9/20/2013 4:27,8,90000000,16176,15303,31479
9/20/2013 4:28,8,90000000,16617,15600,32217
9/20/2013 4:29,8,90000000,15829,15558,31387
9/20/2013 4:29,8,90000000,16436,15516,31952
9/20/2013 4:30,8,90000000,16711,15411,32122
9/20/2013 4:31,8,90000000,15926,15424,31350
9/20/2013 4:31,8,90000000,16678,15937,32615
9/20/2013 4:32,8,90000000,16747,15609,32356
9/20/2013 4:33,8,90000000,16750,15983,32733
9/20/2013 4:33,8,90000000,16568,15526,32094
9/20/2013 4:34,8,90000000,16360,15501,31861
9/20/2013 4:35,8,90000000,16524,15505,32029
9/20/2013 4:35,8,90000000,16941,15582,32523
9/20/2013 4:36,8,90000000,16460,15936,32396
9/20/2013 4:37,8,90000000,17411,15955,33366
9/20/2013 4:37,8,90000000,15905,15526,31431
9/20/2013 4:38,8,90000000,16016,15509,31525
9/20/2013 4:39,8,90000000,16580,15968,32548
9/20/2013 4:39,8,90000000,16255,15956,32211
9/20/2013 4:40,8,90000000,16067,15606,31673
9/20/2013 4:41,8,90000000,16719,15607,32326
9/20/2013 4:41,8,90000000,17156,15511,32667
9/20/2013 4:42,8,100000000,18575,17925,36500
9/20/2013 4:43,8,100000000,18879,18028,36907
9/20/2013 4:44,8,100000000,18686,17953,36639
9/20/2013 4:44,8,100000000,19485,17929,37414
9/20/2013 4:45,8,100000000,19371,18200,37571
9/20/2013 4:46,8,100000000,20056,18228,38284
9/20/2013 4:47,8,100000000,17730,17815,35545
9/20/2013 4:47,8,100000000,18698,17803,36501
9/20/2013 4:48,8,100000000,18440,18779,37219
9/20/2013 4:49,8,100000000,18682,17805,36487
9/20/2013 4:50,8,100000000,17930,18449,36379
9/20/2013 4:50,8,100000000,17054,17935,34989
9/20/2013 4:51,8,100000000,17501,17800,35301
9/20/2013 4:52,8,100000000,17425,18231,35656
9/20/2013 4:53,8,100000000,17463,17937,35400
9/20/2013 4:53,8,100000000,18279,18030,36309
9/20/2013 4:54,8,100000000,18762,18405,37167
9/20/2013 4:55,8,100000000,17934,18202,36136
9/20/2013 4:56,8,100000000,18003,17939,35942
9/20/2013 4:56,8,100000000,17459,17928,35387
9/20/2013 4:57,8,100000000,18614,17814,36428
9/20/2013 4:58,8,100000000,17063,17757,34820
9/20/2013 4:59,8,100000000,18853,17866,36719
9/20/2013 4:59,8,100000000,17660,19884,37544
9/20/2013 5:00,8,100000000,17855,18254,36109
9/20/2013 5:01,8,100000000,17747,18295,36042
9/20/2013 5:02,8,100000000,18364,17845,36209
9/20/2013 5:02,8,100000000,17559,18375,35934
9/20/2013 5:03,8,100000000,18111,18054,36165
9/20/2013 5:04,8,100000000,17475,17763,35238
9/20/2013 5:05,8,100000000,18399,18326,36725
9/20/2013 5:05,8,100000000,18609,17945,36554
9/20/2013 5:06,8,100000000,17634,17859,35493
9/20/2013 5:07,8,100000000,18015,18237,36252
9/20/2013 5:08,8,100000000,17652,17836,35488
9/20/2013 5:08,8,100000000,18536,17675,36211
9/20/2013 5:09,8,100000000,17815,17797,35612
9/20/2013 5:10,8,100000000,18752,17827,36579
9/20/2013 5:11,8,100000000,17630,18503,36133
9/20/2013 5:11,8,100000000,17418,17718,35136
9/20/2013 5:12,8,100000000,18420,17862,36282
9/20/2013 5:13,8,100000000,17427,17846,35273
9/20/2013 5:14,8,100000000,19397,17888,37285
9/20/2013 5:14,8,100000000,18453,19046,37499
9/20/2013 5:15,8,100000000,18559,17806,36365
9/20/2013 5:16,8,100000000,17089,18325,35414
9/20/2013 5:17,8,100000000,17792,18325,36117
9/20/2013 5:17,8,100000000,18266,17810,36076
9/20/2013 5:18,8,100000000,18635,17936,36571
9/20/2013 5:19,8,100000000,17192,18335,35527
9/20/2013 5:19,8,100000000,17443,18407,35850
9/20/2013 5:20,8,100000000,18153,19053,37206
9/20/2013 5:21,8,100000000,18348,17839,36187
9/20/2013 5:22,8,100000000,17993,18281,36274
9/20/2013 5:22,8,100000000,17901,18256,36157
9/20/2013 5:23,8,100000000,18393,17866,36259
9/20/2013 5:24,8,100000000,17703,17848,35551
9/20/2013 5:25,8,100000000,18863,17744,36607
9/20/2013 5:25,8,100000000,18188,17857,36045
9/20/2013 5:26,8,100000000,17368,17758,35126
9/20/2013 5:27,8,100000000,17387,17935,35322
9/20/2013 5:28,8,100000000,18203,18086,36289
9/20/2013 5:28,8,100000000,17626,17961,35587
9/20/2013 5:29,8,100000000,17780,17831,35611
9/20/2013 5:30,8,100000000,18914,17986,36900
9/20/2013 5:31,8,100000000,16932,18512,35444
9/20/2013 5:31,8,100000000,17462,18296,35758
9/20/2013 5:32,8,100000000,17257,18468,35725
9/20/2013 5:33,8,100000000,17502,17839,35341
9/20/2013 5:34,8,100000000,17522,17720,35242
9/20/2013 5:34,8,100000000,18148,17134,35282
9/20/2013 5:35,8,100000000,17451,17846,35297
9/20/2013 5:36,8,100000000,16754,18331,35085
9/20/2013 5:37,8,100000000,19371,17941,37312
9/20/2013 5:37,8,100000000,17884,18254,36138
9/20/2013 5:38,8,100000000,17957,17798,35755
9/20/2013 5:39,8,100000000,19175,17948,37123
9/20/2013 5:39,8,100000000,17371,18362,35733
9/20/2013 5:40,8,100000000,18424,18004,36428
9/20/2013 5:41,8,100000000,17120,18293,35413
9/20/2013 5:42,8,100000000,17487,17912,35399
9/20/2013 5:42,8,100000000,17591,17969,35560
9/20/2013 5:43,8,100000000,17974,17809,35783
9/20/2013 5:44,8,100000000,18134,17808,35942
9/20/2013 5:45,8,100000000,18276,17933,36209
9/20/2013 5:45,8,100000000,17693,18224,35917
9/20/2013 5:46,8,100000000,17115,17985,35100
9/20/2013 5:47,8,100000000,17875,18405,36280
9/20/2013 5:48,8,100000000,18966,17860,36826
9/20/2013 5:48,8,100000000,17654,17977,35631
9/20/2013 5:49,8,100000000,17167,18282,35449
9/20/2013 5:50,8,100000000,19074,18356,37430
9/20/2013 5:51,8,100000000,17466,18602,36068
9/20/2013 5:51,8,100000000,18544,17656,36200
9/20/2013 5:52,8,100000000,17526,18834,36360
9/20/2013 5:53,8,100000000,18015,18063,36078
9/20/2013 5:54,8,100000000,19015,18182,37197
9/20/2013 5:54,8,100000000,20024,18262,38286
9/20/2013 5:55,8,100000000,18815,18189,37004
9/20/2013 5:56,8,100000000,18323,17823,36146
9/20/2013 5:57,8,100000000,19129,17710,36839
9/20/2013 5:57,8,100000000,17794,17914,35708
9/20/2013 5:58,8,100000000,17117,18133,35250
9/20/2013 5:59,8,100000000,18056,17829,35885
9/20/2013 6:00,8,100000000,17423,18219,35642
9/20/2013 6:00,8,100000000,18156,19324,37480
9/20/2013 6:01,8,100000000,17551,18355,35906
9/20/2013 6:02,8,100000000,17016,18267,35283
9/20/2013 6:03,8,100000000,17634,19929,37563
9/20/2013 6:03,8,100000000,18637,17869,36506
9/20/2013 6:04,8,100000000,18267,18248,36515
9/20/2013 6:05,8,100000000,18602,18230,36832
9/20/2013 6:06,8,100000000,18143,17945,36088
9/20/2013 6:06,8,100000000,17441,17916,35357
9/20/2013 6:07,8,100000000,19053,17816,36869
9/20/2013 6:07,10,1000,26,25,51
9/20/2013 6:07,10,1000,31,27,58
9/20/2013 6:07,10,1000,23,26,49
9/20/2013 6:07,10,1000,28,25,53
9/20/2013 6:07,10,1000,26,26,52
9/20/2013 6:07,10,1000,25,25,50
9/20/2013 6:07,10,1000,30,26,56
9/20/2013 6:07,10,1000,1026,25,1051
9/20/2013 6:07,10,1000,42,29,71
9/20/2013 6:07,10,1000,27,27,54
9/20/2013 6:07,10,1000,28,26,54
9/20/2013 6:08,10,1000,29,28,57
9/20/2013 6:08,10,1000,24,27,51
9/20/2013 6:08,10,1000,1017,30,1047
9/20/2013 6:08,10,1000,23,25,48
9/20/2013 6:08,10,1000,28,26,54
9/20/2013 6:08,10,1000,31,26,57
9/20/2013 6:08,10,1000,29,27,56
9/20/2013 6:08,10,1000,27,26,53
9/20/2013 6:08,10,1000,30,27,57
9/20/2013 6:08,10,1000,28,25,53
9/20/2013 6:08,10,1000,26,26,52
9/20/2013 6:08,10,1000,27,29,56
9/20/2013 6:08,10,1000,24,25,49
9/20/2013 6:08,10,1000,25,26,51
9/20/2013 6:08,10,1000,32,31,63
9/20/2013 6:08,10,1000,28,28,56
9/20/2013 6:08,10,1000,31,26,57
9/20/2013 6:08,10,1000,26,25,51
9/20/2013 6:08,10,1000,28,27,55
9/20/2013 6:08,10,1000,27,26,53
9/20/2013 6:08,10,1000,32,26,58
9/20/2013 6:08,10,1000,29,28,57
9/20/2013 6:08,10,1000,26,28,54
9/20/2013 6:08,10,1000,27,26,53
9/20/2013 6:08,10,1000,27,26,53
9/20/2013 6:08,10,1000,27,25,52
9/20/2013 6:08,10,1000,30,27,57
9/20/2013 6:08,10,1000,30,26,56
9/20/2013 6:08,10,1000,27,25,52
9/20/2013 6:09,10,1000,28,26,54
9/20/2013 6:09,10,1000,34,26,60
9/20/2013 6:09,10,1000,29,29,58
9/20/2013 6:09,10,1000,28,25,53
9/20/2013 6:09,10,1000,30,26,56
9/20/2013 6:09,10,1000,26,26,52
9/20/2013 6:09,10,1000,27,25,52
9/20/2013 6:09,10,1000,26,25,51
9/20/2013 6:09,10,1000,25,26,51
9/20/2013 6:09,10,1000,26,25,51
9/20/2013 6:09,10,1000,27,25,52
9/20/2013 6:09,10,1000,28,27,55
9/20/2013 6:09,10,1000,24,26,50
9/20/2013 6:09,10,1000,34,28,62
9/20/2013 6:09,10,1000,31,26,57
9/20/2013 6:09,10,1000,27,25,52
9/20/2013 6:09,10,1000,26,25,51
9/20/2013 6:09,10,1000,26,25,51
9/20/2013 6:09,10,1000,27,26,53
9/20/2013 6:09,10,1000,27,26,53
9/20/2013 6:09,10,1000,35,29,64
9/20/2013 6:09,10,1000,27,25,52
9/20/2013 6:09,10,1000,25,26,51
9/20/2013 6:09,10,1000,26,25,51
9/20/2013 6:09,10,1000,25,25,50
9/20/2013 6:09,10,1000,31,26,57
9/20/2013 6:09,10,1000,30,28,58
9/20/2013 6:09,10,1000,26,29,55
9/20/2013 6:09,10,1000,22,26,48
9/20/2013 6:09,10,1000,27,26,53
9/20/2013 6:09,10,1000,27,25,52
9/20/2013 6:10,10,1000,28,26,54
9/20/2013 6:10,10,1000,28,25,53
9/20/2013 6:10,10,1000,27,26,53
9/20/2013 6:10,10,1000,27,25,52
9/20/2013 6:10,10,1000,26,25,51
9/20/2013 6:10,10,1000,33,27,60
9/20/2013 6:10,10,1000,31,25,56
9/20/2013 6:10,10,1000,23,25,48
9/20/2013 6:10,10,1000,29,25,54
9/20/2013 6:10,10,1000,25,29,54
9/20/2013 6:10,10,1000,26,25,51
9/20/2013 6:10,10,1000,26,25,51
9/20/2013 6:10,10,1000,25,28,53
9/20/2013 6:10,10,1000,28,30,58
9/20/2013 6:10,10,1000,30,25,55
9/20/2013 6:10,10,1000,29,27,56
9/20/2013 6:10,10,1000,27,25,52
9/20/2013 6:10,10,1000,25,26,51
9/20/2013 6:10,10,1000,26,28,54
9/20/2013 6:10,10,1000,30,26,56
9/20/2013 6:10,10,1000,34,28,62
9/20/2013 6:10,10,1000,26,28,54
9/20/2013 6:10,10,1000,26,25,51
9/20/2013 6:10,10,1000,1021,27,1048
9/20/2013 6:10,10,1000,25,25,50
9/20/2013 6:10,10,1000,24,25,49
9/20/2013 6:10,10,1000,27,25,52
9/20/2013 6:10,10,1000,31,25,56
9/20/2013 6:10,10,1000,25,26,51
9/20/2013 6:11,10,1000,25,26,51
9/20/2013 6:11,10,1000,26,26,52
9/20/2013 6:11,10,1000,31,30,61
9/20/2013 6:11,10,1000,29,26,55
9/20/2013 6:11,10,1000,28,27,55
9/20/2013 6:11,10,1000,27,27,54
9/20/2013 6:11,10,1000,30,27,57
9/20/2013 6:11,10,1000,28,25,53
9/20/2013 6:11,10,1000,29,27,56
9/20/2013 6:11,10,1000,28,26,54
9/20/2013 6:11,10,1000,26,26,52
9/20/2013 6:11,10,1000,26,25,51
9/20/2013 6:11,10,1000,26,26,52
9/20/2013 6:11,10,1000,25,25,50
9/20/2013 6:11,10,1000,25,25,50
9/20/2013 6:11,10,2000,27,36,63
9/20/2013 6:11,10,2000,25,37,62
9/20/2013 6:11,10,2000,27,37,64
9/20/2013 6:11,10,2000,26,37,63
9/20/2013 6:11,10,2000,25,36,61
9/20/2013 6:11,10,2000,30,37,67
9/20/2013 6:11,10,2000,25,36,61
9/20/2013 6:11,10,2000,27,36,63
9/20/2013 6:11,10,2000,26,37,63
9/20/2013 6:11,10,2000,33,39,72
9/20/2013 6:11,10,2000,29,37,66
9/20/2013 6:11,10,2000,26,37,63
9/20/2013 6:11,10,2000,1015,38,1053
9/20/2013 6:11,10,2000,36,39,75
9/20/2013 6:12,10,2000,26,36,62
9/20/2013 6:12,10,2000,1017,39,1056
9/20/2013 6:12,10,2000,28,37,65
9/20/2013 6:12,10,2000,26,36,62
9/20/2013 6:12,10,2000,32,39,71
9/20/2013 6:12,10,2000,30,39,69
9/20/2013 6:12,10,2000,26,36,62
9/20/2013 6:12,10,2000,28,36,64
9/20/2013 6:12,10,2000,30,38,68
9/20/2013 6:12,10,2000,26,36,62
9/20/2013 6:12,10,2000,30,38,68
9/20/2013 6:12,10,2000,27,38,65
9/20/2013 6:12,10,2000,26,36,62
9/20/2013 6:12,10,2000,28,36,64
9/20/2013 6:12,10,2000,25,35,60
9/20/2013 6:12,10,2000,40,38,78
9/20/2013 6:12,10,2000,27,35,62
9/20/2013 6:12,10,2000,25,36,61
9/20/2013 6:12,10,2000,54,37,91
9/20/2013 6:12,10,2000,26,36,62
9/20/2013 6:12,10,2000,30,36,66
9/20/2013 6:12,10,2000,31,40,71
9/20/2013 6:12,10,2000,28,35,63
9/20/2013 6:12,10,2000,25,37,62
9/20/2013 6:12,10,2000,30,36,66
9/20/2013 6:12,10,2000,25,36,61
9/20/2013 6:12,10,2000,27,36,63
9/20/2013 6:12,10,2000,32,35,67
9/20/2013 6:12,10,2000,25,37,62
9/20/2013 6:12,10,2000,26,36,62
9/20/2013 6:13,10,2000,28,36,64
9/20/2013 6:13,10,2000,25,36,61
9/20/2013 6:13,10,2000,29,37,66
9/20/2013 6:13,10,2000,26,36,62
9/20/2013 6:13,10,2000,1014,38,1052
9/20/2013 6:13,10,2000,26,35,61
9/20/2013 6:13,10,2000,32,36,68
9/20/2013 6:13,10,2000,28,36,64
9/20/2013 6:13,10,2000,29,38,67
9/20/2013 6:13,10,2000,29,35,64
9/20/2013 6:13,10,2000,1014,38,1052
9/20/2013 6:13,10,2000,1016,37,1053
9/20/2013 6:13,10,2000,28,39,67
9/20/2013 6:13,10,2000,53,37,90
9/20/2013 6:13,10,2000,26,36,62
9/20/2013 6:13,10,2000,1013,40,1053
9/20/2013 6:13,10,2000,31,40,71
9/20/2013 6:13,10,2000,25,35,60
9/20/2013 6:13,10,2000,26,35,61
9/20/2013 6:13,10,2000,24,36,60
9/20/2013 6:13,10,2000,33,38,71
9/20/2013 6:13,10,2000,66,41,107
9/20/2013 6:13,10,2000,26,35,61
9/20/2013 6:13,10,2000,26,36,62
9/20/2013 6:13,10,2000,1028,37,1065
9/20/2013 6:13,10,2000,1016,39,1055
9/20/2013 6:13,10,2000,32,36,68
9/20/2013 6:14,10,2000,29,37,66
9/20/2013 6:14,10,2000,25,36,61
9/20/2013 6:14,10,2000,29,36,65
9/20/2013 6:14,10,2000,27,35,62
9/20/2013 6:14,10,2000,26,35,61
9/20/2013 6:14,10,2000,29,35,64
9/20/2013 6:14,10,2000,34,40,74
9/20/2013 6:14,10,2000,31,38,69
9/20/2013 6:14,10,2000,26,36,62
9/20/2013 6:14,10,2000,28,35,63
9/20/2013 6:14,10,2000,30,40,70
9/20/2013 6:14,10,2000,26,36,62
9/20/2013 6:14,10,2000,26,35,61
9/20/2013 6:14,10,2000,27,36,63
9/20/2013 6:14,10,2000,26,35,61
9/20/2013 6:14,10,2000,25,36,61
9/20/2013 6:14,10,2000,27,38,65
9/20/2013 6:14,10,2000,32,36,68
9/20/2013 6:14,10,2000,52,35,87
9/20/2013 6:14,10,2000,31,36,67
9/20/2013 6:14,10,2000,26,37,63
9/20/2013 6:14,10,2000,26,35,61
9/20/2013 6:14,10,2000,32,38,70
9/20/2013 6:14,10,2000,30,36,66
9/20/2013 6:14,10,2000,33,38,71
9/20/2013 6:14,10,2000,34,38,72
9/20/2013 6:14,10,2000,24,36,60
9/20/2013 6:14,10,2000,27,36,63
9/20/2013 6:14,10,2000,29,38,67
9/20/2013 6:14,10,2000,29,38,67
9/20/2013 6:15,10,2000,26,36,62
9/20/2013 6:15,10,2000,63,37,100
9/20/2013 6:15,10,2000,30,36,66
9/20/2013 6:15,10,2000,42,35,77
9/20/2013 6:15,10,2000,38,39,77
9/20/2013 6:15,10,2000,31,39,70
9/20/2013 6:15,10,2000,1013,36,1049
9/20/2013 6:15,10,2000,27,36,63
9/20/2013 6:15,10,2000,32,37,69
9/20/2013 6:15,10,2000,25,36,61
9/20/2013 6:15,10,2000,31,37,68
9/20/2013 6:15,10,2000,29,37,66
9/20/2013 6:15,10,2000,35,36,71
9/20/2013 6:15,10,2000,30,40,70
9/20/2013 6:15,10,3000,33,49,82
9/20/2013 6:15,10,3000,29,44,73
9/20/2013 6:15,10,3000,28,44,72
9/20/2013 6:15,10,3000,29,43,72
9/20/2013 6:15,10,3000,29,47,76
9/20/2013 6:15,10,3000,29,43,72
9/20/2013 6:15,10,3000,29,46,75
9/20/2013 6:15,10,3000,31,45,76
9/20/2013 6:15,10,3000,26,44,70
9/20/2013 6:15,10,3000,33,47,80
9/20/2013 6:15,10,3000,29,45,74
9/20/2013 6:15,10,3000,26,44,70
9/20/2013 6:15,10,3000,31,45,76
9/20/2013 6:15,10,3000,32,44,76
9/20/2013 6:15,10,3000,29,45,74
9/20/2013 6:16,10,3000,31,45,76
9/20/2013 6:16,10,3000,27,46,73
9/20/2013 6:16,10,3000,29,44,73
9/20/2013 6:16,10,3000,29,44,73
9/20/2013 6:16,10,3000,34,45,79
9/20/2013 6:16,10,3000,29,45,74
9/20/2013 6:16,10,3000,27,44,71
9/20/2013 6:16,10,3000,32,45,77
9/20/2013 6:16,10,3000,27,45,72
9/20/2013 6:16,10,3000,28,44,72
9/20/2013 6:16,10,3000,26,45,71
9/20/2013 6:16,10,3000,30,46,76
9/20/2013 6:16,10,3000,27,44,71
9/20/2013 6:16,10,3000,28,44,72
9/20/2013 6:16,10,3000,33,44,77
9/20/2013 6:16,10,3000,32,45,77
9/20/2013 6:16,10,3000,28,49,77
9/20/2013 6:16,10,3000,28,45,73
9/20/2013 6:16,10,3000,27,45,72
9/20/2013 6:16,10,3000,27,43,70
9/20/2013 6:16,10,3000,29,45,74
9/20/2013 6:16,10,3000,31,43,74
9/20/2013 6:16,10,3000,1021,46,1067
9/20/2013 6:16,10,3000,28,47,75
9/20/2013 6:16,10,3000,31,47,78
9/20/2013 6:16,10,3000,26,44,70
9/20/2013 6:16,10,3000,32,45,77
9/20/2013 6:16,10,3000,1015,47,1062
9/20/2013 6:16,10,3000,27,44,71
9/20/2013 6:16,10,3000,27,45,72
9/20/2013 6:17,10,3000,27,45,72
9/20/2013 6:17,10,3000,27,44,71
9/20/2013 6:17,10,3000,28,43,71
9/20/2013 6:17,10,3000,27,44,71
9/20/2013 6:17,10,3000,24,45,69
9/20/2013 6:17,10,3000,28,44,72
9/20/2013 6:17,10,3000,28,44,72
9/20/2013 6:17,10,3000,33,45,78
9/20/2013 6:17,10,3000,28,45,73
9/20/2013 6:17,10,3000,1017,47,1064
9/20/2013 6:17,10,3000,31,46,77
9/20/2013 6:17,10,3000,26,44,70
9/20/2013 6:17,10,3000,31,47,78
9/20/2013 6:17,10,3000,31,45,76
9/20/2013 6:17,10,3000,30,45,75
9/20/2013 6:17,10,3000,27,46,73
9/20/2013 6:17,10,3000,30,45,75
9/20/2013 6:17,10,3000,33,45,78
9/20/2013 6:17,10,3000,28,44,72
9/20/2013 6:17,10,3000,28,43,71
9/20/2013 6:17,10,3000,29,45,74
9/20/2013 6:17,10,3000,32,45,77
9/20/2013 6:17,10,3000,27,45,72
9/20/2013 6:17,10,3000,25,45,70
9/20/2013 6:17,10,3000,35,45,80
9/20/2013 6:17,10,3000,28,44,72
9/20/2013 6:17,10,3000,31,46,77
9/20/2013 6:17,10,3000,27,43,70
9/20/2013 6:17,10,3000,27,44,71
9/20/2013 6:17,10,3000,26,44,70
9/20/2013 6:18,10,3000,28,45,73
9/20/2013 6:18,10,3000,28,44,72
9/20/2013 6:18,10,3000,27,45,72
9/20/2013 6:18,10,3000,29,45,74
9/20/2013 6:18,10,3000,27,44,71
9/20/2013 6:18,10,3000,28,43,71
9/20/2013 6:18,10,3000,27,44,71
9/20/2013 6:18,10,3000,1020,47,1067
9/20/2013 6:18,10,3000,30,45,75
9/20/2013 6:18,10,3000,30,47,77
9/20/2013 6:18,10,3000,28,44,72
9/20/2013 6:18,10,3000,31,45,76
9/20/2013 6:18,10,3000,30,47,77
9/20/2013 6:18,10,3000,29,48,77
9/20/2013 6:18,10,3000,32,44,76
9/20/2013 6:18,10,3000,32,47,79
9/20/2013 6:18,10,3000,28,44,72
9/20/2013 6:18,10,3000,31,45,76
9/20/2013 6:18,10,3000,1024,47,1071
9/20/2013 6:18,10,3000,27,47,74
9/20/2013 6:18,10,3000,27,45,72
9/20/2013 6:18,10,3000,28,45,73
9/20/2013 6:18,10,3000,30,44,74
9/20/2013 6:18,10,3000,25,45,70
9/20/2013 6:18,10,3000,26,44,70
9/20/2013 6:18,10,3000,28,43,71
9/20/2013 6:18,10,3000,28,44,72
9/20/2013 6:19,10,3000,25,44,69
9/20/2013 6:19,10,3000,27,45,72
9/20/2013 6:19,10,3000,29,45,74
9/20/2013 6:19,10,3000,29,45,74
9/20/2013 6:19,10,3000,29,45,74
9/20/2013 6:19,10,3000,25,44,69
9/20/2013 6:19,10,3000,27,44,71
9/20/2013 6:19,10,3000,27,44,71
9/20/2013 6:19,10,3000,27,44,71
9/20/2013 6:19,10,3000,29,45,74
9/20/2013 6:19,10,3000,25,44,69
9/20/2013 6:19,10,3000,24,45,69
9/20/2013 6:19,10,3000,29,44,73
9/20/2013 6:19,10,4000,31,52,83
9/20/2013 6:19,10,4000,30,49,79
9/20/2013 6:19,10,4000,30,52,82
9/20/2013 6:19,10,4000,29,50,79
9/20/2013 6:19,10,4000,28,50,78
9/20/2013 6:19,10,4000,28,50,78
9/20/2013 6:19,10,4000,25,51,76
9/20/2013 6:19,10,4000,31,50,81
9/20/2013 6:19,10,4000,25,53,78
9/20/2013 6:19,10,4000,30,51,81
9/20/2013 6:19,10,4000,30,52,82
9/20/2013 6:19,10,4000,27,49,76
9/20/2013 6:19,10,4000,33,50,83
9/20/2013 6:19,10,4000,37,52,89
9/20/2013 6:19,10,4000,29,50,79
9/20/2013 6:19,10,4000,28,49,77
9/20/2013 6:19,10,4000,27,51,78
9/20/2013 6:19,10,4000,31,53,84
9/20/2013 6:20,10,4000,29,49,78
9/20/2013 6:20,10,4000,29,51,80
9/20/2013 6:20,10,4000,30,50,80
9/20/2013 6:20,10,4000,28,49,77
9/20/2013 6:20,10,4000,26,50,76
9/20/2013 6:20,10,4000,29,54,83
9/20/2013 6:20,10,4000,29,51,80
9/20/2013 6:20,10,4000,31,50,81
9/20/2013 6:20,10,4000,27,49,76
9/20/2013 6:20,10,4000,30,49,79
9/20/2013 6:20,10,4000,28,50,78
9/20/2013 6:20,10,4000,29,49,78
9/20/2013 6:20,10,4000,29,50,79
9/20/2013 6:20,10,4000,30,49,79
9/20/2013 6:20,10,4000,33,50,83
9/20/2013 6:20,10,4000,31,50,81
9/20/2013 6:20,10,4000,31,50,81
9/20/2013 6:20,10,4000,36,53,89
9/20/2013 6:20,10,4000,28,49,77
9/20/2013 6:20,10,4000,1024,53,1077
9/20/2013 6:20,10,4000,29,50,79
9/20/2013 6:20,10,4000,28,51,79
9/20/2013 6:20,10,4000,26,49,75
9/20/2013 6:20,10,4000,56,49,105
9/20/2013 6:20,10,4000,25,50,75
9/20/2013 6:20,10,4000,26,50,76
9/20/2013 6:20,10,4000,28,51,79
9/20/2013 6:20,10,4000,29,51,80
9/20/2013 6:20,10,4000,30,51,81
9/20/2013 6:20,10,4000,28,49,77
9/20/2013 6:21,10,4000,29,50,79
9/20/2013 6:21,10,4000,29,49,78
9/20/2013 6:21,10,4000,27,50,77
9/20/2013 6:21,10,4000,33,53,86
9/20/2013 6:21,10,4000,36,50,86
9/20/2013 6:21,10,4000,1015,66,1081
9/20/2013 6:21,10,4000,1016,53,1069
9/20/2013 6:21,10,4000,33,50,83
9/20/2013 6:21,10,4000,28,48,76
9/20/2013 6:21,10,4000,31,52,83
9/20/2013 6:21,10,4000,28,49,77
9/20/2013 6:21,10,4000,29,49,78
9/20/2013 6:21,10,4000,28,51,79
9/20/2013 6:21,10,4000,29,48,77
9/20/2013 6:21,10,4000,25,50,75
9/20/2013 6:21,10,4000,31,50,81
9/20/2013 6:21,10,4000,31,53,84
9/20/2013 6:21,10,4000,29,50,79
9/20/2013 6:21,10,4000,1015,52,1067
9/20/2013 6:21,10,4000,30,50,80
9/20/2013 6:21,10,4000,30,50,80
9/20/2013 6:21,10,4000,29,51,80
9/20/2013 6:21,10,4000,28,49,77
9/20/2013 6:21,10,4000,30,51,81
9/20/2013 6:21,10,4000,34,50,84
9/20/2013 6:21,10,4000,35,50,85
9/20/2013 6:21,10,4000,28,51,79
9/20/2013 6:21,10,4000,29,50,79
9/20/2013 6:22,10,4000,27,51,78
9/20/2013 6:22,10,4000,1017,53,1070
9/20/2013 6:22,10,4000,1014,55,1069
9/20/2013 6:22,10,4000,29,48,77
9/20/2013 6:22,10,4000,28,50,78
9/20/2013 6:22,10,4000,29,48,77
9/20/2013 6:22,10,4000,34,52,86
9/20/2013 6:22,10,4000,28,50,78
9/20/2013 6:22,10,4000,32,51,83
9/20/2013 6:22,10,4000,31,50,81
9/20/2013 6:22,10,4000,1020,52,1072
9/20/2013 6:22,10,4000,30,51,81
9/20/2013 6:22,10,4000,30,50,80
9/20/2013 6:22,10,4000,30,51,81
9/20/2013 6:22,10,4000,31,49,80
9/20/2013 6:22,10,4000,28,49,77
9/20/2013 6:22,10,4000,28,50,78
9/20/2013 6:22,10,4000,28,50,78
9/20/2013 6:22,10,4000,1015,55,1070
9/20/2013 6:22,10,4000,27,53,80
9/20/2013 6:22,10,4000,25,51,76
9/20/2013 6:22,10,4000,30,50,80
9/20/2013 6:22,10,4000,28,50,78
9/20/2013 6:22,10,4000,31,51,82
9/20/2013 6:22,10,4000,29,49,78
9/20/2013 6:22,10,4000,1013,53,1066
9/20/2013 6:22,10,4000,30,49,79
9/20/2013 6:22,10,4000,29,50,79
9/20/2013 6:23,10,4000,27,50,77
9/20/2013 6:23,10,4000,28,50,78
9/20/2013 6:23,10,4000,30,50,80
9/20/2013 6:23,10,4000,27,50,77
9/20/2013 6:23,10,4000,28,52,80
9/20/2013 6:23,10,4000,30,52,82
9/20/2013 6:23,10,4000,32,62,94
9/20/2013 6:23,10,4000,30,51,81
9/20/2013 6:23,10,4000,27,51,78
9/20/2013 6:23,10,4000,29,50,79
9/20/2013 6:23,10,4000,29,49,78
9/20/2013 6:23,10,5000,35,54,89
9/20/2013 6:23,10,5000,29,55,84
9/20/2013 6:23,10,5000,30,53,83
9/20/2013 6:23,10,5000,32,55,87
9/20/2013 6:23,10,5000,30,56,86
9/20/2013 6:23,10,5000,28,56,84
9/20/2013 6:23,10,5000,1016,57,1073
9/20/2013 6:23,10,5000,31,54,85
9/20/2013 6:23,10,5000,35,54,89
9/20/2013 6:23,10,5000,30,55,85
9/20/2013 6:23,10,5000,36,54,90
9/20/2013 6:23,10,5000,29,57,86
9/20/2013 6:23,10,5000,30,53,83
9/20/2013 6:23,10,5000,29,53,82
9/20/2013 6:23,10,5000,35,56,91
9/20/2013 6:23,10,5000,31,56,87
9/20/2013 6:23,10,5000,33,56,89
9/20/2013 6:23,10,5000,28,53,81
9/20/2013 6:24,10,5000,29,53,82
9/20/2013 6:24,10,5000,30,54,84
9/20/2013 6:24,10,5000,31,53,84
9/20/2013 6:24,10,5000,37,55,92
9/20/2013 6:24,10,5000,33,53,86
9/20/2013 6:24,10,5000,31,53,84
9/20/2013 6:24,10,5000,31,54,85
9/20/2013 6:24,10,5000,29,54,83
9/20/2013 6:24,10,5000,33,56,89
9/20/2013 6:24,10,5000,37,53,90
9/20/2013 6:24,10,5000,28,55,83
9/20/2013 6:24,10,5000,30,54,84
9/20/2013 6:24,10,5000,37,54,91
9/20/2013 6:24,10,5000,32,62,94
9/20/2013 6:24,10,5000,30,55,85
9/20/2013 6:24,10,5000,31,55,86
9/20/2013 6:24,10,5000,29,54,83
9/20/2013 6:24,10,5000,30,53,83
9/20/2013 6:24,10,5000,30,54,84
9/20/2013 6:24,10,5000,31,55,86
9/20/2013 6:24,10,5000,30,54,84
9/20/2013 6:24,10,5000,30,55,85
9/20/2013 6:24,10,5000,29,54,83
9/20/2013 6:24,10,5000,60,57,117
9/20/2013 6:24,10,5000,28,55,83
9/20/2013 6:24,10,5000,29,53,82
9/20/2013 6:24,10,5000,36,56,92
9/20/2013 6:24,10,5000,32,55,87
9/20/2013 6:24,10,5000,29,56,85
9/20/2013 6:24,10,5000,27,56,83
9/20/2013 6:25,10,5000,31,55,86
9/20/2013 6:25,10,5000,29,54,83
9/20/2013 6:25,10,5000,37,56,93
9/20/2013 6:25,10,5000,32,54,86
9/20/2013 6:25,10,5000,28,56,84
9/20/2013 6:25,10,5000,1020,58,1078
9/20/2013 6:25,10,5000,29,55,84
9/20/2013 6:25,10,5000,29,56,85
9/20/2013 6:25,10,5000,31,53,84
9/20/2013 6:25,10,5000,32,54,86
9/20/2013 6:25,10,5000,30,55,85
9/20/2013 6:25,10,5000,28,54,82
9/20/2013 6:25,10,5000,30,54,84
9/20/2013 6:25,10,5000,30,53,83
9/20/2013 6:25,10,5000,30,53,83
9/20/2013 6:25,10,5000,28,54,82
9/20/2013 6:25,10,5000,29,54,83
9/20/2013 6:25,10,5000,34,55,89
9/20/2013 6:25,10,5000,31,53,84
9/20/2013 6:25,10,5000,31,58,89
9/20/2013 6:25,10,5000,33,54,87
9/20/2013 6:25,10,5000,1017,55,1072
9/20/2013 6:25,10,5000,31,53,84
9/20/2013 6:25,10,5000,33,57,90
9/20/2013 6:25,10,5000,29,54,83
9/20/2013 6:25,10,5000,42,57,99
9/20/2013 6:25,10,5000,30,58,88
9/20/2013 6:25,10,5000,28,55,83
9/20/2013 6:25,10,5000,31,56,87
9/20/2013 6:26,10,5000,34,54,88
9/20/2013 6:26,10,5000,30,53,83
9/20/2013 6:26,10,5000,34,54,88
9/20/2013 6:26,10,5000,32,53,85
9/20/2013 6:26,10,5000,28,54,82
9/20/2013 6:26,10,5000,32,55,87
9/20/2013 6:26,10,5000,29,53,82
9/20/2013 6:26,10,5000,34,53,87
9/20/2013 6:26,10,5000,28,54,82
9/20/2013 6:26,10,5000,31,55,86
9/20/2013 6:26,10,5000,30,55,85
9/20/2013 6:26,10,5000,34,54,88
9/20/2013 6:26,10,5000,30,54,84
9/20/2013 6:26,10,5000,30,53,83
9/20/2013 6:26,10,5000,32,56,88
9/20/2013 6:26,10,5000,32,54,86
9/20/2013 6:26,10,5000,29,55,84
9/20/2013 6:26,10,5000,30,55,85
9/20/2013 6:26,10,5000,29,55,84
9/20/2013 6:26,10,5000,1024,54,1078
9/20/2013 6:26,10,5000,33,58,91
9/20/2013 6:26,10,5000,33,55,88
9/20/2013 6:26,10,5000,32,57,89
9/20/2013 6:26,10,5000,33,58,91
9/20/2013 6:26,10,5000,29,54,83
9/20/2013 6:26,10,5000,31,53,84
9/20/2013 6:26,10,5000,30,58,88
9/20/2013 6:26,10,5000,31,55,86
9/20/2013 6:26,10,5000,28,55,83
9/20/2013 6:26,10,5000,30,53,83
9/20/2013 6:27,10,5000,32,54,86
9/20/2013 6:27,10,5000,29,58,87
9/20/2013 6:27,10,5000,30,53,83
9/20/2013 6:27,10,5000,30,53,83
9/20/2013 6:27,10,5000,29,55,84
9/20/2013 6:27,10,5000,29,53,82
9/20/2013 6:27,10,5000,28,54,82
9/20/2013 6:27,10,5000,31,54,85
9/20/2013 6:27,10,6000,31,58,89
9/20/2013 6:27,10,6000,31,60,91
9/20/2013 6:27,10,6000,29,58,87
9/20/2013 6:27,10,6000,27,59,86
9/20/2013 6:27,10,6000,30,58,88
9/20/2013 6:27,10,6000,31,57,88
9/20/2013 6:27,10,6000,29,60,89
9/20/2013 6:27,10,6000,1015,61,1076
9/20/2013 6:27,10,6000,30,58,88
9/20/2013 6:27,10,6000,30,58,88
9/20/2013 6:27,10,6000,1022,62,1084
9/20/2013 6:27,10,6000,32,61,93
9/20/2013 6:27,10,6000,33,59,92
9/20/2013 6:27,10,6000,30,58,88
9/20/2013 6:27,10,6000,32,57,89
9/20/2013 6:27,10,6000,27,59,86
9/20/2013 6:27,10,6000,32,58,90
9/20/2013 6:27,10,6000,34,63,97
9/20/2013 6:27,10,6000,31,59,90
9/20/2013 6:27,10,6000,29,58,87
9/20/2013 6:27,10,6000,30,57,87
9/20/2013 6:28,10,6000,29,59,88
9/20/2013 6:28,10,6000,29,59,88
9/20/2013 6:28,10,6000,31,59,90
9/20/2013 6:28,10,6000,35,59,94
9/20/2013 6:28,10,6000,35,60,95
9/20/2013 6:28,10,6000,30,58,88
9/20/2013 6:28,10,6000,1016,60,1076
9/20/2013 6:28,10,6000,31,58,89
9/20/2013 6:28,10,6000,37,64,101
9/20/2013 6:28,10,6000,32,58,90
9/20/2013 6:28,10,6000,31,59,90
9/20/2013 6:28,10,6000,39,59,98
9/20/2013 6:28,10,6000,33,59,92
9/20/2013 6:28,10,6000,34,59,93
9/20/2013 6:28,10,6000,29,58,87
9/20/2013 6:28,10,6000,29,63,92
9/20/2013 6:28,10,6000,33,60,93
9/20/2013 6:28,10,6000,28,62,90
9/20/2013 6:28,10,6000,32,59,91
9/20/2013 6:28,10,6000,27,60,87
9/20/2013 6:28,10,6000,39,58,97
9/20/2013 6:28,10,6000,31,59,90
9/20/2013 6:28,10,6000,34,58,92
9/20/2013 6:28,10,6000,29,58,87
9/20/2013 6:28,10,6000,37,60,97
9/20/2013 6:28,10,6000,32,61,93
9/20/2013 6:28,10,6000,36,58,94
9/20/2013 6:28,10,6000,31,59,90
9/20/2013 6:28,10,6000,36,65,101
9/20/2013 6:28,10,6000,33,57,90
9/20/2013 6:29,10,6000,29,59,88
9/20/2013 6:29,10,6000,31,58,89
9/20/2013 6:29,10,6000,29,59,88
9/20/2013 6:29,10,6000,29,59,88
9/20/2013 6:29,10,6000,34,59,93
9/20/2013 6:29,10,6000,30,58,88
9/20/2013 6:29,10,6000,32,60,92
9/20/2013 6:29,10,6000,29,60,89
9/20/2013 6:29,10,6000,30,57,87
9/20/2013 6:29,10,6000,34,60,94
9/20/2013 6:29,10,6000,34,59,93
9/20/2013 6:29,10,6000,31,58,89
9/20/2013 6:29,10,6000,30,60,90
9/20/2013 6:29,10,6000,28,59,87
9/20/2013 6:29,10,6000,31,59,90
9/20/2013 6:29,10,6000,29,62,91
9/20/2013 6:29,10,6000,32,58,90
9/20/2013 6:29,10,6000,29,57,86
9/20/2013 6:29,10,6000,1033,62,1095
9/20/2013 6:29,10,6000,35,60,95
9/20/2013 6:29,10,6000,30,59,89
9/20/2013 6:29,10,6000,29,57,86
9/20/2013 6:29,10,6000,29,57,86
9/20/2013 6:29,10,6000,29,59,88
9/20/2013 6:29,10,6000,33,60,93
9/20/2013 6:29,10,6000,30,58,88
9/20/2013 6:29,10,6000,31,57,88
9/20/2013 6:29,10,6000,33,59,92
9/20/2013 6:29,10,6000,33,62,95
9/20/2013 6:30,10,6000,34,60,94
9/20/2013 6:30,10,6000,31,57,88
9/20/2013 6:30,10,6000,31,61,92
9/20/2013 6:30,10,6000,33,58,91
9/20/2013 6:30,10,6000,39,60,99
9/20/2013 6:30,10,6000,35,60,95
9/20/2013 6:30,10,6000,27,59,86
9/20/2013 6:30,10,6000,30,57,87
9/20/2013 6:30,10,6000,35,58,93
9/20/2013 6:30,10,6000,31,60,91
9/20/2013 6:30,10,6000,34,61,95
9/20/2013 6:30,10,6000,32,58,90
9/20/2013 6:30,10,6000,31,58,89
9/20/2013 6:30,10,6000,28,58,86
9/20/2013 6:30,10,6000,35,59,94
9/20/2013 6:30,10,6000,35,62,97
9/20/2013 6:30,10,6000,33,59,92
9/20/2013 6:30,10,6000,29,59,88
9/20/2013 6:30,10,6000,32,59,91
9/20/2013 6:30,10,6000,1022,59,1081
9/20/2013 6:30,10,6000,30,74,104
9/20/2013 6:30,10,6000,31,58,89
9/20/2013 6:30,10,6000,32,61,93
9/20/2013 6:30,10,6000,30,57,87
9/20/2013 6:30,10,6000,34,59,93
9/20/2013 6:30,10,6000,35,57,92
9/20/2013 6:30,10,6000,33,60,93
9/20/2013 6:30,10,6000,31,58,89
9/20/2013 6:30,10,6000,29,58,87
9/20/2013 6:30,10,6000,34,58,92
9/20/2013 6:31,10,6000,30,58,88
9/20/2013 6:31,10,6000,34,58,92
9/20/2013 6:31,10,6000,41,62,103
9/20/2013 6:31,10,6000,29,62,91
9/20/2013 6:31,10,6000,1016,62,1078
9/20/2013 6:31,10,7000,34,64,98
9/20/2013 6:31,10,7000,32,62,94
9/20/2013 6:31,10,7000,30,62,92
9/20/2013 6:31,10,7000,31,61,92
9/20/2013 6:31,10,7000,31,63,94
9/20/2013 6:31,10,7000,35,61,96
9/20/2013 6:31,10,7000,33,61,94
9/20/2013 6:31,10,7000,41,63,104
9/20/2013 6:31,10,7000,30,61,91
9/20/2013 6:31,10,7000,38,64,102
9/20/2013 6:31,10,7000,34,62,96
9/20/2013 6:31,10,7000,35,61,96
9/20/2013 6:31,10,7000,32,63,95
9/20/2013 6:31,10,7000,32,63,95
9/20/2013 6:31,10,7000,34,63,97
9/20/2013 6:31,10,7000,34,61,95
9/20/2013 6:31,10,7000,33,64,97
9/20/2013 6:31,10,7000,31,62,93
9/20/2013 6:31,10,7000,37,67,104
9/20/2013 6:31,10,7000,34,59,93
9/20/2013 6:31,10,7000,34,61,95
9/20/2013 6:31,10,7000,33,62,95
9/20/2013 6:31,10,7000,31,64,95
9/20/2013 6:31,10,7000,35,64,99
9/20/2013 6:32,10,7000,33,61,94
9/20/2013 6:32,10,7000,36,63,99
9/20/2013 6:32,10,7000,32,65,97
9/20/2013 6:32,10,7000,38,62,100
9/20/2013 6:32,10,7000,33,62,95
9/20/2013 6:32,10,7000,34,60,94
9/20/2013 6:32,10,7000,34,62,96
9/20/2013 6:32,10,7000,37,65,102
9/20/2013 6:32,10,7000,31,62,93
9/20/2013 6:32,10,7000,32,65,97
9/20/2013 6:32,10,7000,31,63,94
9/20/2013 6:32,10,7000,31,62,93
9/20/2013 6:32,10,7000,33,62,95
9/20/2013 6:32,10,7000,31,62,93
9/20/2013 6:32,10,7000,32,61,93
9/20/2013 6:32,10,7000,35,61,96
9/20/2013 6:32,10,7000,33,62,95
9/20/2013 6:32,10,7000,35,67,102
9/20/2013 6:32,10,7000,32,62,94
9/20/2013 6:32,10,7000,30,60,90
9/20/2013 6:32,10,7000,34,61,95
9/20/2013 6:32,10,7000,35,62,97
9/20/2013 6:32,10,7000,35,62,97
9/20/2013 6:32,10,7000,31,61,92
9/20/2013 6:32,10,7000,39,64,103
9/20/2013 6:32,10,7000,29,64,93
9/20/2013 6:32,10,7000,30,64,94
9/20/2013 6:32,10,7000,32,61,93
9/20/2013 6:32,10,7000,34,64,98
9/20/2013 6:32,10,7000,35,62,97
9/20/2013 6:32,10,7000,38,64,102
9/20/2013 6:33,10,7000,33,59,92
9/20/2013 6:33,10,7000,32,59,91
9/20/2013 6:33,10,7000,33,64,97
9/20/2013 6:33,10,7000,33,63,96
9/20/2013 6:33,10,7000,33,62,95
9/20/2013 6:33,10,7000,32,62,94
9/20/2013 6:33,10,7000,36,62,98
9/20/2013 6:33,10,7000,32,63,95
9/20/2013 6:33,10,7000,36,62,98
9/20/2013 6:33,10,7000,33,63,96
9/20/2013 6:33,10,7000,33,61,94
9/20/2013 6:33,10,7000,34,61,95
9/20/2013 6:33,10,7000,29,63,92
9/20/2013 6:33,10,7000,39,61,100
9/20/2013 6:33,10,7000,32,62,94
9/20/2013 6:33,10,7000,32,62,94
9/20/2013 6:33,10,7000,33,64,97
9/20/2013 6:33,10,7000,32,61,93
9/20/2013 6:33,10,7000,31,60,91
9/20/2013 6:33,10,7000,32,63,95
9/20/2013 6:33,10,7000,32,63,95
9/20/2013 6:33,10,7000,35,65,100
9/20/2013 6:33,10,7000,31,63,94
9/20/2013 6:33,10,7000,34,62,96
9/20/2013 6:33,10,7000,31,63,94
9/20/2013 6:33,10,7000,31,63,94
9/20/2013 6:33,10,7000,32,64,96
9/20/2013 6:33,10,7000,40,60,100
9/20/2013 6:33,10,7000,34,60,94
9/20/2013 6:33,10,7000,33,65,98
9/20/2013 6:33,10,7000,36,64,100
9/20/2013 6:34,10,7000,32,61,93
9/20/2013 6:34,10,7000,34,61,95
9/20/2013 6:34,10,7000,32,60,92
9/20/2013 6:34,10,7000,32,62,94
9/20/2013 6:34,10,7000,32,60,92
9/20/2013 6:34,10,7000,33,60,93
9/20/2013 6:34,10,7000,33,58,91
9/20/2013 6:34,10,7000,29,64,93
9/20/2013 6:34,10,7000,37,63,100
9/20/2013 6:34,10,7000,33,60,93
9/20/2013 6:34,10,7000,30,62,92
9/20/2013 6:34,10,7000,32,60,92
9/20/2013 6:34,10,7000,30,62,92
9/20/2013 6:34,10,7000,32,61,93
9/20/2013 6:34,10,7000,33,62,95
9/20/2013 6:34,10,7000,33,60,93
9/20/2013 6:34,10,7000,31,62,93
9/20/2013 6:34,10,7000,34,62,96
9/20/2013 6:34,10,7000,32,61,93
9/20/2013 6:34,10,7000,30,63,93
9/20/2013 6:34,10,7000,37,60,97
9/20/2013 6:34,10,7000,30,61,91
9/20/2013 6:34,10,7000,43,63,106
9/20/2013 6:34,10,7000,29,60,89
9/20/2013 6:34,10,7000,32,62,94
9/20/2013 6:34,10,7000,32,60,92
9/20/2013 6:34,10,7000,32,61,93
9/20/2013 6:34,10,7000,31,64,95
9/20/2013 6:34,10,7000,32,60,92
9/20/2013 6:34,10,8000,31,59,90
9/20/2013 6:35,10,8000,33,61,94
9/20/2013 6:35,10,8000,32,69,101
9/20/2013 6:35,10,8000,32,62,94
9/20/2013 6:35,10,8000,33,63,96
9/20/2013 6:35,10,8000,32,62,94
9/20/2013 6:35,10,8000,33,65,98
9/20/2013 6:35,10,8000,33,62,95
9/20/2013 6:35,10,8000,34,64,98
9/20/2013 6:35,10,8000,37,63,100
9/20/2013 6:35,10,8000,30,59,89
9/20/2013 6:35,10,8000,37,67,104
9/20/2013 6:35,10,8000,32,61,93
9/20/2013 6:35,10,8000,34,60,94
9/20/2013 6:35,10,8000,34,64,98
9/20/2013 6:35,10,8000,34,62,96
9/20/2013 6:35,10,8000,32,63,95
9/20/2013 6:35,10,8000,32,62,94
9/20/2013 6:35,10,8000,33,60,93
9/20/2013 6:35,10,8000,42,62,104
9/20/2013 6:35,10,8000,34,64,98
9/20/2013 6:35,10,8000,35,64,99
9/20/2013 6:35,10,8000,32,62,94
9/20/2013 6:35,10,8000,32,65,97
9/20/2013 6:35,10,8000,35,64,99
9/20/2013 6:35,10,8000,30,60,90
9/20/2013 6:35,10,8000,33,63,96
9/20/2013 6:35,10,8000,32,61,93
9/20/2013 6:35,10,8000,32,62,94
9/20/2013 6:35,10,8000,31,65,96
9/20/2013 6:35,10,8000,31,65,96
9/20/2013 6:35,10,8000,34,63,97
9/20/2013 6:36,10,8000,36,66,102
9/20/2013 6:36,10,8000,31,59,90
9/20/2013 6:36,10,8000,33,63,96
9/20/2013 6:36,10,8000,34,64,98
9/20/2013 6:36,10,8000,34,63,97
9/20/2013 6:36,10,8000,38,62,100
9/20/2013 6:36,10,8000,35,64,99
9/20/2013 6:36,10,8000,33,61,94
9/20/2013 6:36,10,8000,32,59,91
9/20/2013 6:36,10,8000,34,64,98
9/20/2013 6:36,10,8000,36,60,96
9/20/2013 6:36,10,8000,35,64,99
9/20/2013 6:36,10,8000,29,62,91
9/20/2013 6:36,10,8000,32,60,92
9/20/2013 6:36,10,8000,35,63,98
9/20/2013 6:36,10,8000,33,62,95
9/20/2013 6:36,10,8000,1017,63,1080
9/20/2013 6:36,10,8000,34,62,96
9/20/2013 6:36,10,8000,32,63,95
9/20/2013 6:36,10,8000,35,61,96
9/20/2013 6:36,10,8000,34,61,95
9/20/2013 6:36,10,8000,35,61,96
9/20/2013 6:36,10,8000,32,61,93
9/20/2013 6:36,10,8000,32,64,96
9/20/2013 6:36,10,8000,37,63,100
9/20/2013 6:36,10,8000,30,66,96
9/20/2013 6:36,10,8000,33,59,92
9/20/2013 6:36,10,8000,33,60,93
9/20/2013 6:36,10,8000,32,64,96
9/20/2013 6:36,10,8000,36,66,102
9/20/2013 6:37,10,8000,36,61,97
9/20/2013 6:37,10,8000,32,59,91
9/20/2013 6:37,10,8000,32,62,94
9/20/2013 6:37,10,8000,32,66,98
9/20/2013 6:37,10,8000,33,61,94
9/20/2013 6:37,10,8000,32,66,98
9/20/2013 6:37,10,8000,33,61,94
9/20/2013 6:37,10,8000,31,66,97
9/20/2013 6:37,10,8000,32,61,93
9/20/2013 6:37,10,8000,32,60,92
9/20/2013 6:37,10,8000,37,61,98
9/20/2013 6:37,10,8000,33,62,95
9/20/2013 6:37,10,8000,33,66,99
9/20/2013 6:37,10,8000,35,64,99
9/20/2013 6:37,10,8000,33,62,95
9/20/2013 6:37,10,8000,32,66,98
9/20/2013 6:37,10,8000,34,62,96
9/20/2013 6:37,10,8000,33,67,100
9/20/2013 6:37,10,8000,32,66,98
9/20/2013 6:37,10,8000,34,64,98
9/20/2013 6:37,10,8000,37,64,101
9/20/2013 6:37,10,8000,35,62,97
9/20/2013 6:37,10,8000,31,62,93
9/20/2013 6:37,10,8000,38,67,105
9/20/2013 6:37,10,8000,1015,62,1077
9/20/2013 6:37,10,8000,33,62,95
9/20/2013 6:37,10,8000,41,61,102
9/20/2013 6:37,10,8000,35,61,96
9/20/2013 6:37,10,8000,35,64,99
9/20/2013 6:37,10,8000,35,61,96
9/20/2013 6:38,10,8000,32,62,94
9/20/2013 6:38,10,8000,34,64,98
9/20/2013 6:38,10,8000,33,60,93
9/20/2013 6:38,10,8000,38,63,101
9/20/2013 6:38,10,8000,33,64,97
9/20/2013 6:38,10,8000,35,62,97
9/20/2013 6:38,10,8000,32,66,98
9/20/2013 6:38,10,8000,31,63,94
9/20/2013 6:38,10,8000,35,64,99
9/20/2013 6:38,10,8000,32,60,92
9/20/2013 6:38,10,8000,32,63,95
9/20/2013 6:38,10,8000,31,64,95
9/20/2013 6:38,10,8000,33,61,94
9/20/2013 6:38,10,8000,35,62,97
9/20/2013 6:38,10,8000,38,66,104
9/20/2013 6:38,10,8000,32,63,95
9/20/2013 6:38,10,8000,46,60,106
9/20/2013 6:38,10,8000,33,66,99
9/20/2013 6:38,10,8000,37,67,104
9/20/2013 6:38,10,8000,1028,65,1093
9/20/2013 6:38,10,8000,34,61,95
9/20/2013 6:38,10,8000,34,62,96
9/20/2013 6:38,10,8000,33,62,95
9/20/2013 6:38,10,9000,35,60,95
9/20/2013 6:38,10,9000,38,63,101
9/20/2013 6:38,10,9000,33,62,95
9/20/2013 6:38,10,9000,35,61,96
9/20/2013 6:38,10,9000,32,63,95
9/20/2013 6:38,10,9000,33,60,93
9/20/2013 6:38,10,9000,1024,67,1091
9/20/2013 6:39,10,9000,1028,64,1092
9/20/2013 6:39,10,9000,37,63,100
9/20/2013 6:39,10,9000,34,64,98
9/20/2013 6:39,10,9000,33,62,95
9/20/2013 6:39,10,9000,34,63,97
9/20/2013 6:39,10,9000,33,60,93
9/20/2013 6:39,10,9000,34,60,94
9/20/2013 6:39,10,9000,34,62,96
9/20/2013 6:39,10,9000,34,62,96
9/20/2013 6:39,10,9000,33,63,96
9/20/2013 6:39,10,9000,1025,65,1090
9/20/2013 6:39,10,9000,38,62,100
9/20/2013 6:39,10,9000,31,63,94
9/20/2013 6:39,10,9000,39,65,104
9/20/2013 6:39,10,9000,1017,64,1081
9/20/2013 6:39,10,9000,35,62,97
9/20/2013 6:39,10,9000,1014,73,1087
9/20/2013 6:39,10,9000,1020,65,1085
9/20/2013 6:39,10,9000,36,62,98
9/20/2013 6:39,10,9000,37,64,101
9/20/2013 6:39,10,9000,37,68,105
9/20/2013 6:39,10,9000,32,61,93
9/20/2013 6:39,10,9000,39,64,103
9/20/2013 6:39,10,9000,34,65,99
9/20/2013 6:39,10,9000,33,63,96
9/20/2013 6:40,10,9000,34,61,95
9/20/2013 6:40,10,9000,35,61,96
9/20/2013 6:40,10,9000,35,62,97
9/20/2013 6:40,10,9000,34,62,96
9/20/2013 6:40,10,9000,32,64,96
9/20/2013 6:40,10,9000,32,69,101
9/20/2013 6:40,10,9000,37,62,99
9/20/2013 6:40,10,9000,35,63,98
9/20/2013 6:40,10,9000,33,63,96
9/20/2013 6:40,10,9000,32,64,96
9/20/2013 6:40,10,9000,36,63,99
9/20/2013 6:40,10,9000,33,62,95
9/20/2013 6:40,10,9000,34,62,96
9/20/2013 6:40,10,9000,35,59,94
9/20/2013 6:40,10,9000,33,62,95
9/20/2013 6:40,10,9000,36,65,101
9/20/2013 6:40,10,9000,39,63,102
9/20/2013 6:40,10,9000,35,62,97
9/20/2013 6:40,10,9000,35,59,94
9/20/2013 6:40,10,9000,35,62,97
9/20/2013 6:40,10,9000,37,64,101
9/20/2013 6:40,10,9000,36,69,105
9/20/2013 6:40,10,9000,33,59,92
9/20/2013 6:40,10,9000,36,65,101
9/20/2013 6:40,10,9000,37,66,103
9/20/2013 6:40,10,9000,33,61,94
9/20/2013 6:40,10,9000,36,69,105
9/20/2013 6:40,10,9000,35,62,97
9/20/2013 6:41,10,9000,33,63,96
9/20/2013 6:41,10,9000,43,62,105
9/20/2013 6:41,10,9000,37,60,97
9/20/2013 6:41,10,9000,47,62,109
9/20/2013 6:41,10,9000,34,60,94
9/20/2013 6:41,10,9000,36,65,101
9/20/2013 6:41,10,9000,36,64,100
9/20/2013 6:41,10,9000,35,65,100
9/20/2013 6:41,10,9000,31,63,94
9/20/2013 6:41,10,9000,33,67,100
9/20/2013 6:41,10,9000,32,65,97
9/20/2013 6:41,10,9000,36,62,98
9/20/2013 6:41,10,9000,35,62,97
9/20/2013 6:41,10,9000,39,61,100
9/20/2013 6:41,10,9000,33,64,97
9/20/2013 6:41,10,9000,37,58,95
9/20/2013 6:41,10,9000,32,61,93
9/20/2013 6:41,10,9000,36,64,100
9/20/2013 6:41,10,9000,36,62,98
9/20/2013 6:41,10,9000,38,70,108
9/20/2013 6:41,10,9000,32,60,92
9/20/2013 6:41,10,9000,34,60,94
9/20/2013 6:41,10,9000,33,64,97
9/20/2013 6:41,10,9000,35,67,102
9/20/2013 6:41,10,9000,35,60,95
9/20/2013 6:41,10,9000,36,63,99
9/20/2013 6:41,10,9000,39,64,103
9/20/2013 6:41,10,9000,33,63,96
9/20/2013 6:41,10,9000,36,65,101
9/20/2013 6:41,10,9000,38,63,101
9/20/2013 6:42,10,9000,33,59,92
9/20/2013 6:42,10,9000,33,62,95
9/20/2013 6:42,10,9000,39,66,105
9/20/2013 6:42,10,9000,34,64,98
9/20/2013 6:42,10,9000,40,63,103
9/20/2013 6:42,10,9000,33,61,94
9/20/2013 6:42,10,9000,33,62,95
9/20/2013 6:42,10,9000,34,61,95
9/20/2013 6:42,10,9000,33,62,95
9/20/2013 6:42,10,9000,35,64,99
9/20/2013 6:42,10,9000,35,62,97
9/20/2013 6:42,10,9000,41,71,112
9/20/2013 6:42,10,9000,38,67,105
9/20/2013 6:42,10,9000,36,63,99
9/20/2013 6:42,10,9000,33,59,92
9/20/2013 6:42,10,9000,40,64,104
9/20/2013 6:42,10,9000,39,62,101
9/20/2013 6:42,10,9000,34,66,100
9/20/2013 6:42,10,9000,35,59,94
9/20/2013 6:42,10,9000,35,63,98
9/20/2013 6:42,10,9000,35,59,94
9/20/2013 6:42,10,9000,39,64,103
9/20/2013 6:42,10,9000,36,61,97
9/20/2013 6:42,10,9000,33,64,97
9/20/2013 6:42,10,9000,35,67,102
9/20/2013 6:42,10,10000,34,66,100
9/20/2013 6:42,10,10000,36,64,100
9/20/2013 6:42,10,10000,35,64,99
9/20/2013 6:42,10,10000,34,63,97
9/20/2013 6:43,10,10000,1021,71,1092
9/20/2013 6:43,10,10000,35,62,97
9/20/2013 6:43,10,10000,33,62,95
9/20/2013 6:43,10,10000,40,62,102
9/20/2013 6:43,10,10000,34,66,100
9/20/2013 6:43,10,10000,33,63,96
9/20/2013 6:43,10,10000,36,62,98
9/20/2013 6:43,10,10000,1030,67,1097
9/20/2013 6:43,10,10000,35,60,95
9/20/2013 6:43,10,10000,40,69,109
9/20/2013 6:43,10,10000,38,65,103
9/20/2013 6:43,10,10000,1018,64,1082
9/20/2013 6:43,10,10000,37,63,100
9/20/2013 6:43,10,10000,36,66,102
9/20/2013 6:43,10,10000,36,66,102
9/20/2013 6:43,10,10000,1023,69,1092
9/20/2013 6:43,10,10000,34,70,104
9/20/2013 6:43,10,10000,37,63,100
9/20/2013 6:43,10,10000,40,64,104
9/20/2013 6:43,10,10000,38,63,101
9/20/2013 6:43,10,10000,35,65,100
9/20/2013 6:43,10,10000,35,65,100
9/20/2013 6:43,10,10000,36,62,98
9/20/2013 6:43,10,10000,33,65,98
9/20/2013 6:43,10,10000,36,63,99
9/20/2013 6:43,10,10000,37,61,98
9/20/2013 6:43,10,10000,36,62,98
9/20/2013 6:43,10,10000,38,63,101
9/20/2013 6:44,10,10000,32,62,94
9/20/2013 6:44,10,10000,38,65,103
9/20/2013 6:44,10,10000,41,62,103
9/20/2013 6:44,10,10000,44,61,105
9/20/2013 6:44,10,10000,41,61,102
9/20/2013 6:44,10,10000,40,63,103
9/20/2013 6:44,10,10000,43,64,107
9/20/2013 6:44,10,10000,35,65,100
9/20/2013 6:44,10,10000,34,65,99
9/20/2013 6:44,10,10000,1024,64,1088
9/20/2013 6:44,10,10000,35,60,95
9/20/2013 6:44,10,10000,34,61,95
9/20/2013 6:44,10,10000,36,66,102
9/20/2013 6:44,10,10000,36,66,102
9/20/2013 6:44,10,10000,39,67,106
9/20/2013 6:44,10,10000,39,68,107
9/20/2013 6:44,10,10000,32,63,95
9/20/2013 6:44,10,10000,43,62,105
9/20/2013 6:44,10,10000,35,66,101
9/20/2013 6:44,10,10000,33,61,94
9/20/2013 6:44,10,10000,36,61,97
9/20/2013 6:44,10,10000,36,60,96
9/20/2013 6:44,10,10000,35,66,101
9/20/2013 6:44,10,10000,37,65,102
9/20/2013 6:44,10,10000,49,69,118
9/20/2013 6:44,10,10000,38,64,102
9/20/2013 6:44,10,10000,34,61,95
9/20/2013 6:44,10,10000,34,62,96
9/20/2013 6:44,10,10000,33,63,96
9/20/2013 6:45,10,10000,37,61,98
9/20/2013 6:45,10,10000,34,67,101
9/20/2013 6:45,10,10000,41,63,104
9/20/2013 6:45,10,10000,37,60,97
9/20/2013 6:45,10,10000,38,66,104
9/20/2013 6:45,10,10000,37,63,100
9/20/2013 6:45,10,10000,33,60,93
9/20/2013 6:45,10,10000,30,63,93
9/20/2013 6:45,10,10000,35,66,101
9/20/2013 6:45,10,10000,35,65,100
9/20/2013 6:45,10,10000,33,67,100
9/20/2013 6:45,10,10000,42,67,109
9/20/2013 6:45,10,10000,38,69,107
9/20/2013 6:45,10,10000,41,62,103
9/20/2013 6:45,10,10000,33,63,96
9/20/2013 6:45,10,10000,37,65,102
9/20/2013 6:45,10,10000,34,62,96
9/20/2013 6:45,10,10000,40,69,109
9/20/2013 6:45,10,10000,39,68,107
9/20/2013 6:45,10,10000,38,64,102
9/20/2013 6:45,10,10000,40,69,109
9/20/2013 6:45,10,10000,37,65,102
9/20/2013 6:45,10,10000,40,66,106
9/20/2013 6:45,10,10000,37,65,102
9/20/2013 6:45,10,10000,35,64,99
9/20/2013 6:45,10,10000,34,65,99
9/20/2013 6:45,10,10000,36,65,101
9/20/2013 6:45,10,10000,34,64,98
9/20/2013 6:45,10,10000,36,62,98
9/20/2013 6:45,10,10000,38,62,100
9/20/2013 6:46,10,10000,36,65,101
9/20/2013 6:46,10,10000,35,63,98
9/20/2013 6:46,10,10000,32,60,92
9/20/2013 6:46,10,10000,35,64,99
9/20/2013 6:46,10,10000,35,66,101
9/20/2013 6:46,10,10000,36,59,95
9/20/2013 6:46,10,10000,37,67,104
9/20/2013 6:46,10,10000,34,63,97
9/20/2013 6:46,10,10000,36,63,99
9/20/2013 6:46,10,10000,35,62,97
9/20/2013 6:46,10,10000,36,60,96
9/20/2013 6:46,10,10000,38,67,105
9/20/2013 6:46,10,10000,40,68,108
9/20/2013 6:46,10,10000,37,62,99
9/20/2013 6:46,10,10000,35,65,100
9/20/2013 6:46,10,10000,36,68,104
9/20/2013 6:46,10,10000,36,64,100
9/20/2013 6:46,10,10000,31,69,100
9/20/2013 6:46,10,10000,35,60,95
9/20/2013 6:46,10,10000,36,65,101
9/20/2013 6:46,10,10000,34,67,101
9/20/2013 6:46,10,10000,35,60,95
9/20/2013 6:46,10,10000,35,62,97
9/20/2013 6:46,10,10000,31,65,96
9/20/2013 6:46,10,10000,39,65,104
9/20/2013 6:46,10,10000,34,63,97
9/20/2013 6:46,10,10000,36,66,102
9/20/2013 6:46,10,10000,33,63,96
9/20/2013 6:46,10,10000,36,63,99
9/20/2013 6:46,10,10000,36,64,100
9/20/2013 6:47,10,10000,1021,65,1086
9/20/2013 6:47,10,10000,38,69,107
9/20/2013 6:47,10,10000,37,67,104
9/20/2013 6:47,10,10000,34,66,100
9/20/2013 6:47,10,10000,37,60,97
9/20/2013 6:47,10,10000,35,61,96
9/20/2013 6:47,10,10000,35,62,97
9/20/2013 6:47,10,10000,38,60,98
9/20/2013 6:47,10,10000,34,64,98
9/20/2013 6:47,10,10000,45,62,107
9/20/2013 6:47,10,10000,34,64,98
9/20/2013 6:47,10,10000,36,61,97
9/20/2013 6:47,10,10000,35,64,99
9/20/2013 6:47,10,10000,35,61,96
9/20/2013 6:47,10,10000,33,62,95
9/20/2013 6:47,10,10000,34,60,94
9/20/2013 6:47,10,10000,38,67,105
9/20/2013 6:47,10,10000,33,66,99
9/20/2013 6:47,10,10000,39,63,102
9/20/2013 6:47,10,10000,40,62,102
9/20/2013 6:47,10,10000,36,62,98
9/20/2013 6:47,10,10000,39,68,107
9/20/2013 6:47,10,10000,39,67,106
9/20/2013 6:47,10,10000,34,64,98
9/20/2013 6:47,10,10000,36,60,96
9/20/2013 6:47,10,10000,37,60,97
9/20/2013 6:47,10,10000,40,61,101
9/20/2013 6:47,10,10000,43,62,105
9/20/2013 6:47,10,10000,33,63,96
9/20/2013 6:48,10,10000,40,70,110
9/20/2013 6:48,10,10000,32,62,94
9/20/2013 6:48,10,10000,34,63,97
9/20/2013 6:48,10,10000,36,63,99
9/20/2013 6:48,10,10000,34,63,97
9/20/2013 6:48,10,10000,34,65,99
9/20/2013 6:48,10,10000,1017,65,1082
9/20/2013 6:48,10,10000,1019,66,1085
9/20/2013 6:48,10,10000,35,64,99
9/20/2013 6:48,10,10000,1028,65,1093
9/20/2013 6:48,10,10000,37,64,101
9/20/2013 6:48,10,10000,33,63,96
9/20/2013 6:48,10,10000,32,70,102
9/20/2013 6:48,10,10000,33,60,93
9/20/2013 6:48,10,10000,36,62,98
9/20/2013 6:48,10,10000,35,62,97
9/20/2013 6:48,10,10000,37,63,100
9/20/2013 6:48,10,10000,35,70,105
9/20/2013 6:48,10,10000,37,64,101
9/20/2013 6:48,10,10000,38,61,99
9/20/2013 6:48,10,10000,39,63,102
9/20/2013 6:48,10,10000,35,62,97
9/20/2013 6:48,10,10000,34,60,94
9/20/2013 6:48,10,10000,37,61,98
9/20/2013 6:48,10,10000,40,60,100
9/20/2013 6:48,10,10000,38,68,106
9/20/2013 6:48,10,10000,36,67,103
9/20/2013 6:49,10,10000,36,68,104
9/20/2013 6:49,10,10000,1025,64,1089
9/20/2013 6:49,10,10000,37,60,97
9/20/2013 6:49,10,10000,34,68,102
9/20/2013 6:49,10,10000,35,62,97
9/20/2013 6:49,10,10000,41,64,105
9/20/2013 6:49,10,10000,36,63,99
9/20/2013 6:49,10,10000,34,63,97
9/20/2013 6:49,10,10000,32,60,92
9/20/2013 6:49,10,10000,38,62,100
9/20/2013 6:49,10,10000,34,61,95
9/20/2013 6:49,10,10000,43,67,110
9/20/2013 6:49,10,10000,35,64,99
9/20/2013 6:49,10,10000,36,63,99
9/20/2013 6:49,10,10000,37,62,99
9/20/2013 6:49,10,10000,34,63,97
9/20/2013 6:49,10,10000,38,63,101
9/20/2013 6:49,10,10000,35,64,99
9/20/2013 6:49,10,10000,33,61,94
9/20/2013 6:49,10,10000,36,62,98
9/20/2013 6:49,10,10000,34,62,96
9/20/2013 6:49,10,10000,35,64,99
9/20/2013 6:49,10,10000,37,63,100
9/20/2013 6:49,10,10000,34,65,99
9/20/2013 6:49,10,10000,39,60,99
9/20/2013 6:49,10,10000,34,60,94
9/20/2013 6:49,10,10000,38,68,106
9/20/2013 6:49,10,10000,36,62,98
9/20/2013 6:49,10,10000,36,65,101
9/20/2013 6:49,10,10000,33,63,96
9/20/2013 6:50,10,10000,37,66,103
9/20/2013 6:50,10,10000,34,66,100
9/20/2013 6:50,10,10000,39,67,106
9/20/2013 6:50,10,10000,34,67,101
9/20/2013 6:50,10,10000,34,65,99
9/20/2013 6:50,10,10000,36,62,98
9/20/2013 6:50,10,10000,35,59,94
9/20/2013 6:50,10,10000,37,63,100
9/20/2013 6:50,10,10000,45,64,109
9/20/2013 6:50,10,10000,33,68,101
9/20/2013 6:50,10,10000,34,67,101
9/20/2013 6:50,10,10000,39,63,102
9/20/2013 6:50,10,10000,33,64,97
9/20/2013 6:50,10,10000,1036,68,1104
9/20/2013 6:50,10,10000,39,62,101
9/20/2013 6:50,10,10000,32,68,100
9/20/2013 6:50,10,10000,34,68,102
9/20/2013 6:50,10,10000,34,61,95
9/20/2013 6:50,10,10000,35,60,95
9/20/2013 6:50,10,10000,36,62,98
9/20/2013 6:50,10,10000,33,64,97
9/20/2013 6:50,10,10000,33,62,95
9/20/2013 6:50,10,10000,37,62,99
9/20/2013 6:50,10,20000,41,62,103
9/20/2013 6:50,10,20000,41,64,105
9/20/2013 6:50,10,20000,44,62,106
9/20/2013 6:50,10,20000,42,66,108
9/20/2013 6:50,10,20000,40,67,107
9/20/2013 6:50,10,20000,38,69,107
9/20/2013 6:51,10,20000,44,70,114
9/20/2013 6:51,10,20000,40,64,104
9/20/2013 6:51,10,20000,42,66,108
9/20/2013 6:51,10,20000,1033,69,1102
9/20/2013 6:51,10,20000,42,67,109
9/20/2013 6:51,10,20000,42,66,108
9/20/2013 6:51,10,20000,44,66,110
9/20/2013 6:51,10,20000,53,68,121
9/20/2013 6:51,10,20000,45,65,110
9/20/2013 6:51,10,20000,44,64,108
9/20/2013 6:51,10,20000,41,70,111
9/20/2013 6:51,10,20000,50,70,120
9/20/2013 6:51,10,20000,45,63,108
9/20/2013 6:51,10,20000,46,68,114
9/20/2013 6:51,10,20000,45,66,111
9/20/2013 6:51,10,20000,41,66,107
9/20/2013 6:51,10,20000,41,65,106
9/20/2013 6:51,10,20000,43,63,106
9/20/2013 6:51,10,20000,43,72,115
9/20/2013 6:51,10,20000,39,63,102
9/20/2013 6:51,10,20000,41,66,107
9/20/2013 6:51,10,20000,41,65,106
9/20/2013 6:51,10,20000,44,63,107
9/20/2013 6:51,10,20000,43,65,108
9/20/2013 6:51,10,20000,43,66,109
9/20/2013 6:51,10,20000,42,64,106
9/20/2013 6:51,10,20000,45,67,112
9/20/2013 6:51,10,20000,51,72,123
9/20/2013 6:51,10,20000,44,73,117
9/20/2013 6:52,10,20000,39,67,106
9/20/2013 6:52,10,20000,44,67,111
9/20/2013 6:52,10,20000,39,67,106
9/20/2013 6:52,10,20000,39,64,103
9/20/2013 6:52,10,20000,48,66,114
9/20/2013 6:52,10,20000,41,63,104
9/20/2013 6:52,10,20000,42,72,114
9/20/2013 6:52,10,20000,47,73,120
9/20/2013 6:52,10,20000,40,64,104
9/20/2013 6:52,10,20000,47,64,111
9/20/2013 6:52,10,20000,53,65,118
9/20/2013 6:52,10,20000,42,65,107
9/20/2013 6:52,10,20000,43,68,111
9/20/2013 6:52,10,20000,41,67,108
9/20/2013 6:52,10,20000,44,66,110
9/20/2013 6:52,10,20000,39,68,107
9/20/2013 6:52,10,20000,41,66,107
9/20/2013 6:52,10,20000,42,65,107
9/20/2013 6:52,10,20000,43,70,113
9/20/2013 6:52,10,20000,39,62,101
9/20/2013 6:52,10,20000,44,63,107
9/20/2013 6:52,10,20000,48,69,117
9/20/2013 6:52,10,20000,42,63,105
9/20/2013 6:52,10,20000,50,65,115
9/20/2013 6:52,10,20000,42,63,105
9/20/2013 6:52,10,20000,42,63,105
9/20/2013 6:52,10,20000,48,70,118
9/20/2013 6:52,10,20000,44,65,109
9/20/2013 6:52,10,20000,46,71,117
9/20/2013 6:52,10,20000,40,69,109
9/20/2013 6:53,10,20000,50,69,119
9/20/2013 6:53,10,20000,41,67,108
9/20/2013 6:53,10,20000,40,64,104
9/20/2013 6:53,10,20000,49,72,121
9/20/2013 6:53,10,20000,53,65,118
9/20/2013 6:53,10,20000,41,68,109
9/20/2013 6:53,10,20000,41,66,107
9/20/2013 6:53,10,20000,1035,70,1105
9/20/2013 6:53,10,20000,44,67,111
9/20/2013 6:53,10,20000,41,69,110
9/20/2013 6:53,10,20000,48,67,115
9/20/2013 6:53,10,20000,39,70,109
9/20/2013 6:53,10,20000,42,72,114
9/20/2013 6:53,10,20000,50,76,126
9/20/2013 6:53,10,20000,43,72,115
9/20/2013 6:53,10,20000,41,63,104
9/20/2013 6:53,10,20000,42,64,106
9/20/2013 6:53,10,20000,44,65,109
9/20/2013 6:53,10,20000,43,64,107
9/20/2013 6:53,10,20000,48,66,114
9/20/2013 6:53,10,20000,44,66,110
9/20/2013 6:53,10,20000,48,66,114
9/20/2013 6:53,10,20000,40,67,107
9/20/2013 6:53,10,20000,50,68,118
9/20/2013 6:53,10,20000,43,69,112
9/20/2013 6:53,10,20000,42,66,108
9/20/2013 6:53,10,20000,44,63,107
9/20/2013 6:53,10,20000,42,63,105
9/20/2013 6:53,10,20000,49,66,115
9/20/2013 6:53,10,20000,51,74,125
9/20/2013 6:54,10,20000,45,63,108
9/20/2013 6:54,10,20000,40,62,102
9/20/2013 6:54,10,20000,40,71,111
9/20/2013 6:54,10,20000,41,64,105
9/20/2013 6:54,10,20000,1032,62,1094
9/20/2013 6:54,10,20000,44,71,115
9/20/2013 6:54,10,20000,42,65,107
9/20/2013 6:54,10,20000,42,66,108
9/20/2013 6:54,10,20000,42,69,111
9/20/2013 6:54,10,20000,42,66,108
9/20/2013 6:54,10,20000,1032,70,1102
9/20/2013 6:54,10,20000,57,67,124
9/20/2013 6:54,10,20000,42,65,107
9/20/2013 6:54,10,20000,44,72,116
9/20/2013 6:54,10,20000,43,68,111
9/20/2013 6:54,10,20000,47,62,109
9/20/2013 6:54,10,20000,41,65,106
9/20/2013 6:54,10,20000,43,66,109
9/20/2013 6:54,10,20000,46,67,113
9/20/2013 6:54,10,20000,43,66,109
9/20/2013 6:54,10,30000,50,74,124
9/20/2013 6:54,10,30000,53,73,126
9/20/2013 6:54,10,30000,47,71,118
9/20/2013 6:54,10,30000,46,70,116
9/20/2013 6:54,10,30000,50,79,129
9/20/2013 6:54,10,30000,43,74,117
9/20/2013 6:54,10,30000,49,76,125
9/20/2013 6:55,10,30000,46,75,121
9/20/2013 6:55,10,30000,45,69,114
9/20/2013 6:55,10,30000,50,72,122
9/20/2013 6:55,10,30000,42,70,112
9/20/2013 6:55,10,30000,48,68,116
9/20/2013 6:55,10,30000,49,74,123
9/20/2013 6:55,10,30000,42,73,115
9/20/2013 6:55,10,30000,53,71,124
9/20/2013 6:55,10,30000,54,71,125
9/20/2013 6:55,10,30000,50,69,119
9/20/2013 6:55,10,30000,1031,76,1107
9/20/2013 6:55,10,30000,1032,78,1110
9/20/2013 6:55,10,30000,46,73,119
9/20/2013 6:55,10,30000,1035,70,1105
9/20/2013 6:55,10,30000,45,71,116
9/20/2013 6:55,10,30000,44,69,113
9/20/2013 6:55,10,30000,48,72,120
9/20/2013 6:55,10,30000,45,72,117
9/20/2013 6:55,10,30000,44,73,117
9/20/2013 6:55,10,30000,46,71,117
9/20/2013 6:55,10,30000,45,69,114
9/20/2013 6:55,10,30000,1038,74,1112
9/20/2013 6:55,10,30000,47,69,116
9/20/2013 6:55,10,30000,47,71,118
9/20/2013 6:55,10,30000,44,70,114
9/20/2013 6:55,10,30000,46,70,116
9/20/2013 6:56,10,30000,39,73,112
9/20/2013 6:56,10,30000,1034,74,1108
9/20/2013 6:56,10,30000,44,70,114
9/20/2013 6:56,10,30000,51,71,122
9/20/2013 6:56,10,30000,44,71,115
9/20/2013 6:56,10,30000,48,72,120
9/20/2013 6:56,10,30000,48,71,119
9/20/2013 6:56,10,30000,53,76,129
9/20/2013 6:56,10,30000,48,72,120
9/20/2013 6:56,10,30000,47,73,120
9/20/2013 6:56,10,30000,49,73,122
9/20/2013 6:56,10,30000,45,76,121
9/20/2013 6:56,10,30000,43,71,114
9/20/2013 6:56,10,30000,1035,72,1107
9/20/2013 6:56,10,30000,49,73,122
9/20/2013 6:56,10,30000,54,71,125
9/20/2013 6:56,10,30000,45,72,117
9/20/2013 6:56,10,30000,44,75,119
9/20/2013 6:56,10,30000,43,73,116
9/20/2013 6:56,10,30000,47,74,121
9/20/2013 6:56,10,30000,44,72,116
9/20/2013 6:56,10,30000,45,72,117
9/20/2013 6:56,10,30000,1035,74,1109
9/20/2013 6:56,10,30000,52,79,131
9/20/2013 6:56,10,30000,1036,73,1109
9/20/2013 6:56,10,30000,46,76,122
9/20/2013 6:56,10,30000,45,78,123
9/20/2013 6:57,10,30000,46,84,130
9/20/2013 6:57,10,30000,41,70,111
9/20/2013 6:57,10,30000,50,73,123
9/20/2013 6:57,10,30000,46,71,117
9/20/2013 6:57,10,30000,46,72,118
9/20/2013 6:57,10,30000,50,74,124
9/20/2013 6:57,10,30000,50,78,128
9/20/2013 6:57,10,30000,44,74,118
9/20/2013 6:57,10,30000,46,74,120
9/20/2013 6:57,10,30000,59,71,130
9/20/2013 6:57,10,30000,46,69,115
9/20/2013 6:57,10,30000,58,73,131
9/20/2013 6:57,10,30000,48,77,125
9/20/2013 6:57,10,30000,44,78,122
9/20/2013 6:57,10,30000,47,72,119
9/20/2013 6:57,10,30000,49,72,121
9/20/2013 6:57,10,30000,50,72,122
9/20/2013 6:57,10,30000,45,71,116
9/20/2013 6:57,10,30000,46,73,119
9/20/2013 6:57,10,30000,47,74,121
9/20/2013 6:57,10,30000,1043,75,1118
9/20/2013 6:57,10,30000,1040,76,1116
9/20/2013 6:57,10,30000,47,77,124
9/20/2013 6:57,10,30000,1045,77,1122
9/20/2013 6:57,10,30000,1045,72,1117
9/20/2013 6:57,10,30000,51,72,123
9/20/2013 6:57,10,30000,44,75,119
9/20/2013 6:58,10,30000,47,72,119
9/20/2013 6:58,10,30000,43,78,121
9/20/2013 6:58,10,30000,47,73,120
9/20/2013 6:58,10,30000,45,72,117
9/20/2013 6:58,10,30000,57,74,131
9/20/2013 6:58,10,30000,46,74,120
9/20/2013 6:58,10,30000,49,75,124
9/20/2013 6:58,10,30000,44,70,114
9/20/2013 6:58,10,30000,44,71,115
9/20/2013 6:58,10,30000,52,75,127
9/20/2013 6:58,10,30000,45,74,119
9/20/2013 6:58,10,30000,43,73,116
9/20/2013 6:58,10,30000,44,74,118
9/20/2013 6:58,10,30000,1029,75,1104
9/20/2013 6:58,10,30000,1038,78,1116
9/20/2013 6:58,10,30000,47,70,117
9/20/2013 6:58,10,30000,1033,73,1106
9/20/2013 6:58,10,30000,1031,70,1101
9/20/2013 6:58,10,30000,43,69,112
9/20/2013 6:58,10,30000,47,77,124
9/20/2013 6:58,10,30000,50,79,129
9/20/2013 6:58,10,30000,43,74,117
9/20/2013 6:58,10,30000,48,70,118
9/20/2013 6:58,10,30000,48,80,128
9/20/2013 6:58,10,30000,57,70,127
9/20/2013 6:58,10,30000,46,74,120
9/20/2013 6:59,10,30000,43,71,114
9/20/2013 6:59,10,30000,48,80,128
9/20/2013 6:59,10,40000,53,79,132
9/20/2013 6:59,10,40000,59,75,134
9/20/2013 6:59,10,40000,56,77,133
9/20/2013 6:59,10,40000,56,80,136
9/20/2013 6:59,10,40000,49,77,126
9/20/2013 6:59,10,40000,53,73,126
9/20/2013 6:59,10,40000,51,75,126
9/20/2013 6:59,10,40000,48,75,123
9/20/2013 6:59,10,40000,1046,79,1125
9/20/2013 6:59,10,40000,1048,75,1123
9/20/2013 6:59,10,40000,53,71,124
9/20/2013 6:59,10,40000,50,75,125
9/20/2013 6:59,10,40000,46,76,122
9/20/2013 6:59,10,40000,50,75,125
9/20/2013 6:59,10,40000,50,72,122
9/20/2013 6:59,10,40000,52,79,131
9/20/2013 6:59,10,40000,54,75,129
9/20/2013 6:59,10,40000,51,76,127
9/20/2013 6:59,10,40000,56,72,128
9/20/2013 6:59,10,40000,49,75,124
9/20/2013 6:59,10,40000,49,69,118
9/20/2013 6:59,10,40000,50,72,122
9/20/2013 6:59,10,40000,50,79,129
9/20/2013 7:00,10,40000,48,73,121
9/20/2013 7:00,10,40000,54,87,141
9/20/2013 7:00,10,40000,47,71,118
9/20/2013 7:00,10,40000,47,76,123
9/20/2013 7:00,10,40000,52,74,126
9/20/2013 7:00,10,40000,51,77,128
9/20/2013 7:00,10,40000,51,74,125
9/20/2013 7:00,10,40000,49,75,124
9/20/2013 7:00,10,40000,50,76,126
9/20/2013 7:00,10,40000,1051,75,1126
9/20/2013 7:00,10,40000,47,72,119
9/20/2013 7:00,10,40000,56,76,132
9/20/2013 7:00,10,40000,51,71,122
9/20/2013 7:00,10,40000,57,75,132
9/20/2013 7:00,10,40000,61,79,140
9/20/2013 7:00,10,40000,52,76,128
9/20/2013 7:00,10,40000,1041,74,1115
9/20/2013 7:00,10,40000,46,72,118
9/20/2013 7:00,10,40000,50,74,124
9/20/2013 7:00,10,40000,45,69,114
9/20/2013 7:00,10,40000,53,72,125
9/20/2013 7:00,10,40000,48,74,122
9/20/2013 7:00,10,40000,51,72,123
9/20/2013 7:00,10,40000,1040,78,1118
9/20/2013 7:00,10,40000,1053,79,1132
9/20/2013 7:00,10,40000,60,75,135
9/20/2013 7:01,10,40000,1045,71,1116
9/20/2013 7:01,10,40000,51,75,126
9/20/2013 7:01,10,40000,1039,74,1113
9/20/2013 7:01,10,40000,1047,71,1118
9/20/2013 7:01,10,40000,53,79,132
9/20/2013 7:01,10,40000,1050,79,1129
9/20/2013 7:01,10,40000,48,76,124
9/20/2013 7:01,10,40000,1034,78,1112
9/20/2013 7:01,10,40000,48,71,119
9/20/2013 7:01,10,40000,51,73,124
9/20/2013 7:01,10,40000,45,69,114
9/20/2013 7:01,10,40000,54,78,132
9/20/2013 7:01,10,40000,47,68,115
9/20/2013 7:01,10,40000,47,72,119
9/20/2013 7:01,10,40000,49,72,121
9/20/2013 7:01,10,40000,48,78,126
9/20/2013 7:01,10,40000,45,71,116
9/20/2013 7:01,10,40000,43,74,117
9/20/2013 7:01,10,40000,49,80,129
9/20/2013 7:01,10,40000,1037,73,1110
9/20/2013 7:01,10,40000,50,72,122
9/20/2013 7:01,10,40000,52,79,131
9/20/2013 7:01,10,40000,49,73,122
9/20/2013 7:01,10,40000,49,81,130
9/20/2013 7:01,10,40000,48,74,122
9/20/2013 7:02,10,40000,52,74,126
9/20/2013 7:02,10,40000,58,82,140
9/20/2013 7:02,10,40000,49,75,124
9/20/2013 7:02,10,40000,51,80,131
9/20/2013 7:02,10,40000,58,82,140
9/20/2013 7:02,10,40000,54,77,131
9/20/2013 7:02,10,40000,48,83,131
9/20/2013 7:02,10,40000,51,75,126
9/20/2013 7:02,10,40000,51,72,123
9/20/2013 7:02,10,40000,1041,82,1123
9/20/2013 7:02,10,40000,46,75,121
9/20/2013 7:02,10,40000,48,72,120
9/20/2013 7:02,10,40000,54,76,130
9/20/2013 7:02,10,40000,1048,84,1132
9/20/2013 7:02,10,40000,51,79,130
9/20/2013 7:02,10,40000,49,72,121
9/20/2013 7:19,10,40000,47,74,121
9/20/2013 7:19,10,40000,48,72,120
9/20/2013 7:19,10,40000,53,75,128
9/20/2013 7:19,10,40000,54,74,128
9/20/2013 7:19,10,40000,59,73,132
9/20/2013 7:19,10,40000,47,76,123
9/20/2013 7:19,10,40000,48,73,121
9/20/2013 7:19,10,40000,50,73,123
9/20/2013 7:19,10,40000,1034,77,1111
9/20/2013 7:19,10,40000,45,73,118
9/20/2013 7:19,10,40000,53,79,132
9/20/2013 7:19,10,40000,54,74,128
9/20/2013 7:19,10,40000,59,75,134
9/20/2013 7:19,10,40000,48,74,122
9/20/2013 7:19,10,40000,56,76,132
9/20/2013 7:19,10,40000,50,74,124
9/20/2013 7:19,10,40000,49,71,120
9/20/2013 7:19,10,40000,1044,78,1122
9/20/2013 7:20,10,40000,43,75,118
9/20/2013 7:20,10,40000,49,72,121
9/20/2013 7:20,10,40000,50,76,126
9/20/2013 7:20,10,40000,47,75,122
9/20/2013 7:20,10,40000,51,77,128
9/20/2013 7:20,10,40000,1032,77,1109
9/20/2013 7:20,10,50000,60,72,132
9/20/2013 7:20,10,50000,64,76,140
9/20/2013 7:20,10,50000,65,76,141
9/20/2013 7:20,10,50000,57,69,126
9/20/2013 7:20,10,50000,65,73,138
9/20/2013 7:20,10,50000,63,71,134
9/20/2013 7:20,10,50000,60,73,133
9/20/2013 7:20,10,50000,1038,69,1107
9/20/2013 7:20,10,50000,57,72,129
9/20/2013 7:20,10,50000,54,68,122
9/20/2013 7:20,10,50000,60,74,134
9/20/2013 7:20,10,50000,1032,76,1108
9/20/2013 7:20,10,50000,62,69,131
9/20/2013 7:20,10,50000,1040,70,1110
9/20/2013 7:20,10,50000,52,100,152
9/20/2013 7:20,10,50000,60,70,130
9/20/2013 7:20,10,50000,67,75,142
9/20/2013 7:20,10,50000,61,69,130
9/20/2013 7:20,10,50000,58,78,136
9/20/2013 7:20,10,50000,65,71,136
9/20/2013 7:21,10,50000,58,68,126
9/20/2013 7:21,10,50000,67,72,139
9/20/2013 7:21,10,50000,70,73,143
9/20/2013 7:21,10,50000,1038,75,1113
9/20/2013 7:21,10,50000,61,71,132
9/20/2013 7:21,10,50000,62,73,135
9/20/2013 7:21,10,50000,58,73,131
9/20/2013 7:21,10,50000,58,69,127
9/20/2013 7:21,10,50000,58,69,127
9/20/2013 7:21,10,50000,58,72,130
9/20/2013 7:21,10,50000,63,69,132
9/20/2013 7:21,10,50000,56,69,125
9/20/2013 7:21,10,50000,59,72,131
9/20/2013 7:21,10,50000,60,71,131
9/20/2013 7:21,10,50000,59,69,128
9/20/2013 7:21,10,50000,55,70,125
9/20/2013 7:21,10,50000,55,69,124
9/20/2013 7:21,10,50000,57,70,127
9/20/2013 7:21,10,50000,52,71,123
9/20/2013 7:21,10,50000,56,71,127
9/20/2013 7:21,10,50000,58,70,128
9/20/2013 7:21,10,50000,58,73,131
9/20/2013 7:21,10,50000,57,69,126
9/20/2013 7:21,10,50000,64,71,135
9/20/2013 7:21,10,50000,61,75,136
9/20/2013 7:21,10,50000,60,74,134
9/20/2013 7:21,10,50000,55,74,129
9/20/2013 7:21,10,50000,55,72,127
9/20/2013 7:21,10,50000,68,71,139
9/20/2013 7:22,10,50000,57,75,132
9/20/2013 7:22,10,50000,56,70,126
9/20/2013 7:22,10,50000,58,68,126
9/20/2013 7:22,10,50000,58,72,130
9/20/2013 7:22,10,50000,1039,72,1111
9/20/2013 7:22,10,50000,64,70,134
9/20/2013 7:22,10,50000,1041,74,1115
9/20/2013 7:22,10,50000,55,75,130
9/20/2013 7:22,10,50000,1039,74,1113
9/20/2013 7:22,10,50000,1040,72,1112
9/20/2013 7:22,10,50000,66,73,139
9/20/2013 7:22,10,50000,1038,70,1108
9/20/2013 7:22,10,50000,53,70,123
9/20/2013 7:22,10,50000,1034,72,1106
9/20/2013 7:22,10,50000,62,71,133
9/20/2013 7:22,10,50000,57,69,126
9/20/2013 7:22,10,50000,56,76,132
9/20/2013 7:22,10,50000,57,73,130
9/20/2013 7:22,10,50000,68,68,136
9/20/2013 7:22,10,50000,55,76,131
9/20/2013 7:22,10,50000,61,74,135
9/20/2013 7:22,10,50000,59,69,128
9/20/2013 7:22,10,50000,59,76,135
9/20/2013 7:22,10,50000,61,70,131
9/20/2013 7:23,10,50000,51,76,127
9/20/2013 7:23,10,50000,60,74,134
9/20/2013 7:23,10,50000,56,69,125
9/20/2013 7:23,10,50000,58,68,126
9/20/2013 7:23,10,50000,56,73,129
9/20/2013 7:23,10,50000,55,72,127
9/20/2013 7:23,10,50000,57,69,126
9/20/2013 7:23,10,50000,55,71,126
9/20/2013 7:23,10,50000,53,68,121
9/20/2013 7:23,10,50000,57,73,130
9/20/2013 7:23,10,50000,55,68,123
9/20/2013 7:23,10,50000,1043,71,1114
9/20/2013 7:23,10,50000,56,73,129
9/20/2013 7:23,10,50000,55,72,127
9/20/2013 7:23,10,50000,56,74,130
9/20/2013 7:23,10,50000,65,71,136
9/20/2013 7:23,10,50000,61,75,136
9/20/2013 7:23,10,50000,57,69,126
9/20/2013 7:23,10,50000,55,69,124
9/20/2013 7:23,10,50000,60,79,139
9/20/2013 7:23,10,50000,63,72,135
9/20/2013 7:23,10,50000,62,69,131
9/20/2013 7:23,10,50000,57,71,128
9/20/2013 7:23,10,50000,54,71,125
9/20/2013 7:23,10,50000,59,71,130
9/20/2013 7:23,10,50000,59,70,129
9/20/2013 7:24,10,50000,1038,71,1109
9/20/2013 7:24,10,50000,1035,70,1105
9/20/2013 7:24,10,50000,59,69,128
9/20/2013 7:24,10,50000,63,70,133
9/20/2013 7:24,10,50000,62,77,139
9/20/2013 7:24,10,50000,59,76,135
9/20/2013 7:24,10,50000,60,70,130
9/20/2013 7:24,10,50000,56,70,126
9/20/2013 7:24,10,50000,57,70,127
9/20/2013 7:24,10,50000,58,70,128
9/20/2013 7:24,10,50000,59,74,133
9/20/2013 7:24,10,50000,1046,76,1122
9/20/2013 7:24,10,50000,1037,79,1116
9/20/2013 7:24,10,50000,58,70,128
9/20/2013 7:24,10,50000,55,74,129
9/20/2013 7:24,10,50000,1040,72,1112
9/20/2013 7:24,10,60000,1056,74,1130
9/20/2013 7:24,10,60000,60,70,130
9/20/2013 7:24,10,60000,58,76,134
9/20/2013 7:24,10,60000,63,75,138
9/20/2013 7:24,10,60000,83,75,158
9/20/2013 7:24,10,60000,69,74,143
9/20/2013 7:24,10,60000,62,75,137
9/20/2013 7:24,10,60000,61,77,138
9/20/2013 7:24,10,60000,62,73,135
9/20/2013 7:24,10,60000,59,72,131
9/20/2013 7:25,10,60000,51,71,122
9/20/2013 7:25,10,60000,59,74,133
9/20/2013 7:25,10,60000,60,71,131
9/20/2013 7:25,10,60000,58,74,132
9/20/2013 7:25,10,60000,61,70,131
9/20/2013 7:25,10,60000,1038,72,1110
9/20/2013 7:25,10,60000,60,75,135
9/20/2013 7:25,10,60000,59,77,136
9/20/2013 7:25,10,60000,62,77,139
9/20/2013 7:25,10,60000,57,74,131
9/20/2013 7:25,10,60000,59,71,130
9/20/2013 7:25,10,60000,54,76,130
9/20/2013 7:25,10,60000,59,72,131
9/20/2013 7:25,10,60000,73,77,150
9/20/2013 7:25,10,60000,59,71,130
9/20/2013 7:25,10,60000,64,77,141
9/20/2013 7:25,10,60000,60,72,132
9/20/2013 7:25,10,60000,63,77,140
9/20/2013 7:25,10,60000,58,76,134
9/20/2013 7:25,10,60000,60,72,132
9/20/2013 7:25,10,60000,55,73,128
9/20/2013 7:25,10,60000,59,72,131
9/20/2013 7:25,10,60000,58,72,130
9/20/2013 7:25,10,60000,60,73,133
9/20/2013 7:25,10,60000,1038,78,1116
9/20/2013 7:25,10,60000,58,71,129
9/20/2013 7:25,10,60000,65,79,144
9/20/2013 7:25,10,60000,56,80,136
9/20/2013 7:25,10,60000,65,77,142
9/20/2013 7:26,10,60000,60,70,130
9/20/2013 7:26,10,60000,60,73,133
9/20/2013 7:26,10,60000,68,78,146
9/20/2013 7:26,10,60000,62,72,134
9/20/2013 7:26,10,60000,57,78,135
9/20/2013 7:26,10,60000,74,70,144
9/20/2013 7:26,10,60000,58,71,129
9/20/2013 7:26,10,60000,64,70,134
9/20/2013 7:26,10,60000,73,72,145
9/20/2013 7:26,10,60000,74,76,150
9/20/2013 7:26,10,60000,62,71,133
9/20/2013 7:26,10,60000,63,77,140
9/20/2013 7:26,10,60000,71,80,151
9/20/2013 7:26,10,60000,66,75,141
9/20/2013 7:26,10,60000,63,76,139
9/20/2013 7:26,10,60000,59,77,136
9/20/2013 7:26,10,60000,57,72,129
9/20/2013 7:26,10,60000,56,72,128
9/20/2013 7:26,10,60000,62,74,136
9/20/2013 7:26,10,60000,58,75,133
9/20/2013 7:26,10,60000,57,74,131
9/20/2013 7:26,10,60000,55,74,129
9/20/2013 7:26,10,60000,1038,74,1112
9/20/2013 7:26,10,60000,1040,75,1115
9/20/2013 7:26,10,60000,73,75,148
9/20/2013 7:26,10,60000,1040,77,1117
9/20/2013 7:26,10,60000,1043,75,1118
9/20/2013 7:27,10,60000,65,77,142
9/20/2013 7:27,10,60000,58,75,133
9/20/2013 7:27,10,60000,59,71,130
9/20/2013 7:27,10,60000,1059,74,1133
9/20/2013 7:27,10,60000,60,72,132
9/20/2013 7:27,10,60000,1049,75,1124
9/20/2013 7:27,10,60000,1038,75,1113
9/20/2013 7:27,10,60000,62,76,138
9/20/2013 7:27,10,60000,60,72,132
9/20/2013 7:27,10,60000,62,70,132
9/20/2013 7:27,10,60000,57,73,130
9/20/2013 7:27,10,60000,59,72,131
9/20/2013 7:27,10,60000,58,75,133
9/20/2013 7:27,10,60000,59,72,131
9/20/2013 7:27,10,60000,67,72,139
9/20/2013 7:27,10,60000,55,77,132
9/20/2013 7:27,10,60000,72,80,152
9/20/2013 7:27,10,60000,67,73,140
9/20/2013 7:27,10,60000,1045,74,1119
9/20/2013 7:27,10,60000,62,73,135
9/20/2013 7:27,10,60000,60,72,132
9/20/2013 7:27,10,60000,61,71,132
9/20/2013 7:27,10,60000,59,72,131
9/20/2013 7:27,10,60000,69,75,144
9/20/2013 7:27,10,60000,66,72,138
9/20/2013 7:27,10,60000,57,70,127
9/20/2013 7:28,10,60000,58,74,132
9/20/2013 7:28,10,60000,60,69,129
9/20/2013 7:28,10,60000,84,74,158
9/20/2013 7:28,10,60000,65,72,137
9/20/2013 7:28,10,60000,60,76,136
9/20/2013 7:28,10,60000,63,82,145
9/20/2013 7:28,10,60000,61,76,137
9/20/2013 7:28,10,60000,56,76,132
9/20/2013 7:28,10,60000,60,73,133
9/20/2013 7:28,10,60000,62,75,137
9/20/2013 7:28,10,60000,60,72,132
9/20/2013 7:28,10,60000,64,80,144
9/20/2013 7:28,10,60000,61,70,131
9/20/2013 7:28,10,60000,62,76,138
9/20/2013 7:28,10,60000,1052,74,1126
9/20/2013 7:28,10,60000,63,73,136
9/20/2013 7:28,10,60000,60,74,134
9/20/2013 7:28,10,60000,63,70,133
9/20/2013 7:28,10,60000,59,73,132
9/20/2013 7:28,10,60000,59,80,139
9/20/2013 7:28,10,60000,1035,75,1110
9/20/2013 7:28,10,60000,1048,80,1128
9/20/2013 7:28,10,60000,59,76,135
9/20/2013 7:28,10,70000,66,72,138
9/20/2013 7:28,10,70000,71,75,146
9/20/2013 7:28,10,70000,62,75,137
9/20/2013 7:28,10,70000,55,74,129
9/20/2013 7:29,10,70000,1054,81,1135
9/20/2013 7:29,10,70000,69,82,151
9/20/2013 7:29,10,70000,67,76,143
9/20/2013 7:29,10,70000,58,77,135
9/20/2013 7:29,10,70000,75,76,151
9/20/2013 7:29,10,70000,63,78,141
9/20/2013 7:29,10,70000,1043,79,1122
9/20/2013 7:29,10,70000,65,75,140
9/20/2013 7:29,10,70000,71,79,150
9/20/2013 7:29,10,70000,62,76,138
9/20/2013 7:29,10,70000,71,74,145
9/20/2013 7:29,10,70000,61,82,143
9/20/2013 7:29,10,70000,57,74,131
9/20/2013 7:29,10,70000,65,77,142
9/20/2013 7:29,10,70000,64,78,142
9/20/2013 7:29,10,70000,62,79,141
9/20/2013 7:29,10,70000,62,74,136
9/20/2013 7:29,10,70000,67,77,144
9/20/2013 7:29,10,70000,73,76,149
9/20/2013 7:29,10,70000,58,78,136
9/20/2013 7:29,10,70000,62,77,139
9/20/2013 7:29,10,70000,61,74,135
9/20/2013 7:29,10,70000,68,77,145
9/20/2013 7:29,10,70000,79,76,155
9/20/2013 7:29,10,70000,68,79,147
9/20/2013 7:29,10,70000,60,75,135
9/20/2013 7:30,10,70000,58,80,138
9/20/2013 7:30,10,70000,72,75,147
9/20/2013 7:30,10,70000,58,78,136
9/20/2013 7:30,10,70000,61,74,135
9/20/2013 7:30,10,70000,65,76,141
9/20/2013 7:30,10,70000,61,74,135
9/20/2013 7:30,10,70000,62,73,135
9/20/2013 7:30,10,70000,64,72,136
9/20/2013 7:30,10,70000,66,75,141
9/20/2013 7:30,10,70000,65,75,140
9/20/2013 7:30,10,70000,70,77,147
9/20/2013 7:30,10,70000,57,73,130
9/20/2013 7:30,10,70000,57,76,133
9/20/2013 7:30,10,70000,91,72,163
9/20/2013 7:30,10,70000,70,77,147
9/20/2013 7:30,10,70000,57,76,133
9/20/2013 7:30,10,70000,59,76,135
9/20/2013 7:30,10,70000,60,74,134
9/20/2013 7:30,10,70000,60,72,132
9/20/2013 7:30,10,70000,63,75,138
9/20/2013 7:30,10,70000,61,73,134
9/20/2013 7:30,10,70000,65,78,143
9/20/2013 7:30,10,70000,60,78,138
9/20/2013 7:30,10,70000,63,76,139
9/20/2013 7:30,10,70000,63,76,139
9/20/2013 7:30,10,70000,1044,77,1121
9/20/2013 7:30,10,70000,61,81,142
9/20/2013 7:30,10,70000,76,77,153
9/20/2013 7:30,10,70000,74,79,153
9/20/2013 7:31,10,70000,55,80,135
9/20/2013 7:31,10,70000,68,75,143
9/20/2013 7:31,10,70000,1052,74,1126
9/20/2013 7:31,10,70000,67,80,147
9/20/2013 7:31,10,70000,63,79,142
9/20/2013 7:31,10,70000,58,75,133
9/20/2013 7:31,10,70000,70,73,143
9/20/2013 7:31,10,70000,1046,79,1125
9/20/2013 7:31,10,70000,1056,75,1131
9/20/2013 7:31,10,70000,62,76,138
9/20/2013 7:31,10,70000,63,74,137
9/20/2013 7:31,10,70000,1038,75,1113
9/20/2013 7:31,10,70000,66,74,140
9/20/2013 7:31,10,70000,66,73,139
9/20/2013 7:31,10,70000,68,75,143
9/20/2013 7:31,10,70000,1044,79,1123
9/20/2013 7:31,10,70000,70,73,143
9/20/2013 7:31,10,70000,62,79,141
9/20/2013 7:31,10,70000,67,81,148
9/20/2013 7:31,10,70000,70,80,150
9/20/2013 7:31,10,70000,72,76,148
9/20/2013 7:31,10,70000,72,73,145
9/20/2013 7:31,10,70000,66,74,140
9/20/2013 7:31,10,70000,61,76,137
9/20/2013 7:31,10,70000,72,76,148
9/20/2013 7:31,10,70000,69,74,143
9/20/2013 7:32,10,70000,60,74,134
9/20/2013 7:32,10,70000,61,74,135
9/20/2013 7:32,10,70000,61,78,139
9/20/2013 7:32,10,70000,55,77,132
9/20/2013 7:32,10,70000,66,79,145
9/20/2013 7:32,10,70000,75,75,150
9/20/2013 7:32,10,70000,69,79,148
9/20/2013 7:32,10,70000,67,78,145
9/20/2013 7:32,10,70000,57,80,137
9/20/2013 7:32,10,70000,56,73,129
9/20/2013 7:32,10,70000,64,73,137
9/20/2013 7:32,10,70000,69,76,145
9/20/2013 7:32,10,70000,67,79,146
9/20/2013 7:32,10,70000,71,78,149
9/20/2013 7:32,10,70000,64,75,139
9/20/2013 7:32,10,70000,60,74,134
9/20/2013 7:32,10,70000,65,75,140
9/20/2013 7:32,10,70000,68,75,143
9/20/2013 7:32,10,70000,63,74,137
9/20/2013 7:32,10,70000,66,77,143
9/20/2013 7:32,10,70000,68,76,144
9/20/2013 7:32,10,70000,61,76,137
9/20/2013 7:32,10,70000,74,80,154
9/20/2013 7:32,10,70000,59,74,133
9/20/2013 7:32,10,70000,59,73,132
9/20/2013 7:32,10,70000,65,73,138
9/20/2013 7:32,10,70000,63,75,138
9/20/2013 7:32,10,70000,59,79,138
9/20/2013 7:32,10,70000,65,79,144
9/20/2013 7:32,10,70000,73,76,149
9/20/2013 7:33,10,80000,68,76,144
9/20/2013 7:33,10,80000,70,77,147
9/20/2013 7:33,10,80000,65,76,141
9/20/2013 7:33,10,80000,85,84,169
9/20/2013 7:33,10,80000,1057,82,1139
9/20/2013 7:33,10,80000,77,75,152
9/20/2013 7:33,10,80000,69,78,147
9/20/2013 7:33,10,80000,73,87,160
9/20/2013 7:33,10,80000,62,82,144
9/20/2013 7:33,10,80000,63,80,143
9/20/2013 7:33,10,80000,77,77,154
9/20/2013 7:33,10,80000,69,79,148
9/20/2013 7:33,10,80000,68,78,146
9/20/2013 7:33,10,80000,65,78,143
9/20/2013 7:33,10,80000,70,78,148
9/20/2013 7:33,10,80000,78,78,156
9/20/2013 7:33,10,80000,68,81,149
9/20/2013 7:33,10,80000,66,78,144
9/20/2013 7:33,10,80000,1046,80,1126
9/20/2013 7:33,10,80000,65,82,147
9/20/2013 7:33,10,80000,70,75,145
9/20/2013 7:33,10,80000,62,77,139
9/20/2013 7:33,10,80000,69,80,149
9/20/2013 7:33,10,80000,71,83,154
9/20/2013 7:33,10,80000,1035,82,1117
9/20/2013 7:33,10,80000,61,79,140
9/20/2013 7:34,10,80000,1050,79,1129
9/20/2013 7:34,10,80000,1059,84,1143
9/20/2013 7:34,10,80000,69,85,154
9/20/2013 7:34,10,80000,64,81,145
9/20/2013 7:34,10,80000,65,79,144
9/20/2013 7:34,10,80000,85,81,166
9/20/2013 7:34,10,80000,1057,81,1138
9/20/2013 7:34,10,80000,68,82,150
9/20/2013 7:34,10,80000,67,79,146
9/20/2013 7:34,10,80000,88,82,170
9/20/2013 7:34,10,80000,65,79,144
9/20/2013 7:34,10,80000,78,83,161
9/20/2013 7:34,10,80000,63,76,139
9/20/2013 7:34,10,80000,72,77,149
9/20/2013 7:34,10,80000,68,75,143
9/20/2013 7:34,10,80000,59,78,137
9/20/2013 7:34,10,80000,70,75,145
9/20/2013 7:34,10,80000,63,76,139
9/20/2013 7:34,10,80000,63,75,138
9/20/2013 7:34,10,80000,79,76,155
9/20/2013 7:34,10,80000,73,87,160
9/20/2013 7:34,10,80000,67,79,146
9/20/2013 7:34,10,80000,1055,79,1134
9/20/2013 7:34,10,80000,66,80,146
9/20/2013 7:34,10,80000,63,78,141
9/20/2013 7:34,10,80000,74,81,155
9/20/2013 7:35,10,80000,66,78,144
9/20/2013 7:35,10,80000,62,77,139
9/20/2013 7:35,10,80000,72,88,160
9/20/2013 7:35,10,80000,71,76,147
9/20/2013 7:35,10,80000,60,77,137
9/20/2013 7:35,10,80000,70,81,151
9/20/2013 7:35,10,80000,69,78,147
9/20/2013 7:35,10,80000,62,75,137
9/20/2013 7:35,10,80000,55,79,134
9/20/2013 7:35,10,80000,65,77,142
9/20/2013 7:35,10,80000,71,83,154
9/20/2013 7:35,10,80000,64,80,144
9/20/2013 7:35,10,80000,69,81,150
9/20/2013 7:35,10,80000,64,75,139
9/20/2013 7:35,10,80000,76,86,162
9/20/2013 7:35,10,80000,76,79,155
9/20/2013 7:35,10,80000,75,82,157
9/20/2013 7:35,10,80000,71,76,147
9/20/2013 7:35,10,80000,70,78,148
9/20/2013 7:35,10,80000,61,81,142
9/20/2013 7:35,10,80000,69,78,147
9/20/2013 7:35,10,80000,1045,81,1126
9/20/2013 7:35,10,80000,73,79,152
9/20/2013 7:35,10,80000,1052,78,1130
9/20/2013 7:35,10,80000,1056,83,1139
9/20/2013 7:36,10,80000,68,82,150
9/20/2013 7:36,10,80000,74,75,149
9/20/2013 7:36,10,80000,1048,80,1128
9/20/2013 7:36,10,80000,66,78,144
9/20/2013 7:36,10,80000,63,79,142
9/20/2013 7:36,10,80000,68,76,144
9/20/2013 7:36,10,80000,65,79,144
9/20/2013 7:36,10,80000,68,76,144
9/20/2013 7:36,10,80000,65,78,143
9/20/2013 7:36,10,80000,68,77,145
9/20/2013 7:36,10,80000,64,78,142
9/20/2013 7:36,10,80000,63,75,138
9/20/2013 7:36,10,80000,64,75,139
9/20/2013 7:36,10,80000,66,83,149
9/20/2013 7:36,10,80000,70,90,160
9/20/2013 7:36,10,80000,1044,84,1128
9/20/2013 7:36,10,80000,69,77,146
9/20/2013 7:36,10,80000,64,83,147
9/20/2013 7:36,10,80000,68,84,152
9/20/2013 7:36,10,80000,63,81,144
9/20/2013 7:36,10,80000,65,79,144
9/20/2013 7:36,10,80000,66,78,144
9/20/2013 7:36,10,80000,68,80,148
9/20/2013 7:36,10,80000,71,79,150
9/20/2013 7:36,10,80000,70,83,153
9/20/2013 7:36,10,80000,63,79,142
9/20/2013 7:36,10,80000,72,76,148
9/20/2013 7:36,10,80000,88,81,169
9/20/2013 7:36,10,80000,58,79,137
9/20/2013 7:37,10,80000,78,79,157
9/20/2013 7:37,10,80000,67,81,148
9/20/2013 7:37,10,80000,79,82,161
9/20/2013 7:37,10,80000,67,82,149
9/20/2013 7:37,10,80000,69,85,154
9/20/2013 7:37,10,80000,59,76,135
9/20/2013 7:37,10,80000,67,77,144
9/20/2013 7:37,10,80000,88,75,163
9/20/2013 7:37,10,80000,63,76,139
9/20/2013 7:37,10,90000,1059,81,1140
9/20/2013 7:37,10,90000,73,82,155
9/20/2013 7:37,10,90000,1055,81,1136
9/20/2013 7:37,10,90000,70,89,159
9/20/2013 7:37,10,90000,59,84,143
9/20/2013 7:37,10,90000,78,81,159
9/20/2013 7:37,10,90000,67,83,150
9/20/2013 7:37,10,90000,1052,83,1135
9/20/2013 7:37,10,90000,89,80,169
9/20/2013 7:37,10,90000,69,80,149
9/20/2013 7:37,10,90000,63,82,145
9/20/2013 7:37,10,90000,64,77,141
9/20/2013 7:37,10,90000,77,82,159
9/20/2013 7:37,10,90000,1037,81,1118
9/20/2013 7:37,10,90000,76,80,156
9/20/2013 7:37,10,90000,80,83,163
9/20/2013 7:38,10,90000,72,80,152
9/20/2013 7:38,10,90000,86,84,170
9/20/2013 7:38,10,90000,70,84,154
9/20/2013 7:38,10,90000,1037,79,1116
9/20/2013 7:38,10,90000,71,78,149
9/20/2013 7:38,10,90000,71,81,152
9/20/2013 7:38,10,90000,78,85,163
9/20/2013 7:38,10,90000,68,80,148
9/20/2013 7:38,10,90000,66,82,148
9/20/2013 7:38,10,90000,71,77,148
9/20/2013 7:38,10,90000,69,78,147
9/20/2013 7:38,10,90000,62,83,145
9/20/2013 7:38,10,90000,70,80,150
9/20/2013 7:38,10,90000,62,79,141
9/20/2013 7:38,10,90000,74,83,157
9/20/2013 7:38,10,90000,65,78,143
9/20/2013 7:38,10,90000,74,84,158
9/20/2013 7:38,10,90000,83,80,163
9/20/2013 7:38,10,90000,62,79,141
9/20/2013 7:38,10,90000,1057,82,1139
9/20/2013 7:38,10,90000,71,80,151
9/20/2013 7:38,10,90000,75,89,164
9/20/2013 7:38,10,90000,71,78,149
9/20/2013 7:38,10,90000,1058,80,1138
9/20/2013 7:38,10,90000,91,89,180
9/20/2013 7:39,10,90000,72,85,157
9/20/2013 7:39,10,90000,73,81,154
9/20/2013 7:39,10,90000,71,84,155
9/20/2013 7:39,10,90000,72,78,150
9/20/2013 7:39,10,90000,74,82,156
9/20/2013 7:39,10,90000,73,83,156
9/20/2013 7:39,10,90000,72,87,159
9/20/2013 7:39,10,90000,68,79,147
9/20/2013 7:39,10,90000,71,88,159
9/20/2013 7:39,10,90000,67,80,147
9/20/2013 7:39,10,90000,70,86,156
9/20/2013 7:39,10,90000,75,80,155
9/20/2013 7:39,10,90000,61,82,143
9/20/2013 7:39,10,90000,74,77,151
9/20/2013 7:39,10,90000,71,80,151
9/20/2013 7:39,10,90000,63,80,143
9/20/2013 7:39,10,90000,67,78,145
9/20/2013 7:39,10,90000,64,85,149
9/20/2013 7:39,10,90000,64,83,147
9/20/2013 7:39,10,90000,76,80,156
9/20/2013 7:39,10,90000,69,78,147
9/20/2013 7:39,10,90000,71,77,148
9/20/2013 7:39,10,90000,92,85,177
9/20/2013 7:39,10,90000,66,78,144
9/20/2013 7:39,10,90000,70,81,151
9/20/2013 7:39,10,90000,71,85,156
9/20/2013 7:39,10,90000,64,83,147
9/20/2013 7:39,10,90000,71,82,153
9/20/2013 7:40,10,90000,72,79,151
9/20/2013 7:40,10,90000,61,80,141
9/20/2013 7:40,10,90000,63,88,151
9/20/2013 7:40,10,90000,69,80,149
9/20/2013 7:40,10,90000,70,80,150
9/20/2013 7:40,10,90000,84,84,168
9/20/2013 7:40,10,90000,68,82,150
9/20/2013 7:40,10,90000,69,87,156
9/20/2013 7:40,10,90000,66,78,144
9/20/2013 7:40,10,90000,1065,84,1149
9/20/2013 7:40,10,90000,76,81,157
9/20/2013 7:40,10,90000,78,78,156
9/20/2013 7:40,10,90000,74,81,155
9/20/2013 7:40,10,90000,72,79,151
9/20/2013 7:40,10,90000,67,78,145
9/20/2013 7:40,10,90000,69,83,152
9/20/2013 7:40,10,90000,78,86,164
9/20/2013 7:40,10,90000,98,83,181
9/20/2013 7:40,10,90000,71,81,152
9/20/2013 7:40,10,90000,64,81,145
9/20/2013 7:40,10,90000,75,77,152
9/20/2013 7:40,10,90000,70,79,149
9/20/2013 7:40,10,90000,90,82,172
9/20/2013 7:40,10,90000,63,83,146
9/20/2013 7:40,10,90000,59,77,136
9/20/2013 7:40,10,90000,1066,83,1149
9/20/2013 7:40,10,90000,69,79,148
9/20/2013 7:40,10,90000,69,81,150
9/20/2013 7:41,10,90000,1070,84,1154
9/20/2013 7:41,10,90000,78,93,171
9/20/2013 7:41,10,90000,70,83,153
9/20/2013 7:41,10,90000,75,82,157
9/20/2013 7:41,10,90000,74,79,153
9/20/2013 7:41,10,90000,1053,83,1136
9/20/2013 7:41,10,90000,1061,81,1142
9/20/2013 7:41,10,90000,65,78,143
9/20/2013 7:41,10,90000,58,80,138
9/20/2013 7:41,10,90000,69,79,148
9/20/2013 7:41,10,90000,67,80,147
9/20/2013 7:41,10,90000,63,80,143
9/20/2013 7:41,10,90000,69,77,146
9/20/2013 7:41,10,90000,76,80,156
9/20/2013 7:41,10,90000,74,82,156
9/20/2013 7:41,10,90000,74,84,158
9/20/2013 7:41,10,90000,63,81,144
9/20/2013 7:41,10,90000,68,82,150
9/20/2013 7:41,10,100000,72,88,160
9/20/2013 7:41,10,100000,76,86,162
9/20/2013 7:41,10,100000,67,83,150
9/20/2013 7:41,10,100000,77,85,162
9/20/2013 7:41,10,100000,68,92,160
9/20/2013 7:41,10,100000,68,83,151
9/20/2013 7:41,10,100000,65,91,156
9/20/2013 7:41,10,100000,67,87,154
9/20/2013 7:41,10,100000,66,96,162
9/20/2013 7:42,10,100000,66,86,152
9/20/2013 7:42,10,100000,74,87,161
9/20/2013 7:42,10,100000,68,85,153
9/20/2013 7:42,10,100000,64,94,158
9/20/2013 7:42,10,100000,67,88,155
9/20/2013 7:42,10,100000,68,84,152
9/20/2013 7:42,10,100000,92,88,180
9/20/2013 7:42,10,100000,90,87,177
9/20/2013 7:42,10,100000,60,89,149
9/20/2013 7:42,10,100000,74,84,158
9/20/2013 7:42,10,100000,69,85,154
9/20/2013 7:42,10,100000,1066,87,1153
9/20/2013 7:42,10,100000,1062,85,1147
9/20/2013 7:42,10,100000,68,86,154
9/20/2013 7:42,10,100000,64,85,149
9/20/2013 7:42,10,100000,77,85,162
9/20/2013 7:42,10,100000,1063,90,1153
9/20/2013 7:42,10,100000,80,83,163
9/20/2013 7:42,10,100000,89,91,180
9/20/2013 7:42,10,100000,72,86,158
9/20/2013 7:42,10,100000,1076,90,1166
9/20/2013 7:42,10,100000,72,84,156
9/20/2013 7:42,10,100000,74,87,161
9/20/2013 7:42,10,100000,84,93,177
9/20/2013 7:42,10,100000,78,89,167
9/20/2013 7:43,10,100000,80,88,168
9/20/2013 7:43,10,100000,68,89,157
9/20/2013 7:43,10,100000,77,83,160
9/20/2013 7:43,10,100000,1070,87,1157
9/20/2013 7:43,10,100000,72,85,157
9/20/2013 7:43,10,100000,63,85,148
9/20/2013 7:43,10,100000,66,91,157
9/20/2013 7:43,10,100000,69,84,153
9/20/2013 7:43,10,100000,64,88,152
9/20/2013 7:43,10,100000,75,87,162
9/20/2013 7:43,10,100000,74,86,160
9/20/2013 7:43,10,100000,82,87,169
9/20/2013 7:43,10,100000,77,87,164
9/20/2013 7:43,10,100000,1066,89,1155
9/20/2013 7:43,10,100000,64,89,153
9/20/2013 7:43,10,100000,73,86,159
9/20/2013 7:43,10,100000,73,90,163
9/20/2013 7:43,10,100000,73,86,159
9/20/2013 7:43,10,100000,63,85,148
9/20/2013 7:43,10,100000,77,91,168
9/20/2013 7:43,10,100000,79,84,163
9/20/2013 7:43,10,100000,66,86,152
9/20/2013 7:43,10,100000,69,84,153
9/20/2013 7:43,10,100000,90,101,191
9/20/2013 7:43,10,100000,70,87,157
9/20/2013 7:43,10,100000,64,87,151
9/20/2013 7:43,10,100000,75,87,162
9/20/2013 7:44,10,100000,79,92,171
9/20/2013 7:44,10,100000,100,92,192
9/20/2013 7:44,10,100000,69,87,156
9/20/2013 7:44,10,100000,68,85,153
9/20/2013 7:44,10,100000,68,87,155
9/20/2013 7:44,10,100000,76,85,161
9/20/2013 7:44,10,100000,63,85,148
9/20/2013 7:44,10,100000,71,89,160
9/20/2013 7:44,10,100000,70,88,158
9/20/2013 7:44,10,100000,66,85,151
9/20/2013 7:44,10,100000,67,85,152
9/20/2013 7:44,10,100000,74,88,162
9/20/2013 7:44,10,100000,68,89,157
9/20/2013 7:44,10,100000,77,86,163
9/20/2013 7:44,10,100000,73,85,158
9/20/2013 7:44,10,100000,68,84,152
9/20/2013 7:44,10,100000,81,93,174
9/20/2013 7:44,10,100000,70,87,157
9/20/2013 7:44,10,100000,79,86,165
9/20/2013 7:44,10,100000,73,85,158
9/20/2013 7:44,10,100000,70,88,158
9/20/2013 7:44,10,100000,77,91,168
9/20/2013 7:44,10,100000,1070,90,1160
9/20/2013 7:44,10,100000,64,83,147
9/20/2013 7:44,10,100000,76,92,168
9/20/2013 7:44,10,100000,1062,88,1150
9/20/2013 7:44,10,100000,69,84,153
9/20/2013 7:45,10,100000,1070,89,1159
9/20/2013 7:45,10,100000,1066,88,1154
9/20/2013 7:45,10,100000,72,88,160
9/20/2013 7:45,10,100000,74,84,158
9/20/2013 7:45,10,100000,1052,89,1141
9/20/2013 7:45,10,100000,67,86,153
9/20/2013 7:45,10,100000,71,86,157
9/20/2013 7:45,10,100000,80,83,163
9/20/2013 7:45,10,100000,72,87,159
9/20/2013 7:45,10,100000,72,85,157
9/20/2013 7:45,10,100000,68,92,160
9/20/2013 7:45,10,100000,83,88,171
9/20/2013 7:45,10,100000,67,87,154
9/20/2013 7:45,10,100000,69,87,156
9/20/2013 7:45,10,100000,72,84,156
9/20/2013 7:45,10,100000,79,83,162
9/20/2013 7:45,10,100000,85,89,174
9/20/2013 7:45,10,100000,1048,90,1138
9/20/2013 7:45,10,100000,84,87,171
9/20/2013 7:45,10,100000,66,86,152
9/20/2013 7:45,10,100000,71,87,158
9/20/2013 7:45,10,100000,76,88,164
9/20/2013 7:45,10,100000,75,84,159
9/20/2013 7:45,10,100000,78,85,163
9/20/2013 7:45,10,100000,76,85,161
9/20/2013 7:45,10,100000,56,88,144
9/20/2013 7:45,10,100000,76,93,169
9/20/2013 7:46,10,100000,68,88,156
9/20/2013 7:46,10,100000,66,88,154
9/20/2013 7:46,10,100000,76,86,162
9/20/2013 7:46,10,100000,74,82,156
9/20/2013 7:46,10,100000,89,86,175
9/20/2013 7:46,10,100000,1087,90,1177
9/20/2013 7:46,10,100000,78,88,166
9/20/2013 7:46,10,100000,72,83,155
9/20/2013 7:46,10,100000,79,86,165
9/20/2013 7:46,10,100000,68,86,154
9/20/2013 7:46,10,100000,76,88,164
9/20/2013 7:46,10,100000,71,90,161
9/20/2013 7:46,10,100000,1064,90,1154
9/20/2013 7:46,10,100000,73,85,158
9/20/2013 7:46,10,100000,81,89,170
9/20/2013 7:46,10,100000,71,88,159
9/20/2013 7:46,10,100000,74,84,158
9/20/2013 7:46,10,100000,66,88,154
9/20/2013 7:46,10,100000,73,87,160
9/20/2013 7:46,10,100000,70,85,155
9/20/2013 7:46,10,100000,72,86,158
9/20/2013 7:46,10,100000,76,83,159
9/20/2013 7:46,10,100000,76,84,160
9/20/2013 7:46,10,100000,75,87,162
9/20/2013 7:46,10,100000,1071,85,1156
9/20/2013 7:46,10,100000,67,84,151
9/20/2013 7:47,10,100000,75,88,163
9/20/2013 7:47,10,100000,1063,86,1149
9/20/2013 7:47,10,100000,73,84,157
9/20/2013 7:47,10,100000,84,84,168
9/20/2013 7:47,10,100000,66,84,150
9/20/2013 7:47,10,100000,1059,84,1143
9/20/2013 7:47,10,100000,72,86,158
9/20/2013 7:47,10,100000,64,89,153
9/20/2013 7:47,10,100000,68,90,158
9/20/2013 7:47,10,100000,1064,90,1154
9/20/2013 7:47,10,100000,1061,85,1146
9/20/2013 7:47,10,100000,82,84,166
9/20/2013 7:47,10,100000,59,86,145
9/20/2013 7:47,10,100000,84,84,168
9/20/2013 7:47,10,100000,66,86,152
9/20/2013 7:47,10,100000,74,87,161
9/20/2013 7:47,10,100000,81,89,170
9/20/2013 7:47,10,100000,69,86,155
9/20/2013 7:47,10,100000,69,86,155
9/20/2013 7:47,10,100000,67,89,156
9/20/2013 7:47,10,100000,70,89,159
9/20/2013 7:47,10,100000,76,87,163
9/20/2013 7:47,10,100000,75,91,166
9/20/2013 7:47,10,100000,73,86,159
9/20/2013 7:47,10,100000,74,89,163
9/20/2013 7:47,10,100000,75,86,161
9/20/2013 7:48,10,100000,1061,88,1149
9/20/2013 7:48,10,100000,94,89,183
9/20/2013 7:48,10,100000,70,89,159
9/20/2013 7:48,10,100000,69,89,158
9/20/2013 7:48,10,100000,72,85,157
9/20/2013 7:48,10,100000,1065,90,1155
9/20/2013 7:48,10,100000,67,84,151
9/20/2013 7:48,10,100000,64,90,154
9/20/2013 7:48,10,100000,83,83,166
9/20/2013 7:48,10,100000,73,94,167
9/20/2013 7:48,10,100000,73,86,159
9/20/2013 7:48,10,100000,74,83,157
9/20/2013 7:48,10,100000,1057,89,1146
9/20/2013 7:48,10,100000,88,87,175
9/20/2013 7:48,10,100000,69,87,156
9/20/2013 7:48,10,100000,77,90,167
9/20/2013 7:48,10,100000,77,88,165
9/20/2013 7:48,10,100000,68,85,153
9/20/2013 7:48,10,100000,1062,91,1153
9/20/2013 7:48,10,100000,84,84,168
9/20/2013 7:48,10,100000,1052,84,1136
9/20/2013 7:48,10,100000,1053,86,1139
9/20/2013 7:48,10,100000,75,89,164
9/20/2013 7:48,10,100000,78,91,169
9/20/2013 7:48,10,100000,73,82,155
9/20/2013 7:48,10,100000,80,86,166
9/20/2013 7:49,10,100000,81,85,166
9/20/2013 7:49,10,100000,70,82,152
9/20/2013 7:49,10,100000,67,88,155
9/20/2013 7:49,10,100000,80,84,164
9/20/2013 7:49,10,100000,77,89,166
9/20/2013 7:49,10,100000,71,94,165
9/20/2013 7:49,10,100000,59,87,146
9/20/2013 7:49,10,100000,76,88,164
9/20/2013 7:49,10,100000,1053,87,1140
9/20/2013 7:49,10,100000,63,88,151
9/20/2013 7:49,10,100000,78,86,164
9/20/2013 7:49,10,100000,85,89,174
9/20/2013 7:49,10,100000,1055,87,1142
9/20/2013 7:49,10,100000,73,92,165
9/20/2013 7:49,10,100000,1051,86,1137
9/20/2013 7:49,10,100000,1067,90,1157
9/20/2013 7:49,10,100000,80,84,164
9/20/2013 7:49,10,100000,72,87,159
9/20/2013 7:49,10,100000,60,87,147
9/20/2013 7:49,10,100000,1061,90,1151
9/20/2013 7:49,10,100000,76,86,162
9/20/2013 7:49,10,100000,64,89,153
9/20/2013 7:49,10,100000,75,83,158
9/20/2013 7:49,10,100000,76,85,161
9/20/2013 7:49,10,100000,69,87,156
9/20/2013 7:50,10,100000,70,83,153
9/20/2013 7:50,10,100000,1068,88,1156
9/20/2013 7:50,10,100000,61,86,147
9/20/2013 7:50,10,100000,89,91,180
9/20/2013 7:50,10,100000,61,88,149
9/20/2013 7:50,10,100000,74,90,164
9/20/2013 7:50,10,100000,68,90,158
9/20/2013 7:50,10,100000,67,87,154
9/20/2013 7:50,10,100000,72,84,156
9/20/2013 7:50,10,100000,72,88,160
9/20/2013 7:50,10,100000,70,87,157
9/20/2013 7:50,10,100000,78,93,171
9/20/2013 7:50,10,200000,87,113,200
9/20/2013 7:50,10,200000,91,106,197
9/20/2013 7:50,10,200000,101,114,215
9/20/2013 7:50,10,200000,98,106,204
9/20/2013 7:50,10,200000,97,109,206
9/20/2013 7:50,10,200000,103,105,208
9/20/2013 7:50,10,200000,110,107,217
9/20/2013 7:50,10,200000,1086,109,1195
9/20/2013 7:50,10,200000,93,105,198
9/20/2013 7:50,10,200000,93,110,203
9/20/2013 7:50,10,200000,115,106,221
9/20/2013 7:50,10,200000,95,111,206
9/20/2013 7:50,10,200000,99,103,202
9/20/2013 7:50,10,200000,110,112,222
9/20/2013 7:51,10,200000,103,110,213
9/20/2013 7:51,10,200000,97,108,205
9/20/2013 7:51,10,200000,104,103,207
9/20/2013 7:51,10,200000,88,105,193
9/20/2013 7:51,10,200000,104,110,214
9/20/2013 7:51,10,200000,107,110,217
9/20/2013 7:51,10,200000,99,104,203
9/20/2013 7:51,10,200000,101,107,208
9/20/2013 7:51,10,200000,1098,112,1210
9/20/2013 7:51,10,200000,101,108,209
9/20/2013 7:51,10,200000,102,107,209
9/20/2013 7:51,10,200000,117,104,221
9/20/2013 7:51,10,200000,1054,110,1164
9/20/2013 7:51,10,200000,103,111,214
9/20/2013 7:51,10,200000,103,107,210
9/20/2013 7:51,10,200000,123,105,228
9/20/2013 7:51,10,200000,107,108,215
9/20/2013 7:51,10,200000,100,106,206
9/20/2013 7:51,10,200000,101,106,207
9/20/2013 7:51,10,200000,92,104,196
9/20/2013 7:51,10,200000,92,108,200
9/20/2013 7:51,10,200000,1082,107,1189
9/20/2013 7:51,10,200000,89,108,197
9/20/2013 7:51,10,200000,1076,107,1183
9/20/2013 7:52,10,200000,93,107,200
9/20/2013 7:52,10,200000,99,109,208
9/20/2013 7:52,10,200000,97,105,202
9/20/2013 7:52,10,200000,115,106,221
9/20/2013 7:52,10,200000,106,109,215
9/20/2013 7:52,10,200000,97,108,205
9/20/2013 7:52,10,200000,98,107,205
9/20/2013 7:52,10,200000,91,108,199
9/20/2013 7:52,10,200000,105,107,212
9/20/2013 7:52,10,200000,119,107,226
9/20/2013 7:52,10,200000,86,108,194
9/20/2013 7:52,10,200000,122,111,233
9/20/2013 7:52,10,200000,107,111,218
9/20/2013 7:52,10,200000,1073,107,1180
9/20/2013 7:52,10,200000,91,110,201
9/20/2013 7:52,10,200000,95,111,206
9/20/2013 7:52,10,200000,1073,104,1177
9/20/2013 7:52,10,200000,1076,110,1186
9/20/2013 7:52,10,200000,86,105,191
9/20/2013 7:52,10,200000,96,104,200
9/20/2013 7:52,10,200000,91,109,200
9/20/2013 7:52,10,200000,113,103,216
9/20/2013 7:52,10,200000,97,109,206
9/20/2013 7:52,10,200000,94,109,203
9/20/2013 7:53,10,200000,108,105,213
9/20/2013 7:53,10,200000,1079,109,1188
9/20/2013 7:53,10,200000,105,109,214
9/20/2013 7:53,10,200000,100,106,206
9/20/2013 7:53,10,200000,99,103,202
9/20/2013 7:53,10,200000,92,109,201
9/20/2013 7:53,10,200000,91,107,198
9/20/2013 7:53,10,200000,96,106,202
9/20/2013 7:53,10,200000,107,105,212
9/20/2013 7:53,10,200000,95,108,203
9/20/2013 7:53,10,200000,89,108,197
9/20/2013 7:53,10,200000,88,112,200
9/20/2013 7:53,10,200000,105,118,223
9/20/2013 7:53,10,200000,103,111,214
9/20/2013 7:53,10,200000,103,104,207
9/20/2013 7:53,10,200000,79,106,185
9/20/2013 7:53,10,200000,106,111,217
9/20/2013 7:53,10,200000,116,112,228
9/20/2013 7:53,10,200000,103,109,212
9/20/2013 7:53,10,200000,86,106,192
9/20/2013 7:53,10,200000,91,105,196
9/20/2013 7:53,10,200000,88,106,194
9/20/2013 7:53,10,200000,101,110,211
9/20/2013 7:53,10,200000,110,113,223
9/20/2013 7:53,10,200000,116,107,223
9/20/2013 7:54,10,200000,84,106,190
9/20/2013 7:54,10,200000,124,117,241
9/20/2013 7:54,10,200000,88,109,197
9/20/2013 7:54,10,200000,1087,112,1199
9/20/2013 7:54,10,200000,112,106,218
9/20/2013 7:54,10,200000,111,109,220
9/20/2013 7:54,10,200000,97,110,207
9/20/2013 7:54,10,200000,89,105,194
9/20/2013 7:54,10,200000,1075,111,1186
9/20/2013 7:54,10,200000,107,111,218
9/20/2013 7:54,10,200000,118,107,225
9/20/2013 7:54,10,200000,111,108,219
9/20/2013 7:54,10,200000,95,111,206
9/20/2013 7:54,10,200000,116,108,224
9/20/2013 7:54,10,200000,125,103,228
9/20/2013 7:54,10,200000,109,106,215
9/20/2013 7:54,10,200000,100,105,205
9/20/2013 7:54,10,200000,105,116,221
9/20/2013 7:54,10,200000,104,111,215
9/20/2013 7:54,10,200000,91,109,200
9/20/2013 7:54,10,200000,92,107,199
9/20/2013 7:54,10,200000,84,111,195
9/20/2013 7:54,10,200000,103,113,216
9/20/2013 7:54,10,200000,110,107,217
9/20/2013 7:54,10,200000,106,104,210
9/20/2013 7:54,10,200000,97,112,209
9/20/2013 7:55,10,200000,97,107,204
9/20/2013 7:55,10,200000,103,112,215
9/20/2013 7:55,10,300000,1114,140,1254
9/20/2013 7:55,10,300000,100,127,227
9/20/2013 7:55,10,300000,104,133,237
9/20/2013 7:55,10,300000,108,128,236
9/20/2013 7:55,10,300000,116,135,251
9/20/2013 7:55,10,300000,116,132,248
9/20/2013 7:55,10,300000,102,132,234
9/20/2013 7:55,10,300000,123,132,255
9/20/2013 7:55,10,300000,139,134,273
9/20/2013 7:55,10,300000,121,134,255
9/20/2013 7:55,10,300000,1094,136,1230
9/20/2013 7:55,10,300000,99,129,228
9/20/2013 7:55,10,300000,127,130,257
9/20/2013 7:55,10,300000,103,139,242
9/20/2013 7:55,10,300000,1101,130,1231
9/20/2013 7:55,10,300000,1089,129,1218
9/20/2013 7:55,10,300000,134,132,266
9/20/2013 7:55,10,300000,107,136,243
9/20/2013 7:55,10,300000,125,131,256
9/20/2013 7:55,10,300000,140,137,277
9/20/2013 7:55,10,300000,119,129,248
9/20/2013 7:55,10,300000,130,130,260
9/20/2013 7:56,10,300000,117,133,250
9/20/2013 7:56,10,300000,135,134,269
9/20/2013 7:56,10,300000,115,141,256
9/20/2013 7:56,10,300000,137,137,274
9/20/2013 7:56,10,300000,121,132,253
9/20/2013 7:56,10,300000,120,138,258
9/20/2013 7:56,10,300000,128,131,259
9/20/2013 7:56,10,300000,120,134,254
9/20/2013 7:56,10,300000,112,135,247
9/20/2013 7:56,10,300000,114,127,241
9/20/2013 7:56,10,300000,122,136,258
9/20/2013 7:56,10,300000,138,132,270
9/20/2013 7:56,10,300000,119,128,247
9/20/2013 7:56,10,300000,121,133,254
9/20/2013 7:56,10,300000,111,133,244
9/20/2013 7:56,10,300000,125,132,257
9/20/2013 7:56,10,300000,138,139,277
9/20/2013 7:56,10,300000,107,131,238
9/20/2013 7:56,10,300000,112,136,248
9/20/2013 7:56,10,300000,130,133,263
9/20/2013 7:56,10,300000,123,131,254
9/20/2013 7:56,10,300000,142,132,274
9/20/2013 7:56,10,300000,1084,133,1217
9/20/2013 7:56,10,300000,1107,136,1243
9/20/2013 7:56,10,300000,103,129,232
9/20/2013 7:56,10,300000,107,133,240
9/20/2013 7:57,10,300000,1097,130,1227
9/20/2013 7:57,10,300000,137,126,263
9/20/2013 7:57,10,300000,104,132,236
9/20/2013 8:13,10,300000,112,133,245
9/20/2013 8:13,10,300000,105,131,236
9/20/2013 8:13,10,300000,1097,135,1232
9/20/2013 8:13,10,300000,110,130,240
9/20/2013 8:14,10,300000,119,133,252
9/20/2013 8:14,10,300000,111,128,239
9/20/2013 8:14,10,300000,110,128,238
9/20/2013 8:14,10,300000,118,127,245
9/20/2013 8:14,10,300000,111,129,240
9/20/2013 8:14,10,300000,1103,143,1246
9/20/2013 8:14,10,300000,114,130,244
9/20/2013 8:14,10,300000,118,135,253
9/20/2013 8:14,10,300000,118,131,249
9/20/2013 8:14,10,300000,1109,137,1246
9/20/2013 8:14,10,300000,120,134,254
9/20/2013 8:14,10,300000,114,132,246
9/20/2013 8:14,10,300000,111,131,242
9/20/2013 8:14,10,300000,117,131,248
9/20/2013 8:14,10,300000,1089,137,1226
9/20/2013 8:14,10,300000,114,132,246
9/20/2013 8:14,10,300000,111,133,244
9/20/2013 8:14,10,300000,1108,140,1248
9/20/2013 8:14,10,300000,1099,133,1232
9/20/2013 8:14,10,300000,116,131,247
9/20/2013 8:14,10,300000,115,134,249
9/20/2013 8:14,10,300000,128,130,258
9/20/2013 8:14,10,300000,1101,136,1237
9/20/2013 8:14,10,300000,114,130,244
9/20/2013 8:14,10,300000,109,132,241
9/20/2013 8:15,10,300000,121,135,256
9/20/2013 8:15,10,300000,104,132,236
9/20/2013 8:15,10,300000,110,132,242
9/20/2013 8:15,10,300000,129,134,263
9/20/2013 8:15,10,300000,1105,133,1238
9/20/2013 8:15,10,300000,1098,133,1231
9/20/2013 8:15,10,300000,125,127,252
9/20/2013 8:15,10,300000,109,130,239
9/20/2013 8:15,10,300000,127,135,262
9/20/2013 8:15,10,300000,155,132,287
9/20/2013 8:15,10,300000,115,135,250
9/20/2013 8:15,10,300000,1118,133,1251
9/20/2013 8:15,10,300000,117,153,270
9/20/2013 8:15,10,300000,113,137,250
9/20/2013 8:15,10,300000,101,138,239
9/20/2013 8:15,10,300000,148,126,274
9/20/2013 8:15,10,300000,111,133,244
9/20/2013 8:15,10,300000,99,134,233
9/20/2013 8:15,10,300000,1094,129,1223
9/20/2013 8:15,10,300000,1084,137,1221
9/20/2013 8:15,10,300000,112,131,243
9/20/2013 8:15,10,300000,107,131,238
9/20/2013 8:15,10,300000,1079,132,1211
9/20/2013 8:15,10,300000,132,141,273
9/20/2013 8:16,10,300000,130,131,261
9/20/2013 8:16,10,300000,1089,137,1226
9/20/2013 8:16,10,300000,93,134,227
9/20/2013 8:16,10,300000,114,132,246
9/20/2013 8:16,10,300000,117,132,249
9/20/2013 8:16,10,300000,109,132,241
9/20/2013 8:16,10,300000,114,135,249
9/20/2013 8:16,10,300000,130,138,268
9/20/2013 8:16,10,300000,111,133,244
9/20/2013 8:16,10,300000,1102,134,1236
9/20/2013 8:16,10,400000,1107,153,1260
9/20/2013 8:16,10,400000,162,158,320
9/20/2013 8:16,10,400000,1143,154,1297
9/20/2013 8:16,10,400000,139,150,289
9/20/2013 8:16,10,400000,147,153,300
9/20/2013 8:16,10,400000,147,188,335
9/20/2013 8:16,10,400000,117,149,266
9/20/2013 8:16,10,400000,175,150,325
9/20/2013 8:16,10,400000,134,154,288
9/20/2013 8:16,10,400000,166,151,317
9/20/2013 8:16,10,400000,116,152,268
9/20/2013 8:16,10,400000,131,157,288
9/20/2013 8:16,10,400000,131,153,284
9/20/2013 8:16,10,400000,130,151,281
9/20/2013 8:16,10,400000,132,151,283
9/20/2013 8:16,10,400000,135,156,291
9/20/2013 8:17,10,400000,175,153,328
9/20/2013 8:17,10,400000,126,154,280
9/20/2013 8:17,10,400000,124,182,306
9/20/2013 8:17,10,400000,136,154,290
9/20/2013 8:17,10,400000,118,147,265
9/20/2013 8:17,10,400000,137,153,290
9/20/2013 8:17,10,400000,119,150,269
9/20/2013 8:17,10,400000,117,154,271
9/20/2013 8:17,10,400000,149,151,300
9/20/2013 8:17,10,400000,108,189,297
9/20/2013 8:17,10,400000,146,150,296
9/20/2013 8:17,10,400000,158,151,309
9/20/2013 8:17,10,400000,151,149,300
9/20/2013 8:17,10,400000,144,152,296
9/20/2013 8:17,10,400000,125,153,278
9/20/2013 8:17,10,400000,154,153,307
9/20/2013 8:17,10,400000,112,146,258
9/20/2013 8:17,10,400000,133,149,282
9/20/2013 8:17,10,400000,160,154,314
9/20/2013 8:17,10,400000,111,152,263
9/20/2013 8:17,10,400000,140,152,292
9/20/2013 8:17,10,400000,133,185,318
9/20/2013 8:17,10,400000,135,188,323
9/20/2013 8:17,10,400000,113,158,271
9/20/2013 8:17,10,400000,146,187,333
9/20/2013 8:17,10,400000,182,148,330
9/20/2013 8:17,10,400000,150,149,299
9/20/2013 8:18,10,400000,109,190,299
9/20/2013 8:18,10,400000,139,186,325
9/20/2013 8:18,10,400000,163,157,320
9/20/2013 8:18,10,400000,134,152,286
9/20/2013 8:18,10,400000,128,155,283
9/20/2013 8:18,10,400000,131,151,282
9/20/2013 8:18,10,400000,141,153,294
9/20/2013 8:18,10,400000,134,151,285
9/20/2013 8:18,10,400000,134,150,284
9/20/2013 8:18,10,400000,135,150,285
9/20/2013 8:18,10,400000,109,158,267
9/20/2013 8:18,10,400000,105,183,288
9/20/2013 8:18,10,400000,130,151,281
9/20/2013 8:18,10,400000,167,149,316
9/20/2013 8:18,10,400000,133,149,282
9/20/2013 8:18,10,400000,166,154,320
9/20/2013 8:18,10,400000,119,160,279
9/20/2013 8:18,10,400000,143,149,292
9/20/2013 8:18,10,400000,99,153,252
9/20/2013 8:18,10,400000,171,155,326
9/20/2013 8:18,10,400000,104,152,256
9/20/2013 8:18,10,400000,115,188,303
9/20/2013 8:18,10,400000,137,192,329
9/20/2013 8:18,10,400000,144,151,295
9/20/2013 8:18,10,400000,148,153,301
9/20/2013 8:18,10,400000,140,155,295
9/20/2013 8:19,10,400000,142,187,329
9/20/2013 8:19,10,400000,1142,153,1295
9/20/2013 8:19,10,400000,134,156,290
9/20/2013 8:19,10,400000,128,154,282
9/20/2013 8:19,10,400000,118,152,270
9/20/2013 8:19,10,400000,129,185,314
9/20/2013 8:19,10,400000,144,155,299
9/20/2013 8:19,10,400000,166,149,315
9/20/2013 8:19,10,400000,132,149,281
9/20/2013 8:19,10,400000,142,152,294
9/20/2013 8:19,10,400000,171,147,318
9/20/2013 8:19,10,400000,134,154,288
9/20/2013 8:19,10,400000,133,149,282
9/20/2013 8:19,10,400000,111,153,264
9/20/2013 8:19,10,400000,184,151,335
9/20/2013 8:19,10,400000,148,185,333
9/20/2013 8:19,10,400000,130,153,283
9/20/2013 8:19,10,400000,133,154,287
9/20/2013 8:19,10,400000,199,187,386
9/20/2013 8:19,10,400000,122,186,308
9/20/2013 8:19,10,400000,116,192,308
9/20/2013 8:19,10,400000,180,151,331
9/20/2013 8:19,10,400000,130,150,280
9/20/2013 8:19,10,400000,143,151,294
9/20/2013 8:19,10,400000,136,161,297
9/20/2013 8:19,10,400000,131,186,317
9/20/2013 8:20,10,400000,127,148,275
9/20/2013 8:20,10,400000,152,154,306
9/20/2013 8:20,10,400000,1105,163,1268
9/20/2013 8:20,10,400000,134,154,288
9/20/2013 8:20,10,400000,1084,151,1235
9/20/2013 8:20,10,400000,146,153,299
9/20/2013 8:53,10,400000,155,162,317
9/20/2013 8:53,10,400000,141,187,328
9/20/2013 8:53,10,400000,142,184,326
9/20/2013 8:53,10,400000,147,148,295
9/20/2013 8:53,10,400000,160,153,313
9/20/2013 8:53,10,400000,144,188,332
9/20/2013 8:53,10,400000,133,149,282
9/20/2013 8:53,10,400000,143,183,326
9/20/2013 8:53,10,400000,139,150,289
9/20/2013 8:54,10,400000,1124,186,1310
9/20/2013 8:54,10,400000,113,148,261
9/20/2013 8:54,10,400000,135,154,289
9/20/2013 8:54,10,400000,122,153,275
9/20/2013 8:54,10,500000,1186,175,1361
9/20/2013 8:54,10,500000,154,207,361
9/20/2013 8:54,10,500000,213,175,388
9/20/2013 8:54,10,500000,175,175,350
9/20/2013 8:54,10,500000,1163,176,1339
9/20/2013 8:54,10,500000,143,211,354
9/20/2013 8:54,10,500000,165,175,340
9/20/2013 8:54,10,500000,205,175,380
9/20/2013 8:54,10,500000,192,205,397
9/20/2013 8:54,10,500000,169,171,340
9/20/2013 8:54,10,500000,1122,210,1332
9/20/2013 8:54,10,500000,156,210,366
9/20/2013 8:54,10,500000,137,203,340
9/20/2013 8:54,10,500000,167,182,349
9/20/2013 8:54,10,500000,190,175,365
9/20/2013 8:54,10,500000,1134,208,1342
9/20/2013 8:54,10,500000,203,180,383
9/20/2013 8:54,10,500000,187,176,363
9/20/2013 8:55,10,500000,1163,172,1335
9/20/2013 8:55,10,500000,221,174,395
9/20/2013 8:55,10,500000,212,174,386
9/20/2013 8:55,10,500000,135,205,340
9/20/2013 8:55,10,500000,138,204,342
9/20/2013 8:55,10,500000,226,169,395
9/20/2013 8:55,10,500000,166,214,380
9/20/2013 8:55,10,500000,174,171,345
9/20/2013 8:55,10,500000,202,176,378
9/20/2013 8:55,10,500000,154,214,368
9/20/2013 8:55,10,500000,197,171,368
9/20/2013 8:55,10,500000,201,210,411
9/20/2013 8:55,10,500000,177,205,382
9/20/2013 8:55,10,500000,207,172,379
9/20/2013 8:55,10,500000,215,170,385
9/20/2013 8:55,10,500000,1156,171,1327
9/20/2013 8:55,10,500000,181,171,352
9/20/2013 8:55,10,500000,1137,209,1346
9/20/2013 8:55,10,500000,244,176,420
9/20/2013 8:55,10,500000,192,176,368
9/20/2013 8:55,10,500000,207,170,377
9/20/2013 8:55,10,500000,222,174,396
9/20/2013 8:55,10,500000,194,173,367
9/20/2013 8:56,10,500000,182,172,354
9/20/2013 8:56,10,500000,143,175,318
9/20/2013 8:56,10,500000,164,207,371
9/20/2013 8:56,10,500000,206,172,378
9/20/2013 8:56,10,500000,183,174,357
9/20/2013 8:56,10,500000,175,213,388
9/20/2013 8:56,10,500000,179,176,355
9/20/2013 8:56,10,500000,228,174,402
9/20/2013 8:56,10,500000,129,208,337
9/20/2013 8:56,10,500000,1157,173,1330
9/20/2013 8:56,10,500000,165,210,375
9/20/2013 8:56,10,500000,176,169,345
9/20/2013 8:56,10,500000,162,212,374
9/20/2013 8:56,10,500000,166,205,371
9/20/2013 8:56,10,500000,205,172,377
9/20/2013 8:56,10,500000,185,210,395
9/20/2013 8:56,10,500000,202,171,373
9/20/2013 8:56,10,500000,140,209,349
9/20/2013 8:56,10,500000,172,178,350
9/20/2013 8:56,10,500000,166,172,338
9/20/2013 8:56,10,500000,181,173,354
9/20/2013 8:56,10,500000,172,177,349
9/20/2013 8:56,10,500000,188,173,361
9/20/2013 8:56,10,500000,194,179,373
9/20/2013 8:56,10,500000,172,171,343
9/20/2013 8:57,10,500000,173,218,391
9/20/2013 8:57,10,500000,209,215,424
9/20/2013 8:57,10,500000,149,205,354
9/20/2013 8:57,10,500000,1107,212,1319
9/20/2013 8:57,10,500000,215,172,387
9/20/2013 8:57,10,500000,167,205,372
9/20/2013 8:57,10,500000,1136,206,1342
9/20/2013 8:57,10,500000,166,214,380
9/20/2013 8:57,10,500000,142,206,348
9/20/2013 8:57,10,500000,202,173,375
9/20/2013 8:57,10,500000,212,173,385
9/20/2013 8:57,10,500000,164,206,370
9/20/2013 8:57,10,500000,183,179,362
9/20/2013 8:57,10,500000,170,176,346
9/20/2013 8:57,10,500000,157,175,332
9/20/2013 8:57,10,500000,193,171,364
9/20/2013 8:57,10,500000,191,174,365
9/20/2013 8:57,10,500000,180,172,352
9/20/2013 8:57,10,500000,163,177,340
9/20/2013 8:57,10,500000,166,206,372
9/20/2013 8:57,10,500000,188,175,363
9/20/2013 8:57,10,500000,1123,211,1334
9/20/2013 8:57,10,500000,191,203,394
9/20/2013 8:57,10,500000,168,210,378
9/20/2013 8:58,10,500000,179,177,356
9/20/2013 8:58,10,500000,222,180,402
9/20/2013 8:58,10,500000,141,213,354
9/20/2013 8:58,10,500000,200,173,373
9/20/2013 8:58,10,500000,210,173,383
9/20/2013 8:58,10,500000,231,171,402
9/20/2013 8:58,10,500000,148,170,318
9/20/2013 8:58,10,500000,190,171,361
9/20/2013 8:58,10,500000,137,212,349
9/20/2013 8:58,10,500000,246,173,419
9/20/2013 8:58,10,500000,163,169,332
9/20/2013 8:58,10,500000,171,175,346
9/20/2013 8:58,10,500000,188,215,403
9/20/2013 8:58,10,500000,150,212,362
9/20/2013 8:58,10,500000,132,209,341
9/20/2013 8:58,10,500000,209,177,386
9/20/2013 8:58,10,500000,139,206,345
9/20/2013 8:58,10,500000,197,174,371
9/20/2013 8:58,10,500000,172,211,383
9/20/2013 8:58,10,500000,185,175,360
9/20/2013 8:58,10,500000,166,210,376
9/20/2013 8:58,10,500000,209,173,382
9/20/2013 8:58,10,500000,151,214,365
9/20/2013 8:58,10,500000,134,213,347
9/20/2013 8:58,10,500000,160,210,370
9/20/2013 8:59,10,600000,125,230,355
9/20/2013 8:59,10,600000,175,193,368
9/20/2013 8:59,10,600000,173,190,363
9/20/2013 8:59,10,600000,194,189,383
9/20/2013 8:59,10,600000,201,192,393
9/20/2013 8:59,10,600000,220,191,411
9/20/2013 8:59,10,600000,192,188,380
9/20/2013 8:59,10,600000,201,191,392
9/20/2013 8:59,10,600000,185,191,376
9/20/2013 8:59,10,600000,188,188,376
9/20/2013 8:59,10,600000,1141,196,1337
9/20/2013 8:59,10,600000,172,192,364
9/20/2013 8:59,10,600000,1163,189,1352
9/20/2013 8:59,10,600000,1159,194,1353
9/20/2013 8:59,10,600000,169,188,357
9/20/2013 8:59,10,600000,164,188,352
9/20/2013 8:59,10,600000,161,191,352
9/20/2013 8:59,10,600000,190,188,378
9/20/2013 8:59,10,600000,202,190,392
9/20/2013 8:59,10,600000,207,190,397
9/20/2013 8:59,10,600000,1161,190,1351
9/20/2013 9:00,10,600000,180,192,372
9/20/2013 9:00,10,600000,1137,194,1331
9/20/2013 9:00,10,600000,187,195,382
9/20/2013 9:00,10,600000,1134,194,1328
9/20/2013 9:00,10,600000,212,195,407
9/20/2013 9:00,10,600000,1172,190,1362
9/20/2013 9:00,10,600000,1157,193,1350
9/20/2013 9:00,10,600000,201,189,390
9/20/2013 9:00,10,600000,1167,197,1364
9/20/2013 9:00,10,600000,147,232,379
9/20/2013 9:00,10,600000,1169,197,1366
9/20/2013 9:00,10,600000,1186,187,1373
9/20/2013 9:00,10,600000,200,197,397
9/20/2013 9:00,10,600000,170,193,363
9/20/2013 9:00,10,600000,146,233,379
9/20/2013 9:00,10,600000,160,187,347
9/20/2013 9:00,10,600000,190,192,382
9/20/2013 9:00,10,600000,190,193,383
9/20/2013 9:00,10,600000,165,225,390
9/20/2013 9:00,10,600000,196,195,391
9/20/2013 9:00,10,600000,199,189,388
9/20/2013 9:01,10,600000,197,189,386
9/20/2013 9:01,10,600000,208,198,406
9/20/2013 9:01,10,600000,185,192,377
9/20/2013 9:01,10,600000,1106,227,1333
9/20/2013 9:01,10,600000,193,188,381
9/20/2013 9:01,10,600000,178,194,372
9/20/2013 9:01,10,600000,213,189,402
9/20/2013 9:01,10,600000,164,192,356
9/20/2013 9:01,10,600000,189,192,381
9/20/2013 9:01,10,600000,170,186,356
9/20/2013 9:01,10,600000,162,189,351
9/20/2013 9:01,10,600000,169,193,362
9/20/2013 9:34,10,600000,182,192,374
9/20/2013 9:34,10,600000,1144,191,1335
9/20/2013 9:34,10,600000,158,189,347
9/20/2013 9:35,10,600000,187,189,376
9/20/2013 9:35,10,600000,184,193,377
9/20/2013 9:35,10,600000,162,192,354
9/20/2013 9:35,10,600000,162,224,386
9/20/2013 9:35,10,600000,205,194,399
9/20/2013 9:35,10,600000,175,187,362
9/20/2013 9:35,10,600000,213,190,403
9/20/2013 9:35,10,600000,173,191,364
9/20/2013 9:35,10,600000,1145,194,1339
9/20/2013 9:35,10,600000,179,193,372
9/20/2013 9:35,10,600000,1166,190,1356
9/20/2013 9:35,10,600000,164,196,360
9/20/2013 9:35,10,600000,1109,227,1336
9/20/2013 9:35,10,600000,196,188,384
9/20/2013 9:35,10,600000,179,189,368
9/20/2013 9:35,10,600000,218,190,408
9/20/2013 9:35,10,600000,177,189,366
9/20/2013 9:35,10,600000,185,191,376
9/20/2013 9:35,10,600000,189,192,381
9/20/2013 9:35,10,600000,1170,186,1356
9/20/2013 9:35,10,600000,213,191,404
9/20/2013 9:35,10,600000,174,194,368
9/20/2013 9:36,10,600000,1171,197,1368
9/20/2013 9:36,10,600000,183,192,375
9/20/2013 9:36,10,600000,165,192,357
9/20/2013 9:36,10,600000,172,192,364
9/20/2013 9:36,10,600000,213,188,401
9/20/2013 9:36,10,600000,185,187,372
9/20/2013 9:36,10,600000,158,196,354
9/20/2013 9:36,10,600000,183,187,370
9/20/2013 9:36,10,600000,210,192,402
9/20/2013 9:36,10,600000,203,190,393
9/20/2013 9:36,10,600000,180,194,374
9/20/2013 9:36,10,600000,192,189,381
9/20/2013 9:36,10,600000,200,192,392
9/20/2013 9:36,10,600000,178,194,372
9/20/2013 9:36,10,600000,218,189,407
9/20/2013 9:36,10,600000,177,186,363
9/20/2013 9:36,10,600000,175,195,370
9/20/2013 9:36,10,600000,171,188,359
9/20/2013 9:36,10,600000,183,190,373
9/20/2013 9:36,10,600000,188,188,376
9/20/2013 9:36,10,600000,185,187,372
9/20/2013 9:36,10,600000,176,194,370
9/20/2013 9:36,10,600000,139,227,366
9/20/2013 9:36,10,600000,217,192,409
9/20/2013 9:36,10,600000,174,193,367
9/20/2013 9:37,10,600000,197,194,391
9/20/2013 9:37,10,600000,193,193,386
9/20/2013 9:37,10,600000,165,189,354
9/20/2013 9:37,10,600000,164,188,352
9/20/2013 9:37,10,600000,154,227,381
9/20/2013 9:37,10,600000,172,189,361
9/20/2013 9:37,10,600000,204,193,397
9/20/2013 9:37,10,600000,166,190,356
9/20/2013 9:37,10,600000,201,193,394
9/20/2013 9:37,10,600000,201,193,394
9/20/2013 9:37,10,700000,1148,219,1367
9/20/2013 9:37,10,700000,1198,211,1409
9/20/2013 9:37,10,700000,1167,216,1383
9/20/2013 9:37,10,700000,1128,215,1343
9/20/2013 9:37,10,700000,170,218,388
9/20/2013 9:37,10,700000,1163,213,1376
9/20/2013 9:37,10,700000,212,216,428
9/20/2013 9:37,10,700000,159,219,378
9/20/2013 9:37,10,700000,228,223,451
9/20/2013 9:37,10,700000,203,220,423
9/20/2013 9:37,10,700000,162,215,377
9/20/2013 9:37,10,700000,182,217,399
9/20/2013 9:38,10,700000,202,217,419
9/20/2013 9:38,10,700000,186,217,403
9/20/2013 9:38,10,700000,167,216,383
9/20/2013 9:38,10,700000,158,222,380
9/20/2013 9:38,10,700000,185,221,406
9/20/2013 9:38,10,700000,183,212,395
9/20/2013 9:38,10,700000,1168,213,1381
9/20/2013 9:38,10,700000,229,220,449
9/20/2013 9:38,10,700000,210,221,431
9/20/2013 9:38,10,700000,191,219,410
9/20/2013 9:38,10,700000,233,215,448
9/20/2013 9:38,10,700000,194,216,410
9/20/2013 9:38,10,700000,185,213,398
9/20/2013 9:38,10,700000,247,218,465
9/20/2013 9:38,10,700000,202,215,417
9/20/2013 9:38,10,700000,200,216,416
9/20/2013 9:38,10,700000,186,213,399
9/20/2013 9:38,10,700000,202,220,422
9/20/2013 9:38,10,700000,192,215,407
9/20/2013 9:38,10,700000,167,220,387
9/20/2013 9:38,10,700000,206,215,421
9/20/2013 9:38,10,700000,201,213,414
9/20/2013 9:38,10,700000,174,215,389
9/20/2013 9:39,10,700000,209,218,427
9/20/2013 9:39,10,700000,182,216,398
9/20/2013 9:39,10,700000,199,215,414
9/20/2013 9:39,10,700000,198,218,416
9/20/2013 9:39,10,700000,213,219,432
9/20/2013 9:39,10,700000,191,212,403
9/20/2013 9:39,10,700000,195,216,411
9/20/2013 9:39,10,700000,188,217,405
9/20/2013 9:39,10,700000,192,217,409
9/20/2013 9:39,10,700000,178,211,389
9/20/2013 9:39,10,700000,1156,226,1382
9/20/2013 9:39,10,700000,184,216,400
9/20/2013 9:39,10,700000,180,216,396
9/20/2013 9:39,10,700000,260,219,479
9/20/2013 9:39,10,700000,244,214,458
9/20/2013 9:39,10,700000,1138,216,1354
9/20/2013 9:39,10,700000,213,217,430
9/20/2013 9:39,10,700000,185,219,404
9/20/2013 9:39,10,700000,1140,215,1355
9/20/2013 9:39,10,700000,1157,222,1379
9/20/2013 9:39,10,700000,184,218,402
9/20/2013 9:39,10,700000,1174,229,1403
9/20/2013 9:40,10,700000,185,215,400
9/20/2013 9:40,10,700000,195,219,414
9/20/2013 9:40,10,700000,195,220,415
9/20/2013 9:40,10,700000,1165,220,1385
9/20/2013 9:40,10,700000,187,219,406
9/20/2013 9:40,10,700000,182,214,396
9/20/2013 9:40,10,700000,224,216,440
9/20/2013 9:40,10,700000,230,213,443
9/20/2013 9:40,10,700000,202,218,420
9/20/2013 9:40,10,700000,1144,219,1363
9/20/2013 9:40,10,700000,1134,220,1354
9/20/2013 9:40,10,700000,187,217,404
9/20/2013 9:40,10,700000,167,213,380
9/20/2013 9:40,10,700000,194,214,408
9/20/2013 9:40,10,700000,1154,218,1372
9/20/2013 9:40,10,700000,215,218,433
9/20/2013 9:40,10,700000,196,217,413
9/20/2013 9:40,10,700000,219,217,436
9/20/2013 9:40,10,700000,205,218,423
9/20/2013 9:40,10,700000,1176,210,1386
9/20/2013 9:40,10,700000,171,214,385
9/20/2013 9:40,10,700000,161,215,376
9/20/2013 9:41,10,700000,202,215,417
9/20/2013 9:41,10,700000,252,217,469
9/20/2013 9:41,10,700000,183,213,396
9/20/2013 9:41,10,700000,180,215,395
9/20/2013 9:41,10,700000,217,219,436
9/20/2013 9:41,10,700000,196,216,412
9/20/2013 9:41,10,700000,1168,217,1385
9/20/2013 9:41,10,700000,196,213,409
9/20/2013 9:41,10,700000,194,214,408
9/20/2013 9:41,10,700000,240,219,459
9/20/2013 9:41,10,700000,216,216,432
9/20/2013 9:41,10,700000,182,214,396
9/20/2013 9:41,10,700000,218,216,434
9/20/2013 9:41,10,700000,1171,217,1388
9/20/2013 9:41,10,700000,214,221,435
9/20/2013 9:41,10,700000,200,219,419
9/20/2013 9:41,10,700000,194,214,408
9/20/2013 9:41,10,700000,190,218,408
9/20/2013 9:41,10,700000,205,215,420
9/20/2013 9:41,10,700000,204,213,417
9/20/2013 9:41,10,700000,173,218,391
9/20/2013 9:41,10,700000,190,217,407
9/20/2013 9:42,10,700000,194,219,413
9/20/2013 9:42,10,700000,184,211,395
9/20/2013 9:42,10,700000,199,214,413
9/20/2013 9:42,10,700000,197,213,410
9/20/2013 9:42,10,700000,216,213,429
9/20/2013 9:42,10,700000,184,228,412
9/20/2013 9:42,10,700000,169,218,387
9/20/2013 9:42,10,700000,166,215,381
9/20/2013 9:42,10,700000,1149,219,1368
9/20/2013 9:42,10,700000,246,220,466
9/20/2013 9:42,10,700000,222,218,440
9/20/2013 9:42,10,700000,205,218,423
9/20/2013 9:42,10,700000,1162,213,1375
9/20/2013 9:42,10,700000,199,212,411
9/20/2013 9:42,10,800000,1215,243,1458
9/20/2013 9:42,10,800000,1203,243,1446
9/20/2013 9:42,10,800000,235,246,481
9/20/2013 9:42,10,800000,211,245,456
9/20/2013 9:42,10,800000,180,248,428
9/20/2013 9:42,10,800000,220,247,467
9/20/2013 9:42,10,800000,213,251,464
9/20/2013 9:42,10,800000,190,253,443
9/20/2013 9:43,10,800000,245,239,484
9/20/2013 9:59,10,800000,1179,242,1421
9/20/2013 9:59,10,800000,1155,248,1403
9/20/2013 9:59,10,800000,208,249,457
9/20/2013 9:59,10,800000,1168,249,1417
9/20/2013 9:59,10,800000,196,246,442
9/20/2013 10:00,10,800000,225,250,475
9/20/2013 10:00,10,800000,210,247,457
9/20/2013 10:00,10,800000,1126,255,1381
9/20/2013 10:00,10,800000,1154,247,1401
9/20/2013 10:00,10,800000,258,246,504
9/20/2013 10:00,10,800000,1157,247,1404
9/20/2013 10:00,10,800000,231,247,478
9/20/2013 10:00,10,800000,201,244,445
9/20/2013 10:00,10,800000,235,243,478
9/20/2013 10:00,10,800000,187,255,442
9/20/2013 10:00,10,800000,217,254,471
9/20/2013 10:00,10,800000,205,243,448
9/20/2013 10:00,10,800000,213,245,458
9/20/2013 10:00,10,800000,195,248,443
9/20/2013 10:00,10,800000,212,246,458
9/20/2013 10:00,10,800000,227,249,476
9/20/2013 10:00,10,800000,208,246,454
9/20/2013 10:00,10,800000,203,248,451
9/20/2013 10:00,10,800000,217,252,469
9/20/2013 10:00,10,800000,183,251,434
9/20/2013 10:00,10,800000,218,254,472
9/20/2013 10:00,10,800000,226,253,479
9/20/2013 10:01,10,800000,191,256,447
9/20/2013 10:01,10,800000,165,249,414
9/20/2013 10:01,10,800000,217,242,459
9/20/2013 10:01,10,800000,247,257,504
9/20/2013 10:01,10,800000,201,241,442
9/20/2013 10:01,10,800000,1141,250,1391
9/20/2013 10:01,10,800000,190,250,440
9/20/2013 10:01,10,800000,267,246,513
9/20/2013 10:01,10,800000,233,246,479
9/20/2013 10:01,10,800000,237,252,489
9/20/2013 10:01,10,800000,209,240,449
9/20/2013 10:01,10,800000,251,245,496
9/20/2013 10:01,10,800000,227,245,472
9/20/2013 10:01,10,800000,191,248,439
9/20/2013 10:01,10,800000,1220,252,1472
9/20/2013 10:01,10,800000,1177,256,1433
9/20/2013 10:01,10,800000,198,245,443
9/20/2013 10:01,10,800000,208,246,454
9/20/2013 10:01,10,800000,205,249,454
9/20/2013 10:01,10,800000,207,248,455
9/20/2013 10:01,10,800000,222,253,475
9/20/2013 10:01,10,800000,196,243,439
9/20/2013 10:02,10,800000,1187,245,1432
9/20/2013 10:02,10,800000,187,247,434
9/20/2013 10:02,10,800000,1150,256,1406
9/20/2013 10:02,10,800000,202,243,445
9/20/2013 10:02,10,800000,269,245,514
9/20/2013 10:02,10,800000,189,245,434
9/20/2013 10:02,10,800000,263,246,509
9/20/2013 10:02,10,800000,222,244,466
9/20/2013 10:02,10,800000,1167,252,1419
9/20/2013 10:02,10,800000,224,248,472
9/20/2013 10:02,10,800000,208,238,446
9/20/2013 10:02,10,800000,274,248,522
9/20/2013 10:02,10,800000,177,255,432
9/20/2013 10:02,10,800000,195,249,444
9/20/2013 10:02,10,800000,259,252,511
9/20/2013 10:02,10,800000,191,248,439
9/20/2013 10:02,10,800000,247,246,493
9/20/2013 10:02,10,800000,1126,254,1380
9/20/2013 10:02,10,800000,236,253,489
9/20/2013 10:02,10,800000,194,255,449
9/20/2013 10:02,10,800000,256,249,505
9/20/2013 10:02,10,800000,219,242,461
9/20/2013 10:03,10,800000,1173,252,1425
9/20/2013 10:03,10,800000,189,247,436
9/20/2013 10:03,10,800000,200,253,453
9/20/2013 10:03,10,800000,193,248,441
9/20/2013 10:03,10,800000,199,245,444
9/20/2013 10:03,10,800000,230,247,477
9/20/2013 10:03,10,800000,222,248,470
9/20/2013 10:03,10,800000,207,243,450
9/20/2013 10:03,10,800000,1228,291,1519
9/20/2013 10:03,10,800000,183,253,436
9/20/2013 10:03,10,800000,195,245,440
9/20/2013 10:03,10,800000,1222,251,1473
9/20/2013 10:03,10,800000,1147,252,1399
9/20/2013 10:03,10,800000,1166,249,1415
9/20/2013 10:03,10,800000,201,250,451
9/20/2013 10:03,10,800000,207,242,449
9/20/2013 10:03,10,800000,215,244,459
9/20/2013 10:03,10,800000,1215,245,1460
9/20/2013 10:03,10,800000,204,243,447
9/20/2013 10:03,10,800000,196,245,441
9/20/2013 10:03,10,800000,220,241,461
9/20/2013 10:03,10,800000,190,245,435
9/20/2013 10:04,10,800000,201,251,452
9/20/2013 10:04,10,800000,265,250,515
9/20/2013 10:04,10,800000,210,248,458
9/20/2013 10:04,10,800000,252,253,505
9/20/2013 10:04,10,800000,1146,255,1401
9/20/2013 10:04,10,800000,1176,244,1420
9/20/2013 10:04,10,800000,201,243,444
9/20/2013 10:04,10,800000,1129,247,1376
9/20/2013 10:04,10,800000,167,252,419
9/20/2013 10:04,10,800000,238,252,490
9/20/2013 10:04,10,800000,1167,242,1409
9/20/2013 10:04,10,800000,278,247,525
9/20/2013 10:04,10,900000,207,269,476
9/20/2013 10:04,10,900000,196,272,468
9/20/2013 10:04,10,900000,1217,276,1493
9/20/2013 10:04,10,900000,228,270,498
9/20/2013 10:04,10,900000,261,271,532
9/20/2013 10:04,10,900000,1199,272,1471
9/20/2013 10:04,10,900000,238,258,496
9/20/2013 10:04,10,900000,237,264,501
9/20/2013 10:05,10,900000,271,268,539
9/20/2013 10:05,10,900000,246,266,512
9/20/2013 10:05,10,900000,206,271,477
9/20/2013 10:05,10,900000,206,267,473
9/20/2013 10:05,10,900000,210,267,477
9/20/2013 10:05,10,900000,241,267,508
9/20/2013 10:05,10,900000,1158,260,1418
9/20/2013 10:05,10,900000,1157,270,1427
9/20/2013 10:05,10,900000,226,269,495
9/20/2013 10:05,10,900000,218,264,482
9/20/2013 10:05,10,900000,219,276,495
9/20/2013 10:05,10,900000,273,264,537
9/20/2013 10:05,10,900000,197,261,458
9/20/2013 10:05,10,900000,227,256,483
9/20/2013 10:05,10,900000,260,267,527
9/20/2013 10:05,10,900000,217,269,486
9/20/2013 10:05,10,900000,230,262,492
9/20/2013 10:05,10,900000,237,258,495
9/20/2013 10:05,10,900000,253,260,513
9/20/2013 10:05,10,900000,234,274,508
9/20/2013 10:05,10,900000,240,269,509
9/20/2013 10:05,10,900000,238,267,505
9/20/2013 10:05,10,900000,216,266,482
9/20/2013 10:06,10,900000,241,263,504
9/20/2013 10:06,10,900000,1242,260,1502
9/20/2013 10:06,10,900000,231,270,501
9/20/2013 10:06,10,900000,209,270,479
9/20/2013 10:06,10,900000,264,269,533
9/20/2013 10:06,10,900000,232,262,494
9/20/2013 10:06,10,900000,216,263,479
9/20/2013 10:06,10,900000,220,295,515
9/20/2013 10:06,10,900000,1210,268,1478
9/20/2013 10:06,10,900000,284,271,555
9/20/2013 10:06,10,900000,236,274,510
9/20/2013 10:06,10,900000,227,265,492
9/20/2013 10:06,10,900000,228,265,493
9/20/2013 10:06,10,900000,240,266,506
9/20/2013 10:06,10,900000,229,264,493
9/20/2013 10:06,10,900000,211,262,473
9/20/2013 10:06,10,900000,234,266,500
9/20/2013 10:06,10,900000,194,265,459
9/20/2013 10:06,10,900000,239,272,511
9/20/2013 10:06,10,900000,1191,272,1463
9/20/2013 10:06,10,900000,224,284,508
9/20/2013 10:06,10,900000,232,267,499
9/20/2013 10:07,10,900000,248,272,520
9/20/2013 10:07,10,900000,1186,259,1445
9/20/2013 10:07,10,900000,229,274,503
9/20/2013 10:07,10,900000,1180,273,1453
9/20/2013 10:07,10,900000,253,270,523
9/20/2013 10:07,10,900000,204,272,476
9/20/2013 10:07,10,900000,246,268,514
9/20/2013 10:07,10,900000,1179,265,1444
9/20/2013 10:07,10,900000,218,259,477
9/20/2013 10:07,10,900000,1191,269,1460
9/20/2013 10:07,10,900000,1159,255,1414
9/20/2013 10:07,10,900000,245,273,518
9/20/2013 10:07,10,900000,1236,269,1505
9/20/2013 10:07,10,900000,236,264,500
9/20/2013 10:07,10,900000,228,267,495
9/20/2013 10:07,10,900000,217,277,494
9/20/2013 10:07,10,900000,221,275,496
9/20/2013 10:07,10,900000,220,262,482
9/20/2013 10:07,10,900000,1218,268,1486
9/20/2013 10:07,10,900000,212,262,474
9/20/2013 10:08,10,900000,229,259,488
9/20/2013 10:08,10,900000,215,264,479
9/20/2013 10:08,10,900000,233,266,499
9/20/2013 10:08,10,900000,226,267,493
9/20/2013 10:08,10,900000,221,269,490
9/20/2013 10:08,10,900000,229,269,498
9/20/2013 10:08,10,900000,257,266,523
9/20/2013 10:08,10,900000,207,275,482
9/20/2013 10:08,10,900000,213,262,475
9/20/2013 10:08,10,900000,278,270,548
9/20/2013 10:08,10,900000,1200,260,1460
9/20/2013 10:08,10,900000,1171,264,1435
9/20/2013 10:08,10,900000,269,261,530
9/20/2013 10:08,10,900000,218,274,492
9/20/2013 10:08,10,900000,247,269,516
9/20/2013 10:08,10,900000,251,260,511
9/20/2013 10:08,10,900000,204,270,474
9/20/2013 10:08,10,900000,197,264,461
9/20/2013 10:08,10,900000,206,266,472
9/20/2013 10:08,10,900000,235,256,491
9/20/2013 10:08,10,900000,243,270,513
9/20/2013 10:08,10,900000,260,274,534
9/20/2013 10:09,10,900000,250,264,514
9/20/2013 10:09,10,900000,232,266,498
9/20/2013 10:09,10,900000,221,272,493
9/20/2013 10:09,10,900000,208,273,481
9/20/2013 10:09,10,900000,284,269,553
9/20/2013 10:09,10,900000,1183,268,1451
9/20/2013 10:09,10,900000,1188,268,1456
9/20/2013 10:09,10,900000,231,274,505
9/20/2013 10:09,10,900000,192,274,466
9/20/2013 10:09,10,900000,237,266,503
9/20/2013 10:09,10,900000,219,263,482
9/20/2013 10:09,10,900000,262,271,533
9/20/2013 10:09,10,900000,211,264,475
9/20/2013 10:09,10,900000,246,261,507
9/20/2013 10:09,10,900000,218,265,483
9/20/2013 10:09,10,900000,1187,268,1455
9/20/2013 10:09,10,900000,220,258,478
9/20/2013 10:09,10,900000,195,270,465
9/20/2013 10:09,10,900000,256,276,532
9/20/2013 10:09,10,900000,214,278,492
9/20/2013 10:09,10,1000000,162,289,451
9/20/2013 10:09,10,1000000,218,290,508
9/20/2013 10:10,10,1000000,1169,293,1462
9/20/2013 10:10,10,1000000,234,285,519
9/20/2013 10:10,10,1000000,221,295,516
9/20/2013 10:10,10,1000000,1157,296,1453
9/20/2013 10:10,10,1000000,204,289,493
9/20/2013 10:10,10,1000000,216,344,560
9/20/2013 10:10,10,1000000,1205,294,1499
9/20/2013 10:10,10,1000000,206,296,502
9/20/2013 10:10,10,1000000,1142,286,1428
9/20/2013 10:10,10,1000000,231,289,520
9/20/2013 10:10,10,1000000,197,286,483
9/20/2013 10:10,10,1000000,216,286,502
9/20/2013 10:10,10,1000000,1186,300,1486
9/20/2013 10:10,10,1000000,1190,298,1488
9/20/2013 10:10,10,1000000,249,291,540
9/20/2013 10:10,10,1000000,187,290,477
9/20/2013 10:10,10,1000000,189,290,479
9/20/2013 10:10,10,1000000,209,293,502
9/20/2013 10:10,10,1000000,205,294,499
9/20/2013 10:10,10,1000000,171,286,457
9/20/2013 10:11,10,1000000,193,296,489
9/20/2013 10:11,10,1000000,176,289,465
9/20/2013 10:11,10,1000000,203,294,497
9/20/2013 10:11,10,1000000,254,299,553
9/20/2013 10:11,10,1000000,213,303,516
9/20/2013 10:11,10,1000000,195,298,493
9/20/2013 10:11,10,1000000,245,294,539
9/20/2013 10:11,10,1000000,1162,291,1453
9/20/2013 10:11,10,1000000,194,285,479
9/20/2013 10:11,10,1000000,1129,281,1410
9/20/2013 10:11,10,1000000,257,292,549
9/20/2013 10:11,10,1000000,207,292,499
9/20/2013 10:11,10,1000000,179,291,470
9/20/2013 10:11,10,1000000,210,292,502
9/20/2013 10:11,10,1000000,223,297,520
9/20/2013 10:11,10,1000000,205,286,491
9/20/2013 10:11,10,1000000,202,293,495
9/20/2013 10:11,10,1000000,247,298,545
9/20/2013 10:11,10,1000000,207,291,498
9/20/2013 10:11,10,1000000,1142,289,1431
9/20/2013 10:12,10,1000000,200,289,489
9/20/2013 10:12,10,1000000,221,296,517
9/20/2013 10:12,10,1000000,232,301,533
9/20/2013 10:12,10,1000000,281,294,575
9/20/2013 10:12,10,1000000,225,292,517
9/20/2013 10:12,10,1000000,1214,296,1510
9/20/2013 10:12,10,1000000,234,301,535
9/20/2013 10:12,10,1000000,218,307,525
9/20/2013 10:12,10,1000000,233,296,529
9/20/2013 10:12,10,1000000,226,303,529
9/20/2013 10:12,10,1000000,200,294,494
9/20/2013 10:12,10,1000000,213,288,501
9/20/2013 10:12,10,1000000,230,286,516
9/20/2013 10:12,10,1000000,184,296,480
9/20/2013 10:12,10,1000000,221,296,517
9/20/2013 10:12,10,1000000,214,300,514
9/20/2013 10:12,10,1000000,194,292,486
9/20/2013 10:12,10,1000000,220,292,512
9/20/2013 10:12,10,1000000,207,286,493
9/20/2013 10:12,10,1000000,1182,296,1478
9/20/2013 10:12,10,1000000,1148,302,1450
9/20/2013 10:12,10,1000000,1200,296,1496
9/20/2013 10:13,10,1000000,216,287,503
9/20/2013 10:13,10,1000000,212,301,513
9/20/2013 10:13,10,1000000,1152,297,1449
9/20/2013 10:13,10,1000000,1152,298,1450
9/20/2013 10:13,10,1000000,1140,286,1426
9/20/2013 10:13,10,1000000,211,295,506
9/20/2013 10:13,10,1000000,1203,297,1500
9/20/2013 10:13,10,1000000,197,323,520
9/20/2013 10:13,10,1000000,189,292,481
9/20/2013 10:13,10,1000000,218,292,510
9/20/2013 10:13,10,1000000,250,299,549
9/20/2013 10:13,10,1000000,1183,292,1475
9/20/2013 10:13,10,1000000,205,289,494
9/20/2013 10:13,10,1000000,212,292,504
9/20/2013 10:13,10,1000000,199,295,494
9/20/2013 10:13,10,1000000,277,293,570
9/20/2013 10:13,10,1000000,192,294,486
9/20/2013 10:13,10,1000000,220,301,521
9/20/2013 10:13,10,1000000,229,294,523
9/20/2013 10:13,10,1000000,179,281,460
9/20/2013 10:14,10,1000000,240,287,527
9/20/2013 10:14,10,1000000,219,294,513
9/20/2013 10:14,10,1000000,268,293,561
9/20/2013 10:14,10,1000000,225,295,520
9/20/2013 10:14,10,1000000,189,288,477
9/20/2013 10:14,10,1000000,157,289,446
9/20/2013 10:14,10,1000000,222,295,517
9/20/2013 10:14,10,1000000,229,286,515
9/20/2013 10:14,10,1000000,207,290,497
9/20/2013 10:14,10,1000000,252,297,549
9/20/2013 10:14,10,1000000,252,294,546
9/20/2013 10:14,10,1000000,168,283,451
9/20/2013 10:14,10,1000000,187,285,472
9/20/2013 10:14,10,1000000,219,286,505
9/20/2013 10:14,10,1000000,234,291,525
9/20/2013 10:14,10,1000000,217,293,510
9/20/2013 10:14,10,1000000,240,294,534
9/20/2013 10:14,10,1000000,160,288,448
9/20/2013 10:14,10,1000000,212,291,503
9/20/2013 10:14,10,1000000,234,307,541
9/20/2013 10:14,10,1000000,1158,298,1456
9/20/2013 10:14,10,1000000,1134,285,1419
9/20/2013 10:15,10,1000000,221,304,525
9/20/2013 10:15,10,1000000,1165,295,1460
9/20/2013 10:15,10,1000000,1199,295,1494
9/20/2013 10:15,10,1000000,1167,288,1455
9/20/2013 10:15,10,1000000,191,288,479
9/20/2013 10:15,10,1000000,225,296,521
9/20/2013 10:15,10,1000000,252,287,539
9/20/2013 10:15,10,1000000,1185,304,1489
9/20/2013 10:15,10,1000000,1180,302,1482
9/20/2013 10:15,10,1000000,1141,282,1423
9/20/2013 10:15,10,1000000,187,288,475
9/20/2013 10:15,10,1000000,1166,300,1466
9/20/2013 10:15,10,1000000,1186,300,1486
9/20/2013 10:15,10,1000000,209,288,497
9/20/2013 10:15,10,1000000,191,300,491
9/20/2013 10:15,10,1000000,218,291,509
9/20/2013 10:15,10,1000000,222,288,510
9/20/2013 10:15,10,1000000,214,295,509
9/20/2013 10:15,10,1000000,1147,295,1442
9/20/2013 10:16,10,1000000,176,291,467
9/20/2013 10:16,10,1000000,207,298,505
9/20/2013 10:16,10,1000000,219,289,508
9/20/2013 10:16,10,1000000,1126,299,1425
9/20/2013 10:16,10,1000000,209,303,512
9/20/2013 10:16,10,1000000,217,310,527
9/20/2013 10:16,10,1000000,201,301,502
9/20/2013 10:16,10,1000000,207,294,501
9/20/2013 10:16,10,1000000,258,296,554
9/20/2013 10:16,10,1000000,218,299,517
9/20/2013 10:16,10,1000000,191,287,478
9/20/2013 10:16,10,1000000,204,299,503
9/20/2013 10:16,10,1000000,219,300,519
9/20/2013 10:16,10,1000000,223,302,525
9/20/2013 10:16,10,1000000,272,290,562
9/20/2013 10:16,10,1000000,212,291,503
9/20/2013 10:16,10,1000000,178,290,468
9/20/2013 10:16,10,1000000,241,289,530
9/20/2013 10:16,10,1000000,177,290,467
9/20/2013 10:16,10,1000000,248,299,547
9/20/2013 10:16,10,1000000,199,298,497
9/20/2013 10:16,10,1000000,204,305,509
9/20/2013 10:16,10,1000000,258,296,554
9/20/2013 10:17,10,1000000,220,295,515
9/20/2013 10:17,10,1000000,193,300,493
9/20/2013 10:17,10,1000000,220,295,515
9/20/2013 10:17,10,1000000,196,290,486
9/20/2013 10:17,10,1000000,203,299,502
9/20/2013 10:17,10,1000000,207,297,504
9/20/2013 10:17,10,1000000,228,297,525
9/20/2013 10:17,10,1000000,1203,304,1507
9/20/2013 10:17,10,1000000,1142,286,1428
9/20/2013 10:17,10,1000000,228,293,521
9/20/2013 10:17,10,1000000,189,289,478
9/20/2013 10:17,10,1000000,232,297,529
9/20/2013 10:17,10,1000000,184,297,481
9/20/2013 10:17,10,1000000,195,295,490
9/20/2013 10:17,10,1000000,193,287,480
9/20/2013 10:17,10,1000000,213,293,506
9/20/2013 10:17,10,1000000,230,288,518
9/20/2013 10:17,10,1000000,182,289,471
9/20/2013 10:17,10,1000000,217,290,507
9/20/2013 10:17,10,1000000,200,288,488
9/20/2013 10:17,10,1000000,205,334,539
9/20/2013 10:17,10,1000000,1157,288,1445
9/20/2013 10:18,10,1000000,211,302,513
9/20/2013 10:18,10,1000000,180,291,471
9/20/2013 10:18,10,1000000,212,294,506
9/20/2013 10:18,10,1000000,206,290,496
9/20/2013 10:18,10,1000000,205,298,503
9/20/2013 10:18,10,1000000,228,293,521
9/20/2013 10:18,10,1000000,211,295,506
9/20/2013 10:18,10,1000000,244,298,542
9/20/2013 10:18,10,1000000,195,286,481
9/20/2013 10:18,10,1000000,248,299,547
9/20/2013 10:18,10,1000000,246,294,540
9/20/2013 10:18,10,1000000,186,291,477
9/20/2013 10:18,10,1000000,229,291,520
9/20/2013 10:18,10,1000000,210,293,503
9/20/2013 10:18,10,1000000,200,292,492
9/20/2013 10:18,10,1000000,219,294,513
9/20/2013 10:18,10,1000000,217,294,511
9/20/2013 10:18,10,1000000,194,284,478
9/20/2013 10:18,10,1000000,1143,297,1440
9/20/2013 10:18,10,1000000,198,291,489
9/20/2013 10:18,10,1000000,214,296,510
9/20/2013 10:18,10,1000000,174,297,471
9/20/2013 10:19,10,1000000,193,292,485
9/20/2013 10:19,10,1000000,220,293,513
9/20/2013 10:19,10,1000000,204,286,490
9/20/2013 10:19,10,1000000,183,294,477
9/20/2013 10:19,10,1000000,201,299,500
9/20/2013 10:19,10,1000000,186,284,470
9/20/2013 10:19,10,1000000,216,281,497
9/20/2013 10:19,10,1000000,209,296,505
9/20/2013 10:19,10,1000000,211,284,495
9/20/2013 10:19,10,1000000,158,283,441
9/20/2013 10:19,10,1000000,262,286,548
9/20/2013 10:19,10,1000000,240,298,538
9/20/2013 10:19,10,1000000,182,285,467
9/20/2013 10:19,10,1000000,213,297,510
9/20/2013 10:19,10,1000000,230,290,520
9/20/2013 10:19,10,1000000,220,295,515
9/20/2013 10:19,10,1000000,246,291,537
9/20/2013 10:19,10,1000000,1129,296,1425
9/20/2013 10:19,10,1000000,171,290,461
9/20/2013 10:19,10,1000000,231,288,519
9/20/2013 10:19,10,1000000,232,308,540
9/20/2013 10:19,10,1000000,254,300,554
9/20/2013 10:19,10,1000000,284,293,577
9/20/2013 10:20,10,1000000,237,301,538
9/20/2013 10:20,10,1000000,195,293,488
9/20/2013 10:20,10,1000000,169,293,462
9/20/2013 10:20,10,1000000,225,298,523
9/20/2013 10:20,10,1000000,208,301,509
9/20/2013 10:20,10,1000000,227,283,510
9/20/2013 10:20,10,1000000,200,301,501
9/20/2013 10:20,10,1000000,194,298,492
9/20/2013 10:20,10,1000000,190,296,486
9/20/2013 10:20,10,1000000,191,295,486
9/20/2013 10:20,10,1000000,206,293,499
9/20/2013 10:20,10,1000000,168,295,463
9/20/2013 10:20,10,1000000,200,294,494
9/20/2013 10:20,10,1000000,282,297,579
9/20/2013 10:20,10,1000000,249,300,549
9/20/2013 10:20,10,2000000,335,526,861
9/20/2013 10:20,10,2000000,1211,529,1740
9/20/2013 10:20,10,2000000,342,502,844
9/20/2013 10:20,10,2000000,303,524,827
9/20/2013 10:20,10,2000000,305,500,805
9/20/2013 10:20,10,2000000,310,528,838
9/20/2013 10:20,10,2000000,333,522,855
9/20/2013 10:21,10,2000000,320,532,852
9/20/2013 10:21,10,2000000,1235,501,1736
9/20/2013 10:21,10,2000000,297,526,823
9/20/2013 10:21,10,2000000,1227,517,1744
9/20/2013 10:21,10,2000000,1218,537,1755
9/20/2013 10:21,10,2000000,1238,533,1771
9/20/2013 10:21,10,2000000,1220,511,1731
9/20/2013 10:21,10,2000000,326,518,844
9/20/2013 10:21,10,2000000,309,530,839
9/20/2013 10:21,10,2000000,399,523,922
9/20/2013 10:21,10,2000000,339,533,872
9/20/2013 10:21,10,2000000,314,534,848
9/20/2013 10:21,10,2000000,319,530,849
9/20/2013 10:21,10,2000000,1238,525,1763
9/20/2013 10:21,10,2000000,302,525,827
9/20/2013 10:21,10,2000000,332,522,854
9/20/2013 10:22,10,2000000,1269,529,1798
9/20/2013 10:22,10,2000000,331,513,844
9/20/2013 10:22,10,2000000,309,542,851
9/20/2013 10:22,10,2000000,362,525,887
9/20/2013 10:22,10,2000000,322,530,852
9/20/2013 10:22,10,2000000,356,531,887
9/20/2013 10:22,10,2000000,304,521,825
9/20/2013 10:22,10,2000000,371,518,889
9/20/2013 10:22,10,2000000,327,530,857
9/20/2013 10:22,10,2000000,302,525,827
9/20/2013 10:22,10,2000000,314,505,819
9/20/2013 10:22,10,2000000,349,502,851
9/20/2013 10:22,10,2000000,347,517,864
9/20/2013 10:22,10,2000000,332,530,862
9/20/2013 10:22,10,2000000,306,519,825
9/20/2013 10:22,10,2000000,391,515,906
9/20/2013 10:22,10,2000000,326,505,831
9/20/2013 10:22,10,2000000,340,524,864
9/20/2013 10:23,10,2000000,312,538,850
9/20/2013 10:23,10,2000000,324,518,842
9/20/2013 10:23,10,2000000,1270,511,1781
9/20/2013 10:23,10,2000000,312,528,840
9/20/2013 10:23,10,2000000,353,484,837
9/20/2013 10:23,10,2000000,339,522,861
9/20/2013 10:23,10,2000000,347,536,883
9/20/2013 10:23,10,2000000,318,524,842
9/20/2013 10:23,10,2000000,375,527,902
9/20/2013 10:23,10,2000000,311,489,800
9/20/2013 10:23,10,2000000,330,526,856
9/20/2013 10:23,10,2000000,334,516,850
9/20/2013 10:23,10,2000000,361,532,893
9/20/2013 10:23,10,2000000,324,514,838
9/20/2013 10:23,10,2000000,328,498,826
9/20/2013 10:23,10,2000000,379,521,900
9/20/2013 10:23,10,2000000,335,527,862
9/20/2013 10:23,10,2000000,308,524,832
9/20/2013 10:23,10,2000000,334,531,865
9/20/2013 10:24,10,2000000,344,531,875
9/20/2013 10:24,10,2000000,331,539,870
9/20/2013 10:24,10,2000000,331,518,849
9/20/2013 10:24,10,2000000,323,527,850
9/20/2013 10:24,10,2000000,325,531,856
9/20/2013 10:24,10,2000000,358,540,898
9/20/2013 10:24,10,2000000,314,526,840
9/20/2013 10:24,10,2000000,303,531,834
9/20/2013 10:24,10,2000000,321,497,818
9/20/2013 10:24,10,2000000,332,526,858
9/20/2013 10:24,10,2000000,1227,521,1748
9/20/2013 10:24,10,2000000,317,523,840
9/20/2013 10:24,10,2000000,310,527,837
9/20/2013 10:24,10,2000000,1234,500,1734
9/20/2013 10:24,10,2000000,349,529,878
9/20/2013 10:24,10,2000000,1256,506,1762
9/20/2013 10:24,10,2000000,329,531,860
9/20/2013 10:24,10,2000000,371,523,894
9/20/2013 10:25,10,2000000,333,540,873
9/20/2013 10:25,10,2000000,1296,525,1821
9/20/2013 10:25,10,2000000,324,497,821
9/20/2013 10:25,10,2000000,319,524,843
9/20/2013 10:25,10,2000000,311,535,846
9/20/2013 10:25,10,2000000,347,526,873
9/20/2013 10:25,10,2000000,321,508,829
9/20/2013 10:25,10,2000000,304,519,823
9/20/2013 10:25,10,2000000,337,506,843
9/20/2013 10:25,10,2000000,343,506,849
9/20/2013 10:25,10,2000000,405,523,928
9/20/2013 10:25,10,2000000,305,530,835
9/20/2013 10:25,10,2000000,1222,533,1755
9/20/2013 10:25,10,2000000,309,527,836
9/20/2013 10:25,10,2000000,313,518,831
9/20/2013 10:25,10,2000000,342,527,869
9/20/2013 10:25,10,2000000,346,540,886
9/20/2013 10:25,10,2000000,320,512,832
9/20/2013 10:26,10,2000000,299,522,821
9/20/2013 10:26,10,2000000,336,518,854
9/20/2013 10:26,10,2000000,316,531,847
9/20/2013 10:26,10,2000000,349,526,875
9/20/2013 10:26,10,2000000,340,523,863
9/20/2013 10:26,10,2000000,310,511,821
9/20/2013 10:26,10,2000000,323,523,846
9/20/2013 10:26,10,2000000,314,539,853
9/20/2013 10:26,10,2000000,329,520,849
9/20/2013 10:26,10,2000000,326,527,853
9/20/2013 10:26,10,2000000,326,535,861
9/20/2013 10:26,10,2000000,360,520,880
9/20/2013 10:26,10,2000000,305,526,831
9/20/2013 10:26,10,2000000,334,500,834
9/20/2013 10:26,10,2000000,332,534,866
9/20/2013 10:26,10,2000000,321,523,844
9/20/2013 10:26,10,2000000,327,523,850
9/20/2013 10:26,10,2000000,1219,501,1720
9/20/2013 10:26,10,2000000,1206,532,1738
9/20/2013 10:27,10,3000000,390,771,1161
9/20/2013 10:27,10,3000000,456,723,1179
9/20/2013 10:27,10,3000000,1307,730,2037
9/20/2013 10:27,10,3000000,1273,755,2028
9/20/2013 10:27,10,3000000,669,749,1418
9/20/2013 10:27,10,3000000,438,729,1167
9/20/2013 10:27,10,3000000,450,748,1198
9/20/2013 10:27,10,3000000,1297,755,2052
9/20/2013 10:27,10,3000000,440,735,1175
9/20/2013 10:27,10,3000000,400,754,1154
9/20/2013 10:27,10,3000000,1298,733,2031
9/20/2013 10:27,10,3000000,438,735,1173
9/20/2013 10:27,10,3000000,1394,731,2125
9/20/2013 10:27,10,3000000,437,730,1167
9/20/2013 10:27,10,3000000,464,739,1203
9/20/2013 10:28,10,3000000,1243,718,1961
9/20/2013 10:28,10,3000000,468,726,1194
9/20/2013 10:28,10,3000000,1272,742,2014
9/20/2013 10:28,10,3000000,452,732,1184
9/20/2013 10:28,10,3000000,414,736,1150
9/20/2013 10:28,10,3000000,450,735,1185
9/20/2013 10:28,10,3000000,468,760,1228
9/20/2013 10:28,10,3000000,470,753,1223
9/20/2013 10:28,10,3000000,426,737,1163
9/20/2013 10:28,10,3000000,413,732,1145
9/20/2013 10:28,10,3000000,448,743,1191
9/20/2013 10:28,10,3000000,434,738,1172
9/20/2013 10:28,10,3000000,425,718,1143
9/20/2013 10:28,10,3000000,1286,713,1999
9/20/2013 10:28,10,3000000,425,733,1158
9/20/2013 10:29,10,3000000,450,750,1200
9/20/2013 10:29,10,3000000,476,717,1193
9/20/2013 10:29,10,3000000,475,754,1229
9/20/2013 10:29,10,3000000,458,735,1193
9/20/2013 10:29,10,3000000,529,745,1274
9/20/2013 10:29,10,3000000,467,748,1215
9/20/2013 10:29,10,3000000,415,727,1142
9/20/2013 10:29,10,3000000,408,726,1134
9/20/2013 10:29,10,3000000,413,726,1139
9/20/2013 10:29,10,3000000,435,759,1194
9/20/2013 10:29,10,3000000,416,756,1172
9/20/2013 10:29,10,3000000,1277,724,2001
9/20/2013 10:29,10,3000000,438,743,1181
9/20/2013 10:29,10,3000000,466,762,1228
9/20/2013 10:29,10,3000000,1350,750,2100
9/20/2013 10:29,10,3000000,483,759,1242
9/20/2013 10:30,10,3000000,468,741,1209
9/20/2013 10:30,10,3000000,462,709,1171
9/20/2013 10:30,10,3000000,448,710,1158
9/20/2013 10:30,10,3000000,498,749,1247
9/20/2013 10:30,10,3000000,514,773,1287
9/20/2013 10:30,10,3000000,444,750,1194
9/20/2013 10:30,10,3000000,418,720,1138
9/20/2013 10:30,10,3000000,424,725,1149
9/20/2013 10:30,10,3000000,1334,743,2077
9/20/2013 10:30,10,3000000,420,732,1152
9/20/2013 10:30,10,3000000,413,768,1181
9/20/2013 10:30,10,3000000,439,718,1157
9/20/2013 10:30,10,3000000,1280,729,2009
9/20/2013 10:30,10,3000000,456,721,1177
9/20/2013 10:30,10,3000000,1308,732,2040
9/20/2013 10:30,10,3000000,469,763,1232
9/20/2013 10:31,10,3000000,424,743,1167
9/20/2013 10:31,10,3000000,1312,740,2052
9/20/2013 10:31,10,3000000,433,748,1181
9/20/2013 10:31,10,3000000,1274,733,2007
9/20/2013 10:31,10,3000000,442,748,1190
9/20/2013 10:31,10,3000000,422,754,1176
9/20/2013 10:31,10,3000000,477,724,1201
9/20/2013 10:31,10,3000000,1298,750,2048
9/20/2013 10:31,10,3000000,489,730,1219
9/20/2013 10:31,10,3000000,462,711,1173
9/20/2013 10:31,10,3000000,1304,720,2024
9/20/2013 10:31,10,3000000,1293,735,2028
9/20/2013 10:31,10,3000000,461,735,1196
9/20/2013 10:31,10,3000000,439,754,1193
9/20/2013 10:31,10,3000000,429,744,1173
9/20/2013 10:32,10,3000000,450,746,1196
9/20/2013 10:32,10,3000000,448,718,1166
9/20/2013 10:32,10,3000000,414,740,1154
9/20/2013 10:32,10,3000000,1323,760,2083
9/20/2013 10:32,10,3000000,1334,727,2061
9/20/2013 10:32,10,3000000,424,742,1166
9/20/2013 10:32,10,3000000,460,735,1195
9/20/2013 10:32,10,3000000,451,726,1177
9/20/2013 10:32,10,3000000,423,759,1182
9/20/2013 10:32,10,3000000,436,746,1182
9/20/2013 10:32,10,3000000,450,725,1175
9/20/2013 10:32,10,3000000,451,731,1182
9/20/2013 10:32,10,3000000,438,745,1183
9/20/2013 10:32,10,3000000,518,755,1273
9/20/2013 10:32,10,3000000,628,727,1355
9/20/2013 10:32,10,3000000,648,727,1375
9/20/2013 10:33,10,3000000,447,741,1188
9/20/2013 10:33,10,3000000,499,764,1263
9/20/2013 10:33,10,3000000,460,758,1218
9/20/2013 10:33,10,3000000,456,741,1197
9/20/2013 10:33,10,3000000,1270,737,2007
9/20/2013 10:33,10,3000000,452,760,1212
9/20/2013 10:33,10,3000000,438,755,1193
9/20/2013 10:33,10,3000000,1273,733,2006
9/20/2013 10:33,10,3000000,1348,726,2074
9/20/2013 10:33,10,3000000,488,753,1241
9/20/2013 10:33,10,3000000,403,715,1118
9/20/2013 10:33,10,3000000,1308,722,2030
9/20/2013 10:33,10,3000000,1279,735,2014
9/20/2013 10:33,10,3000000,1279,753,2032
9/20/2013 10:33,10,3000000,433,734,1167
9/20/2013 10:34,10,3000000,453,764,1217
9/20/2013 10:34,10,3000000,378,733,1111
9/20/2013 10:34,10,3000000,445,749,1194
9/20/2013 10:34,10,3000000,477,725,1202
9/20/2013 10:34,10,3000000,632,712,1344
9/20/2013 10:34,10,3000000,681,749,1430
9/20/2013 10:34,10,3000000,463,737,1200
9/20/2013 10:34,10,4000000,551,948,1499
9/20/2013 10:34,10,4000000,617,980,1597
9/20/2013 10:34,10,4000000,763,954,1717
9/20/2013 10:34,10,4000000,1319,950,2269
9/20/2013 10:34,10,4000000,537,977,1514
9/20/2013 10:34,10,4000000,517,977,1494
9/20/2013 10:34,10,4000000,559,988,1547
9/20/2013 10:34,10,4000000,611,963,1574
9/20/2013 10:35,10,4000000,1298,976,2274
9/20/2013 10:35,10,4000000,768,966,1734
9/20/2013 10:35,10,4000000,641,965,1606
9/20/2013 10:35,10,4000000,565,977,1542
9/20/2013 10:35,10,4000000,1395,955,2350
9/20/2013 10:35,10,4000000,539,985,1524
9/20/2013 10:35,10,4000000,700,951,1651
9/20/2013 10:35,10,4000000,561,953,1514
9/20/2013 10:35,10,4000000,775,1017,1792
9/20/2013 10:35,10,4000000,1354,970,2324
9/20/2013 10:35,10,4000000,1410,995,2405
9/20/2013 10:35,10,4000000,510,952,1462
9/20/2013 10:35,10,4000000,557,984,1541
9/20/2013 10:35,10,4000000,769,976,1745
9/20/2013 10:36,10,4000000,1353,975,2328
9/20/2013 10:36,10,4000000,727,971,1698
9/20/2013 10:36,10,4000000,1324,969,2293
9/20/2013 10:36,10,4000000,1338,989,2327
9/20/2013 10:36,10,4000000,767,960,1727
9/20/2013 10:36,10,4000000,1422,956,2378
9/20/2013 10:36,10,4000000,1348,972,2320
9/20/2013 10:36,10,4000000,528,951,1479
9/20/2013 10:36,10,4000000,522,951,1473
9/20/2013 10:36,10,4000000,580,977,1557
9/20/2013 10:36,10,4000000,810,950,1760
9/20/2013 10:36,10,4000000,685,974,1659
9/20/2013 10:36,10,4000000,545,993,1538
9/20/2013 10:37,10,4000000,576,991,1567
9/20/2013 10:37,10,4000000,527,941,1468
9/20/2013 10:37,10,4000000,749,965,1714
9/20/2013 10:37,10,4000000,741,979,1720
9/20/2013 10:37,10,4000000,736,971,1707
9/20/2013 10:37,10,4000000,550,1003,1553
9/20/2013 10:37,10,4000000,756,987,1743
9/20/2013 10:37,10,4000000,716,952,1668
9/20/2013 10:37,10,4000000,525,949,1474
9/20/2013 10:37,10,4000000,543,980,1523
9/20/2013 10:37,10,4000000,1362,969,2331
9/20/2013 10:37,10,4000000,559,981,1540
9/20/2013 10:37,10,4000000,594,960,1554
9/20/2013 10:37,10,4000000,1398,959,2357
9/20/2013 10:38,10,4000000,553,953,1506
9/20/2013 10:38,10,4000000,1341,954,2295
9/20/2013 10:38,10,4000000,557,994,1551
9/20/2013 10:38,10,4000000,724,986,1710
9/20/2013 10:38,10,4000000,700,960,1660
9/20/2013 10:38,10,4000000,547,970,1517
9/20/2013 10:38,10,4000000,777,977,1754
9/20/2013 10:38,10,4000000,514,953,1467
9/20/2013 10:38,10,4000000,757,973,1730
9/20/2013 10:38,10,4000000,1376,993,2369
9/20/2013 10:38,10,4000000,564,952,1516
9/20/2013 10:38,10,4000000,594,980,1574
9/20/2013 10:38,10,4000000,532,949,1481
9/20/2013 10:38,10,4000000,997,955,1952
9/20/2013 10:39,10,4000000,725,943,1668
9/20/2013 10:39,10,4000000,560,964,1524
9/20/2013 10:39,10,4000000,560,938,1498
9/20/2013 10:39,10,4000000,694,1009,1703
9/20/2013 10:39,10,4000000,557,980,1537
9/20/2013 10:39,10,4000000,569,949,1518
9/20/2013 10:39,10,4000000,712,950,1662
9/20/2013 10:39,10,4000000,546,915,1461
9/20/2013 10:39,10,4000000,802,997,1799
9/20/2013 10:39,10,4000000,521,962,1483
9/20/2013 10:39,10,4000000,1339,950,2289
9/20/2013 10:39,10,4000000,590,965,1555
9/20/2013 10:39,10,4000000,558,942,1500
9/20/2013 10:39,10,4000000,557,972,1529
9/20/2013 10:39,10,4000000,549,967,1516
9/20/2013 10:40,10,4000000,550,960,1510
9/20/2013 10:40,10,4000000,1357,970,2327
9/20/2013 10:40,10,4000000,536,917,1453
9/20/2013 10:40,10,4000000,588,988,1576
9/20/2013 10:40,10,4000000,578,996,1574
9/20/2013 10:40,10,4000000,578,959,1537
9/20/2013 10:40,10,4000000,532,948,1480
9/20/2013 10:40,10,4000000,703,933,1636
9/20/2013 10:40,10,4000000,731,991,1722
9/20/2013 10:40,10,4000000,564,991,1555
9/20/2013 10:40,10,4000000,615,982,1597
9/20/2013 10:40,10,4000000,602,949,1551
9/20/2013 10:40,10,4000000,503,948,1451
9/20/2013 10:40,10,4000000,592,964,1556
9/20/2013 10:41,10,4000000,526,984,1510
9/20/2013 10:41,10,4000000,596,938,1534
9/20/2013 10:41,10,4000000,511,968,1479
9/20/2013 10:41,10,4000000,708,972,1680
9/20/2013 10:41,10,4000000,776,975,1751
9/20/2013 10:41,10,4000000,560,968,1528
9/20/2013 10:41,10,4000000,798,970,1768
9/20/2013 10:41,10,4000000,1040,975,2015
9/20/2013 10:41,10,4000000,745,992,1737
9/20/2013 10:41,10,4000000,582,981,1563
9/20/2013 10:41,10,4000000,544,937,1481
9/20/2013 10:41,10,4000000,1385,994,2379
9/20/2013 10:41,10,4000000,604,981,1585
9/20/2013 10:41,10,4000000,759,979,1738
9/20/2013 10:41,10,4000000,518,989,1507
9/20/2013 10:42,10,4000000,578,941,1519
9/20/2013 10:42,10,4000000,553,940,1493
9/20/2013 10:42,10,4000000,782,988,1770
9/20/2013 10:42,10,4000000,750,963,1713
9/20/2013 10:42,10,4000000,809,1009,1818
9/20/2013 10:42,10,4000000,569,988,1557
9/20/2013 10:42,10,4000000,1377,935,2312
9/20/2013 10:42,10,4000000,791,959,1750
9/20/2013 10:42,10,5000000,604,1213,1817
9/20/2013 10:42,10,5000000,976,1194,2170
9/20/2013 10:42,10,5000000,621,1204,1825
9/20/2013 10:42,10,5000000,615,1154,1769
9/20/2013 10:42,10,5000000,844,1170,2014
9/20/2013 10:43,10,5000000,624,1174,1798
9/20/2013 10:43,10,5000000,778,1193,1971
9/20/2013 10:43,10,5000000,836,1218,2054
9/20/2013 10:43,10,5000000,838,1200,2038
9/20/2013 10:43,10,5000000,652,1216,1868
9/20/2013 10:43,10,5000000,631,1194,1825
9/20/2013 10:43,10,5000000,626,1184,1810
9/20/2013 10:43,10,5000000,673,1116,1789
9/20/2013 10:43,10,5000000,599,1174,1773
9/20/2013 10:43,10,5000000,1027,1250,2277
9/20/2013 10:43,10,5000000,675,1126,1801
9/20/2013 10:43,10,5000000,656,1219,1875
9/20/2013 10:43,10,5000000,813,1164,1977
9/20/2013 10:43,10,5000000,693,1211,1904
9/20/2013 10:44,10,5000000,693,1217,1910
9/20/2013 10:44,10,5000000,597,1235,1832
9/20/2013 10:44,10,5000000,617,1138,1755
9/20/2013 10:44,10,5000000,666,1253,1919
9/20/2013 10:44,10,5000000,853,1187,2040
9/20/2013 10:44,10,5000000,771,1199,1970
9/20/2013 10:44,10,5000000,869,1190,2059
9/20/2013 10:44,10,5000000,618,1186,1804
9/20/2013 10:44,10,5000000,1411,1198,2609
9/20/2013 10:44,10,5000000,586,1166,1752
9/20/2013 10:44,10,5000000,852,1165,2017
9/20/2013 10:44,10,5000000,705,1239,1944
9/20/2013 10:44,10,5000000,788,1209,1997
9/20/2013 10:45,10,5000000,643,1183,1826
9/20/2013 10:45,10,5000000,634,1229,1863
9/20/2013 10:45,10,5000000,673,1199,1872
9/20/2013 10:45,10,5000000,782,1248,2030
9/20/2013 10:45,10,5000000,642,1171,1813
9/20/2013 10:45,10,5000000,847,1194,2041
9/20/2013 10:45,10,5000000,680,1113,1793
9/20/2013 10:45,10,5000000,597,1197,1794
9/20/2013 10:45,10,5000000,611,1181,1792
9/20/2013 10:45,10,5000000,825,1164,1989
9/20/2013 10:45,10,5000000,625,1179,1804
9/20/2013 10:45,10,5000000,838,1187,2025
9/20/2013 10:45,10,5000000,864,1129,1993
9/20/2013 10:46,10,5000000,607,1198,1805
9/20/2013 10:46,10,5000000,1505,1137,2642
9/20/2013 10:46,10,5000000,617,1182,1799
9/20/2013 10:46,10,5000000,667,1239,1906
9/20/2013 10:46,10,5000000,797,1166,1963
9/20/2013 10:46,10,5000000,669,1205,1874
9/20/2013 10:46,10,5000000,778,1181,1959
9/20/2013 10:46,10,5000000,1533,1215,2748
9/20/2013 10:46,10,5000000,639,1179,1818
9/20/2013 10:46,10,5000000,618,1230,1848
9/20/2013 10:46,10,5000000,798,1172,1970
9/20/2013 10:46,10,5000000,696,1242,1938
9/20/2013 10:46,10,5000000,649,1197,1846
9/20/2013 10:47,10,5000000,754,1197,1951
9/20/2013 10:47,10,5000000,571,1173,1744
9/20/2013 10:47,10,5000000,805,1207,2012
9/20/2013 10:47,10,5000000,785,1195,1980
9/20/2013 10:47,10,5000000,618,1133,1751
9/20/2013 10:47,10,5000000,621,1182,1803
9/20/2013 10:47,10,5000000,708,1192,1900
9/20/2013 10:47,10,5000000,870,1108,1978
9/20/2013 10:47,10,5000000,658,1116,1774
9/20/2013 10:47,10,5000000,600,1191,1791
9/20/2013 10:47,10,5000000,660,1196,1856
9/20/2013 10:47,10,5000000,651,1124,1775
9/20/2013 10:47,10,5000000,627,1139,1766
9/20/2013 10:47,10,5000000,800,1195,1995
9/20/2013 10:48,10,5000000,629,1218,1847
9/20/2013 10:48,10,5000000,649,1170,1819
9/20/2013 10:48,10,5000000,601,1192,1793
9/20/2013 10:48,10,5000000,831,1136,1967
9/20/2013 10:48,10,5000000,810,1219,2029
9/20/2013 10:48,10,5000000,674,1235,1909
9/20/2013 10:48,10,5000000,636,1216,1852
9/20/2013 10:48,10,5000000,630,1515,2145
9/20/2013 10:48,10,5000000,618,1220,1838
9/20/2013 10:48,10,5000000,616,1175,1791
9/20/2013 10:48,10,5000000,647,1198,1845
9/20/2013 10:48,10,5000000,836,1201,2037
9/20/2013 10:48,10,5000000,869,1194,2063
9/20/2013 10:49,10,5000000,1046,1244,2290
9/20/2013 10:49,10,5000000,1419,1194,2613
9/20/2013 10:49,10,5000000,629,1133,1762
9/20/2013 10:49,10,5000000,775,1114,1889
9/20/2013 10:49,10,5000000,633,1194,1827
9/20/2013 10:49,10,5000000,632,1166,1798
9/20/2013 10:49,10,5000000,669,1174,1843
9/20/2013 10:49,10,5000000,651,1233,1884
9/20/2013 10:49,10,5000000,663,1216,1879
9/20/2013 10:49,10,5000000,686,1106,1792
9/20/2013 10:49,10,5000000,1412,1204,2616
9/20/2013 10:49,10,5000000,1545,1201,2746
9/20/2013 10:49,10,5000000,816,1169,1985
9/20/2013 10:50,10,5000000,786,1190,1976
9/20/2013 10:50,10,5000000,671,1234,1905
9/20/2013 10:50,10,5000000,678,1109,1787
9/20/2013 10:50,10,5000000,820,1207,2027
9/20/2013 10:50,10,5000000,648,1217,1865
9/20/2013 10:50,10,5000000,1411,1164,2575
9/20/2013 10:50,10,5000000,1389,1209,2598
9/20/2013 10:50,10,5000000,640,1183,1823
9/20/2013 10:50,10,5000000,901,1228,2129
9/20/2013 10:50,10,5000000,655,1233,1888
9/20/2013 10:50,10,5000000,1412,1189,2601
9/20/2013 10:50,10,5000000,845,1174,2019
9/20/2013 10:50,10,5000000,656,1211,1867
9/20/2013 10:51,10,5000000,768,1211,1979
9/20/2013 10:51,10,5000000,651,1193,1844
9/20/2013 10:51,10,5000000,775,1196,1971
9/20/2013 10:51,10,5000000,763,1193,1956
9/20/2013 10:51,10,6000000,749,1321,2070
9/20/2013 10:51,10,6000000,882,1382,2264
9/20/2013 10:51,10,6000000,887,1395,2282
9/20/2013 10:51,10,6000000,787,1355,2142
9/20/2013 10:51,10,6000000,716,1383,2099
9/20/2013 10:51,10,6000000,762,1400,2162
9/20/2013 10:51,10,6000000,1522,1349,2871
9/20/2013 10:51,10,6000000,928,1398,2326
9/20/2013 10:52,10,6000000,746,1389,2135
9/20/2013 10:52,10,6000000,974,1356,2330
9/20/2013 10:52,10,6000000,1090,1387,2477
9/20/2013 10:52,10,6000000,807,1381,2188
9/20/2013 10:52,10,6000000,768,1321,2089
9/20/2013 10:52,10,6000000,1156,1341,2497
9/20/2013 10:52,10,6000000,1173,1363,2536
9/20/2013 10:52,10,6000000,758,1384,2142
9/20/2013 10:52,10,6000000,991,1357,2348
9/20/2013 10:52,10,6000000,978,1327,2305
9/20/2013 10:52,10,6000000,941,1394,2335
9/20/2013 10:52,10,6000000,806,1416,2222
9/20/2013 10:53,10,6000000,952,1392,2344
9/20/2013 10:53,10,6000000,778,1372,2150
9/20/2013 10:53,10,6000000,770,1389,2159
9/20/2013 10:53,10,6000000,828,1307,2135
9/20/2013 10:53,10,6000000,772,1428,2200
9/20/2013 10:53,10,6000000,874,1272,2146
9/20/2013 10:53,10,6000000,811,1328,2139
9/20/2013 10:53,10,6000000,859,1285,2144
9/20/2013 10:53,10,6000000,1550,1336,2886
9/20/2013 10:53,10,6000000,775,1375,2150
9/20/2013 10:53,10,6000000,979,1492,2471
9/20/2013 10:53,10,6000000,745,1402,2147
9/20/2013 10:54,10,6000000,821,1343,2164
9/20/2013 10:54,10,6000000,921,1318,2239
9/20/2013 10:54,10,6000000,942,1348,2290
9/20/2013 10:54,10,6000000,907,1314,2221
9/20/2013 10:54,10,6000000,848,1303,2151
9/20/2013 10:54,10,6000000,857,1270,2127
9/20/2013 10:54,10,6000000,1119,1337,2456
9/20/2013 10:54,10,6000000,810,1282,2092
9/20/2013 10:54,10,6000000,816,1342,2158
9/20/2013 10:54,10,6000000,771,1424,2195
9/20/2013 10:54,10,6000000,987,1328,2315
9/20/2013 10:54,10,6000000,847,1352,2199
9/20/2013 10:55,10,6000000,1140,1303,2443
9/20/2013 10:55,10,6000000,735,1407,2142
9/20/2013 10:55,10,6000000,836,1409,2245
9/20/2013 10:55,10,6000000,767,1395,2162
9/20/2013 10:55,10,6000000,887,1291,2178
9/20/2013 10:55,10,6000000,773,1353,2126
9/20/2013 10:55,10,6000000,768,1404,2172
9/20/2013 10:55,10,6000000,973,1339,2312
9/20/2013 10:55,10,6000000,996,1398,2394
9/20/2013 10:55,10,6000000,949,1441,2390
9/20/2013 10:55,10,6000000,1186,1317,2503
9/20/2013 10:55,10,6000000,782,1317,2099
9/20/2013 10:56,10,6000000,1476,1335,2811
9/20/2013 10:56,10,6000000,977,1319,2296
9/20/2013 10:56,10,6000000,1499,1325,2824
9/20/2013 10:56,10,6000000,899,1391,2290
9/20/2013 10:56,10,6000000,1494,1324,2818
9/20/2013 10:56,10,6000000,720,1374,2094
9/20/2013 10:56,10,6000000,877,1359,2236
9/20/2013 10:56,10,6000000,820,1316,2136
9/20/2013 10:56,10,6000000,893,1372,2265
9/20/2013 10:56,10,6000000,788,1418,2206
9/20/2013 10:56,10,6000000,844,1435,2279
9/20/2013 10:56,10,6000000,777,1329,2106
9/20/2013 10:57,10,6000000,1066,1313,2379
9/20/2013 10:57,10,6000000,758,1367,2125
9/20/2013 10:57,10,6000000,726,1380,2106
9/20/2013 10:57,10,6000000,1133,1313,2446
9/20/2013 10:57,10,6000000,778,1323,2101
9/20/2013 10:57,10,6000000,743,1408,2151
9/20/2013 10:57,10,6000000,1553,1337,2890
9/20/2013 10:57,10,6000000,848,1287,2135
9/20/2013 10:57,10,6000000,753,1394,2147
9/20/2013 10:57,10,6000000,899,1331,2230
9/20/2013 10:57,10,6000000,794,1327,2121
9/20/2013 10:57,10,6000000,783,1404,2187
9/20/2013 10:58,10,6000000,764,1385,2149
9/20/2013 10:58,10,6000000,869,1299,2168
9/20/2013 10:58,10,6000000,942,1376,2318
9/20/2013 10:58,10,6000000,932,1473,2405
9/20/2013 10:58,10,6000000,818,1330,2148
9/20/2013 10:58,10,6000000,785,1406,2191
9/20/2013 10:58,10,6000000,780,1357,2137
9/20/2013 10:58,10,6000000,914,1363,2277
9/20/2013 10:58,10,6000000,766,1346,2112
9/20/2013 10:58,10,6000000,1165,1395,2560
9/20/2013 10:58,10,6000000,982,1341,2323
9/20/2013 10:58,10,6000000,888,1329,2217
9/20/2013 10:58,10,6000000,850,1307,2157
9/20/2013 10:59,10,6000000,970,1336,2306
9/20/2013 10:59,10,6000000,1549,1354,2903
9/20/2013 10:59,10,6000000,765,1358,2123
9/20/2013 10:59,10,6000000,755,1398,2153
9/20/2013 10:59,10,6000000,897,1426,2323
9/20/2013 10:59,10,6000000,765,1292,2057
9/20/2013 10:59,10,6000000,933,1348,2281
9/20/2013 10:59,10,6000000,996,1313,2309
9/20/2013 10:59,10,6000000,828,1264,2092
9/20/2013 10:59,10,6000000,798,1355,2153
9/20/2013 10:59,10,6000000,820,1314,2134
9/20/2013 10:59,10,6000000,814,1316,2130
9/20/2013 11:00,10,6000000,774,1320,2094
9/20/2013 11:00,10,6000000,945,1350,2295
9/20/2013 11:00,10,6000000,786,1377,2163
9/20/2013 11:00,10,6000000,1529,1292,2821
9/20/2013 11:00,10,6000000,768,1368,2136
9/20/2013 11:00,10,6000000,836,1364,2200
9/20/2013 11:00,10,6000000,797,1329,2126
9/20/2013 11:00,10,6000000,728,1320,2048
9/20/2013 11:00,10,6000000,1503,1380,2883
9/20/2013 11:00,10,6000000,950,1392,2342
9/20/2013 11:00,10,7000000,1000,1542,2542
9/20/2013 11:01,10,7000000,1614,1622,3236
9/20/2013 11:01,10,7000000,929,1587,2516
9/20/2013 11:01,10,7000000,1633,1563,3196
9/20/2013 11:01,10,7000000,892,1577,2469
9/20/2013 11:01,10,7000000,1627,1625,3252
9/20/2013 11:01,10,7000000,937,1650,2587
9/20/2013 11:01,10,7000000,899,1533,2432
9/20/2013 11:01,10,7000000,1628,1503,3131
9/20/2013 11:01,10,7000000,1726,1605,3331
9/20/2013 11:01,10,7000000,1000,1562,2562
9/20/2013 11:01,10,7000000,948,1547,2495
9/20/2013 11:02,10,7000000,959,1612,2571
9/20/2013 11:02,10,7000000,855,1607,2462
9/20/2013 11:02,10,7000000,1601,1559,3160
9/20/2013 11:02,10,7000000,894,1590,2484
9/20/2013 11:02,10,7000000,931,1567,2498
9/20/2013 11:02,10,7000000,1738,1537,3275
9/20/2013 11:02,10,7000000,1671,1542,3213
9/20/2013 11:02,10,7000000,1021,1513,2534
9/20/2013 11:02,10,7000000,927,1537,2464
9/20/2013 11:02,10,7000000,894,1553,2447
9/20/2013 11:02,10,7000000,914,1570,2484
9/20/2013 11:03,10,7000000,923,1536,2459
9/20/2013 11:03,10,7000000,1032,1648,2680
9/20/2013 11:03,10,7000000,1023,1537,2560
9/20/2013 11:03,10,7000000,1131,1544,2675
9/20/2013 11:03,10,7000000,983,1646,2629
9/20/2013 11:03,10,7000000,1609,1533,3142
9/20/2013 11:03,10,7000000,1314,1628,2942
9/20/2013 11:03,10,7000000,946,1531,2477
9/20/2013 11:03,10,7000000,1596,1541,3137
9/20/2013 11:03,10,7000000,1699,1594,3293
9/20/2013 11:03,10,7000000,1522,1545,3067
9/20/2013 11:04,10,7000000,901,1657,2558
9/20/2013 11:04,10,7000000,1713,1532,3245
9/20/2013 11:04,10,7000000,1567,1588,3155
9/20/2013 11:04,10,7000000,980,1596,2576
9/20/2013 11:04,10,7000000,954,1576,2530
9/20/2013 11:04,10,7000000,968,1551,2519
9/20/2013 11:04,10,7000000,847,1532,2379
9/20/2013 11:04,10,7000000,1242,1547,2789
9/20/2013 11:04,10,7000000,1056,1519,2575
9/20/2013 11:04,10,7000000,931,1575,2506
9/20/2013 11:04,10,7000000,938,1571,2509
9/20/2013 11:05,10,7000000,877,1566,2443
9/20/2013 11:05,10,7000000,1076,1637,2713
9/20/2013 11:05,10,7000000,1272,1571,2843
9/20/2013 11:05,10,7000000,864,1544,2408
9/20/2013 11:05,10,7000000,1521,1631,3152
9/20/2013 11:05,10,7000000,855,1548,2403
9/20/2013 11:05,10,7000000,907,1572,2479
9/20/2013 11:05,10,7000000,941,1577,2518
9/20/2013 11:05,10,7000000,891,1542,2433
9/20/2013 11:05,10,7000000,1133,1636,2769
9/20/2013 11:05,10,7000000,1492,1546,3038
9/20/2013 11:06,10,7000000,935,1559,2494
9/20/2013 11:06,10,7000000,1689,1536,3225
9/20/2013 11:06,10,7000000,1089,1568,2657
9/20/2013 11:06,10,7000000,1613,1540,3153
9/20/2013 11:06,10,7000000,1639,1648,3287
9/20/2013 11:06,10,7000000,948,1544,2492
9/20/2013 11:06,10,7000000,1722,1541,3263
9/20/2013 11:06,10,7000000,1066,1564,2630
9/20/2013 11:06,10,7000000,1073,1531,2604
9/20/2013 11:06,10,7000000,1097,1613,2710
9/20/2013 11:06,10,7000000,940,1585,2525
9/20/2013 11:07,10,7000000,1657,1573,3230
9/20/2013 11:07,10,7000000,1074,1619,2693
9/20/2013 11:07,10,7000000,1588,1625,3213
9/20/2013 11:07,10,7000000,1141,1576,2717
9/20/2013 11:07,10,7000000,1173,1535,2708
9/20/2013 11:07,10,7000000,1111,1604,2715
9/20/2013 11:07,10,7000000,960,1559,2519
9/20/2013 11:07,10,7000000,963,1602,2565
9/20/2013 11:07,10,7000000,929,1597,2526
9/20/2013 11:07,10,7000000,1330,1541,2871
9/20/2013 11:08,10,7000000,1700,1644,3344
9/20/2013 11:08,10,7000000,1686,1594,3280
9/20/2013 11:08,10,7000000,1659,1511,3170
9/20/2013 11:08,10,7000000,1132,1627,2759
9/20/2013 11:08,10,7000000,1288,1606,2894
9/20/2013 11:08,10,7000000,1007,1583,2590
9/20/2013 11:08,10,7000000,949,1552,2501
9/20/2013 11:08,10,7000000,883,1593,2476
9/20/2013 11:08,10,7000000,1365,1570,2935
9/20/2013 11:08,10,7000000,1122,1657,2779
9/20/2013 11:08,10,7000000,882,1572,2454
9/20/2013 11:09,10,7000000,1124,1662,2786
9/20/2013 11:09,10,7000000,954,1550,2504
9/20/2013 11:09,10,7000000,918,1577,2495
9/20/2013 11:09,10,7000000,934,1597,2531
9/20/2013 11:09,10,7000000,897,1584,2481
9/20/2013 11:09,10,7000000,933,1522,2455
9/20/2013 11:09,10,7000000,997,1490,2487
9/20/2013 11:09,10,7000000,951,1627,2578
9/20/2013 11:09,10,7000000,1295,1559,2854
9/20/2013 11:09,10,7000000,893,1623,2516
9/20/2013 11:09,10,7000000,1080,1549,2629
9/20/2013 11:10,10,7000000,873,1543,2416
9/20/2013 11:10,10,7000000,980,1579,2559
9/20/2013 11:10,10,7000000,880,1551,2431
9/20/2013 11:10,10,7000000,1627,1571,3198
9/20/2013 11:10,10,7000000,1245,1565,2810
9/20/2013 11:10,10,7000000,1153,1645,2798
9/20/2013 11:44,10,7000000,923,1554,2477
9/20/2013 11:44,10,7000000,930,1529,2459
9/20/2013 11:44,10,7000000,898,1551,2449
9/20/2013 11:44,10,7000000,907,1582,2489
9/20/2013 11:44,10,7000000,917,1567,2484
9/20/2013 11:44,10,7000000,873,1622,2495
9/20/2013 11:44,10,7000000,873,1535,2408
9/20/2013 11:44,10,7000000,1142,1574,2716
9/20/2013 11:44,10,7000000,1238,1552,2790
9/20/2013 11:44,10,8000000,1060,1864,2924
9/20/2013 11:44,10,8000000,1381,1877,3258
9/20/2013 11:45,10,8000000,989,1895,2884
9/20/2013 11:45,10,8000000,1722,1797,3519
9/20/2013 11:45,10,8000000,1690,1772,3462
9/20/2013 11:45,10,8000000,1125,1768,2893
9/20/2013 11:45,10,8000000,1019,1854,2873
9/20/2013 11:45,10,8000000,1298,1775,3073
9/20/2013 11:45,10,8000000,1204,1762,2966
9/20/2013 11:45,10,8000000,1866,1779,3645
9/20/2013 11:45,10,8000000,1396,1795,3191
9/20/2013 11:45,10,8000000,1088,1723,2811
9/20/2013 11:46,10,8000000,1744,1886,3630
9/20/2013 11:46,10,8000000,1737,1777,3514
9/20/2013 11:46,10,8000000,1335,1793,3128
9/20/2013 11:46,10,8000000,1055,1706,2761
9/20/2013 11:46,10,8000000,1273,1876,3149
9/20/2013 11:46,10,8000000,1044,1872,2916
9/20/2013 11:46,10,8000000,1157,1781,2938
9/20/2013 11:46,10,8000000,1746,1796,3542
9/20/2013 11:46,10,8000000,961,1755,2716
9/20/2013 11:46,10,8000000,1081,1807,2888
9/20/2013 11:47,10,8000000,1352,1771,3123
9/20/2013 11:47,10,8000000,1023,1780,2803
9/20/2013 11:47,10,8000000,1062,1783,2845
9/20/2013 11:47,10,8000000,1188,1864,3052
9/20/2013 11:47,10,8000000,1055,1726,2781
9/20/2013 11:47,10,8000000,1048,1718,2766
9/20/2013 11:47,10,8000000,1174,1789,2963
9/20/2013 11:47,10,8000000,1158,1884,3042
9/20/2013 11:47,10,8000000,1214,1772,2986
9/20/2013 11:47,10,8000000,1034,1756,2790
9/20/2013 11:48,10,8000000,1161,1794,2955
9/20/2013 11:48,10,8000000,1415,1693,3108
9/20/2013 11:48,10,8000000,1187,1777,2964
9/20/2013 11:48,10,8000000,1413,1715,3128
9/20/2013 11:48,10,8000000,1078,1738,2816
9/20/2013 11:48,10,8000000,1370,1815,3185
9/20/2013 11:48,10,8000000,1326,1724,3050
9/20/2013 11:48,10,8000000,1705,1790,3495
9/20/2013 11:48,10,8000000,1157,1798,2955
9/20/2013 11:48,10,8000000,1191,1766,2957
9/20/2013 11:49,10,8000000,1043,1859,2902
9/20/2013 11:49,10,8000000,1093,1870,2963
9/20/2013 11:49,10,8000000,1691,1862,3553
9/20/2013 11:49,10,8000000,1019,1906,2925
9/20/2013 11:49,10,8000000,1101,1794,2895
9/20/2013 11:49,10,8000000,1030,1730,2760
9/20/2013 11:49,10,8000000,1098,1843,2941
9/20/2013 11:49,10,8000000,1703,1790,3493
9/20/2013 11:49,10,8000000,1014,1734,2748
9/20/2013 11:49,10,8000000,1131,1753,2884
9/20/2013 11:50,10,8000000,1073,1723,2796
9/20/2013 11:50,10,8000000,1445,1873,3318
9/20/2013 11:50,10,8000000,1052,1774,2826
9/20/2013 11:50,10,8000000,1007,1805,2812
9/20/2013 11:50,10,8000000,983,1769,2752
9/20/2013 11:50,10,8000000,1033,1810,2843
9/20/2013 11:50,10,8000000,1164,1713,2877
9/20/2013 11:50,10,8000000,1231,1764,2995
9/20/2013 11:50,10,8000000,1014,1816,2830
9/20/2013 11:50,10,8000000,1168,1785,2953
9/20/2013 11:50,10,8000000,1242,1734,2976
9/20/2013 11:51,10,8000000,993,1790,2783
9/20/2013 11:51,10,8000000,895,1793,2688
9/20/2013 11:51,10,8000000,1328,2111,3439
9/20/2013 11:51,10,8000000,1090,1780,2870
9/20/2013 11:51,10,8000000,1056,1697,2753
9/20/2013 11:51,10,8000000,1716,1821,3537
9/20/2013 11:51,10,8000000,1044,1795,2839
9/20/2013 11:51,10,8000000,1227,1789,3016
9/20/2013 11:51,10,8000000,1039,1737,2776
9/20/2013 11:51,10,8000000,1174,1808,2982
9/20/2013 11:52,10,8000000,1036,1791,2827
9/20/2013 11:52,10,8000000,1154,1780,2934
9/20/2013 11:52,10,8000000,1153,1825,2978
9/20/2013 11:52,10,8000000,1226,1759,2985
9/20/2013 11:52,10,8000000,1185,1926,3111
9/20/2013 11:52,10,8000000,1085,1901,2986
9/20/2013 11:52,10,8000000,1286,1832,3118
9/20/2013 11:52,10,8000000,1032,1881,2913
9/20/2013 11:52,10,8000000,1053,1792,2845
9/20/2013 11:52,10,8000000,1214,1739,2953
9/20/2013 11:53,10,8000000,1079,1743,2822
9/20/2013 11:53,10,8000000,1083,1783,2866
9/20/2013 11:53,10,8000000,1202,1761,2963
9/20/2013 11:53,10,8000000,1729,1769,3498
9/20/2013 11:53,10,8000000,1045,1735,2780
9/20/2013 11:53,10,8000000,1082,1740,2822
9/20/2013 11:53,10,8000000,1160,1759,2919
9/20/2013 11:53,10,8000000,1059,1704,2763
9/20/2013 11:53,10,8000000,1016,1834,2850
9/20/2013 11:53,10,8000000,1125,1806,2931
9/20/2013 11:53,10,8000000,1753,1779,3532
9/20/2013 11:54,10,8000000,1050,1835,2885
9/20/2013 11:54,10,8000000,1041,1886,2927
9/20/2013 11:54,10,8000000,1040,1829,2869
9/20/2013 11:54,10,8000000,1188,1911,3099
9/20/2013 11:54,10,8000000,1779,1701,3480
9/20/2013 11:54,10,8000000,1764,1739,3503
9/20/2013 11:54,10,8000000,1110,1814,2924
9/20/2013 11:54,10,8000000,1032,1783,2815
9/20/2013 11:54,10,8000000,1180,1772,2952
9/20/2013 11:54,10,8000000,1092,1796,2888
9/20/2013 11:55,10,8000000,1155,1894,3049
9/20/2013 11:55,10,8000000,1110,1718,2828
9/20/2013 11:55,10,8000000,1203,1844,3047
9/20/2013 11:55,10,8000000,1230,1708,2938
9/20/2013 11:55,10,8000000,1130,1804,2934
9/20/2013 11:55,10,8000000,1052,1759,2811
9/20/2013 11:55,10,8000000,1819,1774,3593
9/20/2013 11:55,10,8000000,1150,1871,3021
9/20/2013 11:55,10,8000000,1385,1815,3200
9/20/2013 11:55,10,8000000,1611,1844,3455
9/20/2013 11:56,10,8000000,1694,1899,3593
9/20/2013 11:56,10,9000000,1239,2073,3312
9/20/2013 11:56,10,9000000,1717,2144,3861
9/20/2013 11:56,10,9000000,1159,1978,3137
9/20/2013 11:56,10,9000000,1238,2225,3463
9/20/2013 11:56,10,9000000,1337,2168,3505
9/20/2013 11:56,10,9000000,1781,1935,3716
9/20/2013 11:56,10,9000000,1229,2063,3292
9/20/2013 11:56,10,9000000,1677,2154,3831
9/20/2013 11:57,10,9000000,1271,1968,3239
9/20/2013 11:57,10,9000000,1877,2155,4032
9/20/2013 11:57,10,9000000,1750,2156,3906
9/20/2013 11:57,10,9000000,1249,2125,3374
9/20/2013 11:57,10,9000000,1500,1976,3476
9/20/2013 11:57,10,9000000,1223,2179,3402
9/20/2013 11:57,10,9000000,1131,2146,3277
9/20/2013 11:57,10,9000000,1174,2128,3302
9/20/2013 11:57,10,9000000,1216,2040,3256
9/20/2013 11:57,10,9000000,1194,1984,3178
9/20/2013 11:58,10,9000000,1152,2166,3318
9/20/2013 11:58,10,9000000,1085,2027,3112
9/20/2013 11:58,10,9000000,1125,1981,3106
9/20/2013 11:58,10,9000000,1236,1971,3207
9/20/2013 11:58,10,9000000,1248,2125,3373
9/20/2013 11:58,10,9000000,1362,2103,3465
9/20/2013 11:58,10,9000000,1316,2186,3502
9/20/2013 11:58,10,9000000,1113,1985,3098
9/20/2013 11:58,10,9000000,1342,2126,3468
9/20/2013 11:58,10,9000000,1105,1990,3095
9/20/2013 11:59,10,9000000,1482,2260,3742
9/20/2013 11:59,10,9000000,1891,1968,3859
9/20/2013 11:59,10,9000000,1348,2103,3451
9/20/2013 11:59,10,9000000,1201,2149,3350
9/20/2013 11:59,10,9000000,1130,1950,3080
9/20/2013 11:59,10,9000000,1223,1969,3192
9/20/2013 11:59,10,9000000,1187,2154,3341
9/20/2013 11:59,10,9000000,1227,2051,3278
9/20/2013 11:59,10,9000000,1129,1957,3086
9/21/2013 12:00,10,9000000,1186,2150,3336
9/21/2013 12:00,10,9000000,1927,2250,4177
9/21/2013 12:00,10,9000000,1307,2207,3514
9/21/2013 12:00,10,9000000,1462,2121,3583
9/21/2013 12:00,10,9000000,1191,2113,3304
9/21/2013 12:00,10,9000000,1401,1986,3387
9/21/2013 12:00,10,9000000,1492,1938,3430
9/21/2013 12:00,10,9000000,1851,2150,4001
9/21/2013 12:00,10,9000000,1229,1967,3196
9/21/2013 12:01,10,9000000,1346,1951,3297
9/21/2013 12:01,10,9000000,1821,2258,4079
9/21/2013 12:01,10,9000000,1198,2194,3392
9/21/2013 12:01,10,9000000,1342,1948,3290
9/21/2013 12:01,10,9000000,1217,2113,3330
9/21/2013 12:01,10,9000000,1302,1914,3216
9/21/2013 12:01,10,9000000,1834,2233,4067
9/21/2013 12:01,10,9000000,1140,1945,3085
9/21/2013 12:01,10,9000000,1169,2133,3302
9/21/2013 12:01,10,9000000,1189,2220,3409
9/21/2013 12:02,10,9000000,1342,1968,3310
9/21/2013 12:02,10,9000000,1480,2199,3679
9/21/2013 12:02,10,9000000,1178,2664,3842
9/21/2013 12:02,10,9000000,1226,2065,3291
9/21/2013 12:02,10,9000000,1143,2022,3165
9/21/2013 12:02,10,9000000,1264,2171,3435
9/21/2013 12:02,10,9000000,1202,1961,3163
9/21/2013 12:02,10,9000000,1189,1946,3135
9/21/2013 12:02,10,9000000,1440,2256,3696
9/21/2013 12:03,10,9000000,1215,2031,3246
9/21/2013 12:03,10,9000000,1209,2224,3433
9/21/2013 12:03,10,9000000,1403,2239,3642
9/21/2013 12:03,10,9000000,1206,1943,3149
9/21/2013 12:03,10,9000000,1396,1958,3354
9/21/2013 12:03,10,9000000,1260,1966,3226
9/21/2013 12:03,10,9000000,1396,1999,3395
9/21/2013 12:03,10,9000000,1173,2120,3293
9/21/2013 12:03,10,9000000,1226,1972,3198
9/21/2013 12:03,10,9000000,1079,2120,3199
9/21/2013 12:04,10,9000000,1646,2191,3837
9/21/2013 12:04,10,9000000,1613,1962,3575
9/21/2013 12:04,10,9000000,1286,2187,3473
9/21/2013 12:04,10,9000000,1132,1983,3115
9/21/2013 12:04,10,9000000,1090,1966,3056
9/21/2013 12:04,10,9000000,1355,2067,3422
9/21/2013 12:04,10,9000000,1519,1907,3426
9/21/2013 12:04,10,9000000,1273,2164,3437
9/21/2013 12:04,10,9000000,1164,1946,3110
9/21/2013 12:05,10,9000000,1779,2159,3938
9/21/2013 12:05,10,9000000,1229,1933,3162
9/21/2013 12:05,10,9000000,1221,2027,3248
9/21/2013 12:05,10,9000000,1081,1992,3073
9/21/2013 12:05,10,9000000,1070,2126,3196
9/21/2013 12:05,10,9000000,1059,2017,3076
9/21/2013 12:05,10,9000000,1719,2152,3871
9/21/2013 12:05,10,9000000,1188,2105,3293
9/21/2013 12:05,10,9000000,1710,2070,3780
9/21/2013 12:05,10,9000000,1277,1992,3269
9/21/2013 12:06,10,9000000,1194,2176,3370
9/21/2013 12:06,10,9000000,1127,2138,3265
9/21/2013 12:06,10,9000000,1317,2157,3474
9/21/2013 12:06,10,9000000,1319,2106,3425
9/21/2013 12:06,10,9000000,1172,2135,3307
9/21/2013 12:06,10,9000000,1442,1947,3389
9/21/2013 12:06,10,9000000,1287,1960,3247
9/21/2013 12:06,10,9000000,1712,1996,3708
9/21/2013 12:06,10,9000000,1192,2120,3312
9/21/2013 12:07,10,9000000,1389,1978,3367
9/21/2013 12:07,10,9000000,1864,1963,3827
9/21/2013 12:07,10,9000000,1404,2201,3605
9/21/2013 12:07,10,9000000,1101,2174,3275
9/21/2013 12:07,10,9000000,1358,2110,3468
9/21/2013 12:07,10,9000000,1398,1986,3384
9/21/2013 12:07,10,9000000,1223,2010,3233
9/21/2013 12:07,10,9000000,1245,2141,3386
9/21/2013 12:07,10,9000000,1481,1963,3444
9/21/2013 12:07,10,9000000,1236,1958,3194
9/21/2013 12:08,10,9000000,1111,1943,3054
9/21/2013 12:08,10,9000000,1205,1943,3148
9/21/2013 12:08,10,10000000,1568,2254,3822
9/21/2013 12:08,10,10000000,1793,2145,3938
9/21/2013 12:08,10,10000000,1304,2403,3707
9/21/2013 12:08,10,10000000,1436,2481,3917
9/21/2013 12:08,10,10000000,1394,2469,3863
9/21/2013 12:08,10,10000000,1299,2512,3811
9/21/2013 12:08,10,10000000,1436,2201,3637
9/21/2013 12:09,10,10000000,1306,2260,3566
9/21/2013 12:09,10,10000000,1337,2152,3489
9/21/2013 12:09,10,10000000,1418,2177,3595
9/21/2013 12:09,10,10000000,1810,2111,3921
9/21/2013 12:09,10,10000000,1856,2217,4073
9/21/2013 12:09,10,10000000,1333,2437,3770
9/21/2013 12:09,10,10000000,1259,2223,3482
9/21/2013 12:09,10,10000000,1307,2397,3704
9/21/2013 12:09,10,10000000,1474,2438,3912
9/21/2013 12:10,10,10000000,1427,2160,3587
9/21/2013 12:10,10,10000000,1709,2135,3844
9/21/2013 12:10,10,10000000,1398,2463,3861
9/21/2013 12:10,10,10000000,1771,2192,3963
9/21/2013 12:10,10,10000000,1417,2421,3838
9/21/2013 12:10,10,10000000,1550,2455,4005
9/21/2013 12:10,10,10000000,1513,2438,3951
9/21/2013 12:10,10,10000000,1512,2113,3625
9/21/2013 12:10,10,10000000,1197,2216,3413
9/21/2013 12:11,10,10000000,1526,2508,4034
9/21/2013 12:11,10,10000000,1476,2389,3865
9/21/2013 12:11,10,10000000,1349,2406,3755
9/21/2013 12:11,10,10000000,1418,2406,3824
9/21/2013 12:11,10,10000000,1402,2499,3901
9/21/2013 12:11,10,10000000,1605,2129,3734
9/21/2013 12:11,10,10000000,1424,2386,3810
9/21/2013 12:11,10,10000000,1319,2526,3845
9/21/2013 12:11,10,10000000,1519,2230,3749
9/21/2013 12:12,10,10000000,1351,2176,3527
9/21/2013 12:12,10,10000000,1632,2108,3740
9/21/2013 12:12,10,10000000,1283,2406,3689
9/21/2013 12:12,10,10000000,1276,2163,3439
9/21/2013 12:12,10,10000000,1882,2405,4287
9/21/2013 12:12,10,10000000,1805,2401,4206
9/21/2013 12:12,10,10000000,1540,2465,4005
9/21/2013 12:12,10,10000000,1669,2482,4151
9/21/2013 12:12,10,10000000,1652,2459,4111
9/21/2013 12:13,10,10000000,1388,2086,3474
9/21/2013 12:13,10,10000000,1536,2152,3688
9/21/2013 12:13,10,10000000,1265,2360,3625
9/21/2013 12:13,10,10000000,1387,2169,3556
9/21/2013 12:13,10,10000000,1332,2195,3527
9/21/2013 12:13,10,10000000,1358,2181,3539
9/21/2013 12:13,10,10000000,1165,2238,3403
9/21/2013 12:13,10,10000000,1274,2200,3474
9/21/2013 12:13,10,10000000,1446,2142,3588
9/21/2013 12:14,10,10000000,1554,2433,3987
9/21/2013 12:14,10,10000000,1237,2265,3502
9/21/2013 12:14,10,10000000,1521,2383,3904
9/21/2013 12:14,10,10000000,1322,2488,3810
9/21/2013 12:14,10,10000000,1816,2161,3977
9/21/2013 12:14,10,10000000,1923,2128,4051
9/21/2013 12:14,10,10000000,1333,2204,3537
9/21/2013 12:14,10,10000000,1338,2446,3784
9/21/2013 12:15,10,10000000,1188,2208,3396
9/21/2013 12:15,10,10000000,1672,2416,4088
9/21/2013 12:15,10,10000000,1288,2525,3813
9/21/2013 12:15,10,10000000,2014,2441,4455
9/21/2013 12:15,10,10000000,1914,2226,4140
9/21/2013 12:15,10,10000000,1222,2169,3391
9/21/2013 12:15,10,10000000,1474,2177,3651
9/21/2013 12:15,10,10000000,1228,2171,3399
9/21/2013 12:15,10,10000000,1382,2359,3741
9/21/2013 12:32,10,10000000,1812,2187,3999
9/21/2013 12:32,10,10000000,1375,2479,3854
9/21/2013 12:32,10,10000000,1767,2343,4110
9/21/2013 12:33,10,10000000,1287,2204,3491
9/21/2013 12:33,10,10000000,1259,2156,3415
9/21/2013 12:33,10,10000000,1267,2429,3696
9/21/2013 12:33,10,10000000,1232,2210,3442
9/21/2013 12:33,10,10000000,1399,2104,3503
9/21/2013 12:33,10,10000000,1689,2076,3765
9/21/2013 12:33,10,10000000,1383,2393,3776
9/21/2013 12:33,10,10000000,1468,2401,3869
9/21/2013 12:33,10,10000000,1341,2179,3520
9/21/2013 12:34,10,10000000,1289,2369,3658
9/21/2013 12:34,10,10000000,1344,2159,3503
9/21/2013 12:34,10,10000000,1265,2350,3615
9/21/2013 12:34,10,10000000,1567,2181,3748
9/21/2013 12:34,10,10000000,1458,2113,3571
9/21/2013 12:34,10,10000000,1414,2395,3809
9/21/2013 12:34,10,10000000,1258,2431,3689
9/21/2013 12:34,10,10000000,1275,2192,3467
9/21/2013 12:34,10,10000000,1796,2176,3972
9/21/2013 12:35,10,10000000,1251,2155,3406
9/21/2013 12:35,10,10000000,1407,2378,3785
9/21/2013 12:35,10,10000000,1284,2387,3671
9/21/2013 12:35,10,10000000,1294,2131,3425
9/21/2013 12:35,10,10000000,1209,2125,3334
9/21/2013 12:35,10,10000000,1288,2429,3717
9/21/2013 12:35,10,10000000,1414,2456,3870
9/21/2013 12:35,10,10000000,1435,2305,3740
9/21/2013 12:35,10,10000000,1399,2128,3527
9/21/2013 12:36,10,10000000,1236,2150,3386
9/21/2013 12:36,10,10000000,1862,2283,4145
9/21/2013 12:36,10,10000000,1278,2199,3477
9/21/2013 12:36,10,10000000,1375,2129,3504
9/21/2013 12:36,10,10000000,1797,2171,3968
9/21/2013 12:36,10,10000000,1842,2227,4069
9/21/2013 12:36,10,10000000,1449,2493,3942
9/21/2013 12:36,10,10000000,1333,2495,3828
9/21/2013 12:36,10,10000000,1173,2244,3417
9/21/2013 12:37,10,10000000,1274,2237,3511
9/21/2013 12:37,10,10000000,1245,2189,3434
9/21/2013 12:37,10,10000000,1822,2101,3923
9/21/2013 12:37,10,10000000,1896,2487,4383
9/21/2013 12:37,10,10000000,1389,2462,3851
9/21/2013 12:37,10,10000000,1576,2536,4112
9/21/2013 12:37,10,10000000,1612,2412,4024
9/21/2013 12:37,10,10000000,1320,2222,3542
9/21/2013 12:38,10,10000000,1866,2402,4268
9/21/2013 12:38,10,10000000,1567,2149,3716
9/21/2013 12:38,10,10000000,1739,2191,3930
9/21/2013 12:38,10,10000000,1269,2481,3750
9/21/2013 12:38,10,10000000,1436,2413,3849
9/21/2013 12:38,10,10000000,1280,2376,3656
9/21/2013 12:38,10,10000000,1216,2110,3326
9/21/2013 12:38,10,10000000,1331,2144,3475
9/21/2013 12:38,10,10000000,1428,2128,3556
9/21/2013 12:39,10,10000000,1263,2430,3693
9/21/2013 12:39,10,10000000,1306,2109,3415
9/21/2013 12:39,10,10000000,1314,2137,3451
9/21/2013 12:39,10,10000000,1462,2447,3909
9/21/2013 12:39,10,10000000,1279,2366,3645
9/21/2013 12:39,10,10000000,1320,2353,3673
9/21/2013 12:39,10,10000000,1304,2162,3466
9/21/2013 12:39,10,10000000,1549,2431,3980
9/21/2013 12:39,10,10000000,1538,2490,4028
9/21/2013 12:39,10,10000000,1465,2110,3575
9/21/2013 12:40,10,10000000,1310,2176,3486
9/21/2013 12:40,10,10000000,1616,2243,3859
9/21/2013 12:40,10,10000000,1342,2379,3721
9/21/2013 12:40,10,10000000,1183,2143,3326
9/21/2013 12:40,10,10000000,1708,2179,3887
9/21/2013 12:40,10,10000000,1445,2459,3904
9/21/2013 12:40,10,10000000,1453,2126,3579
9/21/2013 12:40,10,10000000,1747,2179,3926
9/21/2013 12:40,10,10000000,1368,2182,3550
9/21/2013 12:41,10,10000000,1466,2476,3942
9/21/2013 12:41,10,10000000,1232,2443,3675
9/21/2013 12:41,10,10000000,1772,2196,3968
9/21/2013 12:41,10,10000000,1405,2147,3552
9/21/2013 12:41,10,10000000,1347,2426,3773
9/21/2013 12:41,10,10000000,1213,2192,3405
9/21/2013 12:41,10,10000000,1249,2214,3463
9/21/2013 12:41,10,10000000,1355,2450,3805
9/21/2013 12:41,10,10000000,1481,2388,3869
9/21/2013 12:42,10,10000000,1415,2382,3797
9/21/2013 12:42,10,10000000,1404,2436,3840
9/21/2013 12:42,10,10000000,1305,2424,3729
9/21/2013 12:42,10,10000000,1767,2214,3981
9/21/2013 12:42,10,10000000,1411,2136,3547
9/21/2013 12:42,10,10000000,1480,2462,3942
9/21/2013 12:42,10,10000000,1273,2144,3417
9/21/2013 12:42,10,10000000,1297,2453,3750
9/21/2013 12:42,10,10000000,1512,2439,3951
9/21/2013 12:43,10,10000000,1633,2128,3761
9/21/2013 12:43,10,10000000,1337,2207,3544
9/21/2013 12:43,10,10000000,1832,2997,4829
9/21/2013 12:43,10,10000000,1880,2491,4371
9/21/2013 12:43,10,10000000,1408,2411,3819
9/21/2013 12:43,10,10000000,1610,2183,3793
9/21/2013 12:43,10,10000000,1517,2356,3873
9/21/2013 12:43,10,10000000,1213,2346,3559
9/21/2013 12:44,10,10000000,1759,2463,4222
9/21/2013 12:44,10,10000000,1379,2113,3492
9/21/2013 12:44,10,10000000,1209,2200,3409
9/21/2013 12:44,10,10000000,1235,2218,3453
9/21/2013 12:44,10,10000000,1528,2201,3729
9/21/2013 12:44,10,10000000,1282,2395,3677
9/21/2013 12:44,10,10000000,1452,2129,3581
9/21/2013 12:44,10,10000000,1267,2387,3654
9/21/2013 12:44,10,10000000,1378,2161,3539
9/21/2013 12:45,10,10000000,1604,2169,3773
9/21/2013 12:45,10,10000000,1266,2166,3432
9/21/2013 12:45,10,10000000,1556,2444,4000
9/21/2013 12:45,10,10000000,1323,2403,3726
9/21/2013 12:45,10,10000000,1573,2518,4091
9/21/2013 12:45,10,10000000,1802,2224,4026
9/21/2013 12:45,10,10000000,1829,2217,4046
9/21/2013 12:45,10,10000000,1828,2168,3996
9/21/2013 12:45,10,10000000,1855,2435,4290
9/21/2013 12:46,10,10000000,1606,2085,3691
9/21/2013 12:46,10,10000000,1302,2391,3693
9/21/2013 12:46,10,10000000,1308,2417,3725
9/21/2013 12:46,10,10000000,1412,2490,3902
9/21/2013 12:46,10,10000000,1467,2215,3682
9/21/2013 12:46,10,10000000,1283,2192,3475
9/21/2013 12:46,10,10000000,1771,2198,3969
9/21/2013 12:46,10,10000000,1674,2417,4091
9/21/2013 12:46,10,10000000,1301,2400,3701
9/21/2013 12:47,10,10000000,1501,2404,3905
9/21/2013 12:47,10,10000000,1198,2191,3389
9/21/2013 12:47,10,10000000,1336,2201,3537
9/21/2013 12:47,10,10000000,1386,2380,3766
9/21/2013 12:47,10,10000000,1237,2427,3664
9/21/2013 12:47,10,10000000,1440,2115,3555
9/21/2013 12:47,10,10000000,1758,2158,3916
9/21/2013 12:47,10,10000000,1717,2353,4070
9/21/2013 12:47,10,10000000,1938,2162,4100
9/21/2013 12:48,10,10000000,1444,2240,3684
9/21/2013 12:48,10,10000000,1262,2377,3639
9/21/2013 12:48,10,10000000,1448,2213,3661
9/21/2013 12:48,10,10000000,1440,2182,3622
9/21/2013 12:48,10,10000000,1781,2112,3893
9/21/2013 12:48,10,10000000,1438,2189,3627
9/21/2013 12:48,10,10000000,1506,2414,3920
9/21/2013 12:48,10,10000000,1399,2382,3781
9/21/2013 12:48,10,10000000,1515,2413,3928
9/21/2013 12:49,10,10000000,1476,2384,3860
9/21/2013 12:49,10,10000000,1418,2140,3558
9/21/2013 12:49,10,10000000,1637,2144,3781
9/21/2013 12:49,10,10000000,1299,2194,3493
9/21/2013 12:49,10,10000000,1358,2347,3705
9/21/2013 12:49,10,10000000,1334,2123,3457
9/21/2013 12:49,10,10000000,1277,2137,3414
9/21/2013 12:49,10,10000000,1440,2542,3982
9/21/2013 12:49,10,10000000,1412,2323,3735
9/21/2013 12:50,10,10000000,1333,2467,3800
9/21/2013 12:50,10,10000000,1309,2299,3608
9/21/2013 12:50,10,10000000,1393,2127,3520
9/21/2013 12:50,10,10000000,1431,2469,3900
9/21/2013 12:50,10,10000000,1682,2288,3970
9/21/2013 12:50,10,20000000,2994,4273,7267
9/21/2013 12:50,10,20000000,3081,4239,7320
9/21/2013 12:51,10,20000000,3205,4327,7532
9/21/2013 12:51,10,20000000,3312,4155,7467
9/21/2013 12:51,10,20000000,3132,4169,7301
9/21/2013 12:51,10,20000000,2960,4339,7299
9/21/2013 12:51,10,20000000,3032,4163,7195
9/21/2013 12:51,10,20000000,3090,4177,7267
9/21/2013 12:52,10,20000000,3020,4138,7158
9/21/2013 12:52,10,20000000,2938,4304,7242
9/21/2013 12:52,10,20000000,3097,4171,7268
9/21/2013 12:52,10,20000000,2967,4124,7091
9/21/2013 12:52,10,20000000,3039,4176,7215
9/21/2013 12:52,10,20000000,3126,4189,7315
9/21/2013 12:53,10,20000000,2816,4260,7076
9/21/2013 12:53,10,20000000,3008,4218,7226
9/21/2013 12:53,10,20000000,3229,4189,7418
9/21/2013 12:53,10,20000000,3108,4159,7267
9/21/2013 12:53,10,20000000,3045,4138,7183
9/21/2013 12:54,10,20000000,2967,4329,7296
9/21/2013 12:54,10,20000000,2955,4500,7455
9/21/2013 12:54,10,20000000,3074,4163,7237
9/21/2013 12:54,10,20000000,2930,4385,7315
9/21/2013 12:54,10,20000000,3012,4184,7196
9/21/2013 12:54,10,20000000,3350,4200,7550
9/21/2013 12:55,10,20000000,3046,4147,7193
9/21/2013 12:55,10,20000000,2926,4414,7340
9/21/2013 12:55,10,20000000,3093,4191,7284
9/21/2013 12:55,10,20000000,3085,4421,7506
9/21/2013 12:55,10,20000000,3144,4172,7316
9/21/2013 12:55,10,20000000,3125,4185,7310
9/21/2013 12:56,10,20000000,3035,4188,7223
9/21/2013 12:56,10,20000000,2919,4160,7079
9/21/2013 12:56,10,20000000,2876,4355,7231
9/21/2013 12:56,10,20000000,2980,4233,7213
9/21/2013 12:56,10,20000000,3005,4676,7681
9/21/2013 12:57,10,20000000,3106,4182,7288
9/21/2013 12:57,10,20000000,2989,4287,7276
9/21/2013 12:57,10,20000000,3098,4258,7356
9/21/2013 12:57,10,20000000,2902,4188,7090
9/21/2013 12:57,10,20000000,2960,4349,7309
9/21/2013 12:57,10,20000000,3110,4221,7331
9/21/2013 12:58,10,20000000,3003,4206,7209
9/21/2013 12:58,10,20000000,3070,4274,7344
9/21/2013 12:58,10,20000000,2983,4220,7203
9/21/2013 12:58,10,20000000,3057,4246,7303
9/21/2013 12:58,10,20000000,3111,4297,7408
9/21/2013 12:58,10,20000000,3136,4189,7325
9/21/2013 12:59,10,20000000,3162,4129,7291
9/21/2013 12:59,10,20000000,3230,4183,7413
9/21/2013 12:59,10,20000000,3046,4157,7203
9/21/2013 12:59,10,20000000,2787,4426,7213
9/21/2013 12:59,10,20000000,3116,4200,7316
9/21/2013 1:00,10,20000000,2916,4250,7166
9/21/2013 1:00,10,20000000,2956,4368,7324
9/21/2013 1:00,10,20000000,3012,4254,7266
9/21/2013 1:00,10,20000000,3105,4279,7384
9/21/2013 1:00,10,20000000,2940,4349,7289
9/21/2013 1:00,10,20000000,3130,4187,7317
9/21/2013 1:01,10,20000000,2962,4208,7170
9/21/2013 1:01,10,20000000,3012,4143,7155
9/21/2013 1:01,10,20000000,3029,4147,7176
9/21/2013 1:01,10,20000000,2908,4223,7131
9/21/2013 1:01,10,20000000,3067,4337,7404
9/21/2013 1:01,10,20000000,3091,4591,7682
9/21/2013 1:02,10,20000000,3058,4153,7211
9/21/2013 1:02,10,20000000,2986,4271,7257
9/21/2013 1:02,10,20000000,3117,4238,7355
9/21/2013 1:02,10,20000000,3084,4260,7344
9/21/2013 1:02,10,20000000,2975,4356,7331
9/21/2013 1:03,10,20000000,3017,4291,7308
9/21/2013 1:03,10,20000000,3037,4410,7447
9/21/2013 1:03,10,20000000,3099,4297,7396
9/21/2013 1:03,10,20000000,2994,4375,7369
9/21/2013 1:03,10,20000000,3077,4192,7269
9/21/2013 1:03,10,20000000,2974,4338,7312
9/21/2013 1:04,10,20000000,2950,4350,7300
9/21/2013 1:04,10,20000000,3117,4243,7360
9/21/2013 1:04,10,20000000,2995,4272,7267
9/21/2013 1:04,10,20000000,3015,4169,7184
9/21/2013 1:04,10,20000000,3133,4426,7559
9/21/2013 1:04,10,20000000,3037,4094,7131
9/21/2013 1:05,10,20000000,3073,4163,7236
9/21/2013 1:05,10,20000000,3127,4205,7332
9/21/2013 1:05,10,20000000,3052,4307,7359
9/21/2013 1:05,10,20000000,3083,4304,7387
9/21/2013 1:05,10,20000000,3028,4190,7218
9/21/2013 1:06,10,20000000,3070,4173,7243
9/21/2013 1:06,10,20000000,3071,4321,7392
9/21/2013 1:06,10,20000000,2914,4216,7130
9/21/2013 1:06,10,20000000,2901,4367,7268
9/21/2013 1:06,10,20000000,3064,4270,7334
9/21/2013 1:06,10,20000000,3094,4139,7233
9/21/2013 1:07,10,20000000,3131,4166,7297
9/21/2013 1:07,10,20000000,3021,4224,7245
9/21/2013 1:07,10,20000000,2972,4306,7278
9/21/2013 1:07,10,20000000,3288,4192,7480
9/21/2013 1:07,10,20000000,3125,4145,7270
9/21/2013 1:08,10,20000000,3181,4159,7340
9/21/2013 1:08,10,20000000,3207,4139,7346
9/21/2013 1:08,10,20000000,2924,4407,7331
9/21/2013 1:08,10,20000000,2937,4286,7223
9/21/2013 1:08,10,20000000,3142,4199,7341
9/21/2013 1:08,10,20000000,2919,4207,7126
9/21/2013 1:09,10,20000000,3098,4216,7314
9/21/2013 1:09,10,20000000,3157,4207,7364
9/21/2013 1:09,10,20000000,3125,4174,7299
9/21/2013 1:09,10,20000000,3085,4186,7271
9/21/2013 1:09,10,20000000,3131,4216,7347
9/21/2013 1:09,10,20000000,3030,4146,7176
9/21/2013 1:10,10,20000000,2938,4296,7234
9/21/2013 1:10,10,20000000,3004,4318,7322
9/21/2013 1:10,10,20000000,2953,4296,7249
9/21/2013 1:10,10,20000000,3050,4164,7214
9/21/2013 1:10,10,20000000,3101,4288,7389
9/21/2013 1:11,10,30000000,4748,6180,10928
9/21/2013 1:11,10,30000000,4905,6289,11194
9/21/2013 1:11,10,30000000,4669,6513,11182
9/21/2013 1:11,10,30000000,4894,6116,11010
9/21/2013 1:12,10,30000000,4671,6415,11086
9/21/2013 1:12,10,30000000,5017,6310,11327
9/21/2013 1:12,10,30000000,4978,6444,11422
9/21/2013 1:12,10,30000000,4640,6293,10933
9/21/2013 1:13,10,30000000,4803,6280,11083
9/21/2013 1:13,10,30000000,4999,6172,11171
9/21/2013 1:13,10,30000000,4683,6843,11526
9/21/2013 1:13,10,30000000,4852,6120,10972
9/21/2013 1:14,10,30000000,5010,6157,11167
9/21/2013 1:14,10,30000000,4661,6396,11057
9/21/2013 1:14,10,30000000,4880,6356,11236
9/21/2013 1:14,10,30000000,4792,6141,10933
9/21/2013 1:15,10,30000000,4960,6256,11216
9/21/2013 1:15,10,30000000,4591,6340,10931
9/21/2013 1:15,10,30000000,5050,6533,11583
9/21/2013 1:15,10,30000000,4531,6377,10908
9/21/2013 1:16,10,30000000,4784,6356,11140
9/21/2013 1:16,10,30000000,4743,6168,10911
9/21/2013 1:16,10,30000000,4765,6435,11200
9/21/2013 1:16,10,30000000,4680,6355,11035
9/21/2013 1:17,10,30000000,4727,6437,11164
9/21/2013 1:17,10,30000000,4578,6327,10905
9/21/2013 1:17,10,30000000,4957,6146,11103
9/21/2013 1:17,10,30000000,4691,6329,11020
9/21/2013 1:18,10,30000000,4914,6174,11088
9/21/2013 1:18,10,30000000,4891,6377,11268
9/21/2013 1:18,10,30000000,4620,6312,10932
9/21/2013 1:18,10,30000000,4969,6373,11342
9/21/2013 1:19,10,30000000,4598,6201,10799
9/21/2013 1:19,10,30000000,4887,6165,11052
9/21/2013 1:19,10,30000000,4834,6155,10989
9/21/2013 1:19,10,30000000,4851,6141,10992
9/21/2013 1:20,10,30000000,4838,7122,11960
9/21/2013 1:20,10,30000000,4893,6151,11044
9/21/2013 1:20,10,30000000,4805,6178,10983
9/21/2013 1:20,10,30000000,4870,6347,11217
9/21/2013 1:21,10,30000000,4552,6384,10936
9/21/2013 1:21,10,30000000,5041,6545,11586
9/21/2013 1:21,10,30000000,4914,6268,11182
9/21/2013 1:21,10,30000000,4924,6397,11321
9/21/2013 1:22,10,30000000,4789,6361,11150
9/21/2013 1:22,10,30000000,4712,6135,10847
9/21/2013 1:22,10,30000000,4713,6184,10897
9/21/2013 1:22,10,30000000,4723,6375,11098
9/21/2013 1:23,10,30000000,4896,6348,11244
9/21/2013 1:23,10,30000000,4693,6139,10832
9/21/2013 1:23,10,30000000,4728,6320,11048
9/21/2013 1:23,10,30000000,5239,6312,11551
9/21/2013 1:24,10,30000000,4869,6321,11190
9/21/2013 1:24,10,30000000,4705,6180,10885
9/21/2013 1:24,10,30000000,4893,6477,11370
9/21/2013 1:24,10,30000000,4729,6370,11099
9/21/2013 1:25,10,30000000,4850,6179,11029
9/21/2013 1:25,10,30000000,4780,6188,10968
9/21/2013 1:25,10,30000000,4855,6177,11032
9/21/2013 1:25,10,30000000,4932,6323,11255
9/21/2013 1:26,10,30000000,5060,6343,11403
9/21/2013 1:26,10,30000000,4765,6438,11203
9/21/2013 1:26,10,30000000,4800,6375,11175
9/21/2013 1:26,10,30000000,4905,6157,11062
9/21/2013 1:27,10,30000000,4714,6378,11092
9/21/2013 1:27,10,30000000,4839,6263,11102
9/21/2013 1:27,10,30000000,4692,6438,11130
9/21/2013 1:27,10,30000000,5144,6175,11319
9/21/2013 1:28,10,30000000,4754,6203,10957
9/21/2013 1:28,10,30000000,4752,6169,10921
9/21/2013 1:28,10,30000000,4572,6359,10931
9/21/2013 1:28,10,30000000,4821,6441,11262
9/21/2013 1:29,10,30000000,5114,6298,11412
9/21/2013 1:29,10,30000000,4728,6261,10989
9/21/2013 1:29,10,30000000,4596,6401,10997
9/21/2013 1:29,10,30000000,4700,6443,11143
9/21/2013 1:30,10,30000000,4741,6196,10937
9/21/2013 1:30,10,30000000,4845,6340,11185
9/21/2013 1:30,10,30000000,4499,6775,11274
9/21/2013 1:30,10,30000000,4665,6337,11002
9/21/2013 1:31,10,30000000,4698,6685,11383
9/21/2013 1:31,10,30000000,4769,6155,10924
9/21/2013 1:31,10,30000000,4762,6426,11188
9/21/2013 1:31,10,30000000,4894,6128,11022
9/21/2013 1:32,10,30000000,5052,6339,11391
9/21/2013 1:32,10,30000000,4832,6324,11156
9/21/2013 1:32,10,30000000,4836,6288,11124
9/21/2013 1:32,10,30000000,4986,6398,11384
9/21/2013 1:33,10,30000000,4713,6336,11049
9/21/2013 1:33,10,30000000,4759,7431,12190
9/21/2013 1:33,10,30000000,4645,6253,10898
9/21/2013 1:33,10,30000000,4793,6307,11100
9/21/2013 1:34,10,30000000,4887,6346,11233
9/21/2013 1:34,10,30000000,4633,6347,10980
9/21/2013 1:34,10,30000000,4822,6342,11164
9/21/2013 1:34,10,30000000,4935,6305,11240
9/21/2013 1:35,10,30000000,4659,6332,10991
9/21/2013 1:35,10,30000000,4865,6223,11088
9/21/2013 1:35,10,30000000,4909,6345,11254
9/21/2013 1:35,10,30000000,4794,6391,11185
9/21/2013 1:36,10,30000000,4763,6260,11023
9/21/2013 1:36,10,30000000,5054,6137,11191
9/21/2013 1:36,10,30000000,4763,6199,10962
9/21/2013 1:36,10,30000000,4606,6922,11528
9/21/2013 1:37,10,30000000,4648,6324,10972
9/21/2013 1:37,10,30000000,4485,6449,10934
9/21/2013 1:37,10,30000000,4501,6290,10791
9/21/2013 1:37,10,30000000,4795,6315,11110
9/21/2013 1:38,10,30000000,4773,6343,11116
9/21/2013 1:38,10,30000000,4644,6317,10961
9/21/2013 1:38,10,30000000,4914,6450,11364
9/21/2013 1:38,10,30000000,4671,6280,10951
9/21/2013 1:39,10,30000000,5058,6198,11256
9/21/2013 1:39,10,30000000,4820,6335,11155
9/21/2013 1:39,10,30000000,4780,6321,11101
9/21/2013 1:40,10,40000000,6174,8573,14747
9/21/2013 1:40,10,40000000,5747,8790,14537
9/21/2013 1:40,10,40000000,5939,8587,14526
9/21/2013 1:40,10,40000000,5902,8940,14842
9/21/2013 1:41,10,40000000,6155,8512,14667
9/21/2013 1:41,10,40000000,6385,8507,14892
9/21/2013 1:41,10,40000000,6404,8604,15008
9/21/2013 1:42,10,40000000,6237,8512,14749
9/21/2013 1:42,10,40000000,6158,8460,14618
9/21/2013 1:42,10,40000000,6054,8631,14685
9/21/2013 1:43,10,40000000,6074,8507,14581
9/21/2013 1:43,10,40000000,5989,8935,14924
9/21/2013 1:43,10,40000000,6055,8532,14587
9/21/2013 1:44,10,40000000,6206,8808,15014
9/21/2013 1:44,10,40000000,6136,8556,14692
9/21/2013 1:44,10,40000000,6003,8571,14574
9/21/2013 1:45,10,40000000,6109,8564,14673
9/21/2013 1:45,10,40000000,6109,8472,14581
9/21/2013 1:45,10,40000000,6199,8620,14819
9/21/2013 1:46,10,40000000,6057,8557,14614
9/21/2013 1:46,10,40000000,6124,8921,15045
9/21/2013 1:46,10,40000000,6039,8609,14648
9/21/2013 1:47,10,40000000,6157,8453,14610
9/21/2013 1:47,10,40000000,6004,8878,14882
9/21/2013 1:47,10,40000000,6015,8782,14797
9/21/2013 1:48,10,40000000,5689,8678,14367
9/21/2013 1:48,10,40000000,6135,8932,15067
9/21/2013 1:48,10,40000000,6111,8573,14684
9/21/2013 1:49,10,40000000,5983,8545,14528
9/21/2013 1:49,10,40000000,5744,8658,14402
9/21/2013 1:49,10,40000000,6195,8473,14668
9/21/2013 1:50,10,40000000,6162,8643,14805
9/21/2013 1:50,10,40000000,6151,8958,15109
9/21/2013 1:50,10,40000000,6350,8572,14922
9/21/2013 1:50,10,40000000,6044,8896,14940
9/21/2013 1:51,10,40000000,6033,8877,14910
9/21/2013 1:51,10,40000000,6203,8554,14757
9/21/2013 1:51,10,40000000,5987,8583,14570
9/21/2013 1:52,10,40000000,6204,8430,14634
9/21/2013 1:52,10,40000000,5889,8889,14778
9/21/2013 1:52,10,40000000,5993,8555,14548
9/21/2013 1:53,10,40000000,6182,8564,14746
9/21/2013 1:53,10,40000000,6216,8507,14723
9/21/2013 1:53,10,40000000,6123,8349,14472
9/21/2013 1:54,10,40000000,5881,9215,15096
9/21/2013 1:54,10,40000000,6255,8368,14623
9/21/2013 1:54,10,40000000,6083,8579,14662
9/21/2013 1:55,10,40000000,6339,8534,14873
9/21/2013 1:55,10,40000000,5816,8937,14753
9/21/2013 1:55,10,40000000,6125,8542,14667
9/21/2013 1:56,10,40000000,5979,8534,14513
9/21/2013 1:56,10,40000000,6054,8889,14943
9/21/2013 1:56,10,40000000,6149,8807,14956
9/21/2013 1:57,10,40000000,6111,8609,14720
9/21/2013 1:57,10,40000000,6137,8595,14732
9/21/2013 1:57,10,40000000,5993,8593,14586
9/21/2013 1:58,10,40000000,6072,8642,14714
9/21/2013 1:58,10,40000000,6093,8621,14714
9/21/2013 1:58,10,40000000,5889,8846,14735
9/21/2013 1:59,10,40000000,6296,8568,14864
9/21/2013 1:59,10,40000000,6273,8432,14705
9/21/2013 1:59,10,40000000,6013,8914,14927
9/21/2013 1:59,10,40000000,6082,9151,15233
9/21/2013 2:00,10,40000000,6267,8584,14851
9/21/2013 2:00,10,40000000,6010,8553,14563
9/21/2013 2:00,10,40000000,6117,8555,14672
9/21/2013 2:01,10,40000000,5873,8644,14517
9/21/2013 2:01,10,40000000,5958,8931,14889
9/21/2013 2:01,10,40000000,6362,8383,14745
9/21/2013 2:02,10,40000000,6006,8797,14803
9/21/2013 2:02,10,40000000,6096,8461,14557
9/21/2013 2:02,10,40000000,6194,8460,14654
9/21/2013 2:03,10,40000000,5988,8686,14674
9/21/2013 2:03,10,40000000,5771,8730,14501
9/21/2013 2:03,10,40000000,6218,8474,14692
9/21/2013 2:04,10,40000000,6196,8516,14712
9/21/2013 2:04,10,40000000,6041,8568,14609
9/21/2013 2:04,10,40000000,5870,8881,14751
9/21/2013 2:05,10,40000000,5617,8600,14217
9/21/2013 2:05,10,40000000,6231,8627,14858
9/21/2013 2:05,10,40000000,6069,8705,14774
9/21/2013 2:06,10,40000000,5895,8713,14608
9/21/2013 2:06,10,40000000,5998,8886,14884
9/21/2013 2:06,10,40000000,6157,8414,14571
9/21/2013 2:07,10,40000000,6261,8520,14781
9/21/2013 2:07,10,40000000,6089,8567,14656
9/21/2013 2:07,10,40000000,5990,8829,14819
9/21/2013 2:08,10,40000000,6093,8628,14721
9/21/2013 2:08,10,40000000,5716,8862,14578
9/21/2013 2:08,10,40000000,6200,8586,14786
9/21/2013 2:08,10,40000000,6204,8586,14790
9/21/2013 2:09,10,40000000,6297,8325,14622
9/21/2013 2:09,10,40000000,6028,8796,14824
9/21/2013 2:09,10,40000000,5847,8946,14793
9/21/2013 2:10,10,40000000,5954,8722,14676
9/21/2013 2:10,10,40000000,6013,8597,14610
9/21/2013 2:10,10,40000000,6258,8643,14901
9/21/2013 2:11,10,40000000,5915,8640,14555
9/21/2013 2:11,10,40000000,6127,8847,14974
9/21/2013 2:11,10,40000000,6109,8500,14609
9/21/2013 2:12,10,40000000,5933,8808,14741
9/21/2013 2:12,10,40000000,5794,8519,14313
9/21/2013 2:12,10,40000000,5868,8810,14678
9/21/2013 2:13,10,40000000,5988,8596,14584
9/21/2013 2:13,10,40000000,6212,8632,14844
9/21/2013 2:13,10,40000000,6085,8537,14622
9/21/2013 2:14,10,40000000,5833,8581,14414
9/21/2013 2:14,10,40000000,6241,8550,14791
9/21/2013 2:14,10,40000000,6000,8709,14709
9/21/2013 2:15,10,40000000,6434,8463,14897
9/21/2013 2:15,10,40000000,6163,8631,14794
9/21/2013 2:15,10,40000000,6188,8607,14795
9/21/2013 2:16,10,40000000,6089,8557,14646
9/21/2013 2:16,10,40000000,6321,8565,14886
9/21/2013 2:16,10,40000000,5999,8811,14810
9/21/2013 2:17,10,50000000,8100,10730,18830
9/21/2013 2:17,10,50000000,8409,10506,18915
9/21/2013 2:17,10,50000000,8268,10794,19062
9/21/2013 2:18,10,50000000,8637,10455,19092
9/21/2013 2:18,10,50000000,8330,10571,18901
9/21/2013 2:19,10,50000000,8430,10701,19131
9/21/2013 2:19,10,50000000,8582,10519,19101
9/21/2013 2:19,10,50000000,8357,10568,18925
9/21/2013 2:20,10,50000000,8826,10598,19424
9/21/2013 2:20,10,50000000,8526,10359,18885
9/21/2013 2:21,10,50000000,8366,10390,18756
9/21/2013 2:21,10,50000000,8425,10322,18747
9/21/2013 2:21,10,50000000,8374,11328,19702
9/21/2013 2:22,10,50000000,8430,10331,18761
9/21/2013 2:22,10,50000000,8598,10804,19402
9/21/2013 2:23,10,50000000,8595,10591,19186
9/21/2013 2:23,10,50000000,8335,11037,19372
9/21/2013 2:24,10,50000000,8133,11928,20061
9/21/2013 2:24,10,50000000,8413,10297,18710
9/21/2013 2:24,10,50000000,8611,10596,19207
9/21/2013 2:25,10,50000000,8539,10793,19332
9/21/2013 2:25,10,50000000,8423,10354,18777
9/21/2013 2:26,10,50000000,8695,10677,19372
9/21/2013 2:26,10,50000000,8493,10383,18876
9/21/2013 2:26,10,50000000,8888,10899,19787
9/21/2013 2:27,10,50000000,8163,10407,18570
9/21/2013 2:27,10,50000000,8737,10657,19394
9/21/2013 2:28,10,50000000,8451,10728,19179
9/21/2013 2:28,10,50000000,8182,10356,18538
9/21/2013 2:28,10,50000000,8371,10351,18722
9/21/2013 2:29,10,50000000,9003,10632,19635
9/21/2013 2:29,10,50000000,9003,10473,19476
9/21/2013 2:30,10,50000000,8363,10915,19278
9/21/2013 2:30,10,50000000,8754,10383,19137
9/21/2013 2:30,10,50000000,8001,11341,19342
9/21/2013 2:31,10,50000000,8372,10291,18663
9/21/2013 2:31,10,50000000,8569,10593,19162
9/21/2013 2:32,10,50000000,8389,10416,18805
9/21/2013 2:32,10,50000000,8548,10627,19175
9/21/2013 2:32,10,50000000,8657,10967,19624
9/21/2013 2:33,10,50000000,8525,10481,19006
9/21/2013 2:33,10,50000000,8440,10653,19093
9/21/2013 2:34,10,50000000,8027,11012,19039
9/21/2013 2:34,10,50000000,8631,10943,19574
9/21/2013 2:35,10,50000000,8777,10404,19181
9/21/2013 2:35,10,50000000,8801,11009,19810
9/21/2013 2:35,10,50000000,8433,10902,19335
9/21/2013 2:36,10,50000000,8385,10894,19279
9/21/2013 2:36,10,50000000,8681,10386,19067
9/21/2013 2:37,10,50000000,8579,10552,19131
9/21/2013 2:37,10,50000000,8504,10261,18765
9/21/2013 2:37,10,50000000,8482,10388,18870
9/21/2013 2:38,10,50000000,8579,10486,19065
9/21/2013 2:38,10,50000000,8257,11050,19307
9/21/2013 2:39,10,50000000,8250,10777,19027
9/21/2013 2:39,10,50000000,8915,11085,20000
9/21/2013 2:39,10,50000000,8705,10319,19024
9/21/2013 2:40,10,50000000,8429,11604,20033
9/21/2013 2:40,10,50000000,8026,10643,18669
9/21/2013 2:41,10,50000000,8697,10705,19402
9/21/2013 2:41,10,50000000,8717,10368,19085
9/21/2013 2:41,10,50000000,8271,10375,18646
9/21/2013 2:42,10,50000000,8159,10749,18908
9/21/2013 2:42,10,50000000,8670,10917,19587
9/21/2013 2:43,10,50000000,8176,10416,18592
9/21/2013 2:43,10,50000000,7921,10695,18616
9/21/2013 2:43,10,50000000,8687,10584,19271
9/21/2013 2:44,10,50000000,8436,10714,19150
9/21/2013 2:44,10,50000000,8232,10744,18976
9/21/2013 2:45,10,50000000,8697,10689,19386
9/21/2013 2:45,10,50000000,8689,11048,19737
9/21/2013 2:46,10,50000000,8488,10434,18922
9/21/2013 2:46,10,50000000,8685,10606,19291
9/21/2013 2:46,10,50000000,8191,10644,18835
9/21/2013 2:47,10,50000000,8661,10514,19175
9/21/2013 2:47,10,50000000,8036,10619,18655
9/21/2013 2:48,10,50000000,8563,11065,19628
9/21/2013 2:48,10,50000000,8463,10842,19305
9/21/2013 2:48,10,50000000,7893,10713,18606
9/21/2013 2:49,10,50000000,8208,10641,18849
9/21/2013 2:49,10,50000000,8685,10439,19124
9/21/2013 2:50,10,50000000,8306,10723,19029
9/21/2013 2:50,10,50000000,8080,10415,18495
9/21/2013 2:50,10,50000000,8130,11013,19143
9/21/2013 2:51,10,50000000,8274,11989,20263
9/21/2013 2:51,10,50000000,8524,10748,19272
9/21/2013 2:52,10,50000000,8567,10344,18911
9/21/2013 2:52,10,50000000,8572,11058,19630
9/21/2013 2:52,10,50000000,8442,10720,19162
9/21/2013 2:53,10,50000000,8582,10790,19372
9/21/2013 2:53,10,50000000,8938,10459,19397
9/21/2013 2:54,10,50000000,8449,10352,18801
9/21/2013 2:54,10,50000000,8335,10691,19026
9/21/2013 2:54,10,50000000,8803,10606,19409
9/21/2013 2:55,10,50000000,8640,11045,19685
9/21/2013 2:55,10,50000000,8197,10985,19182
9/21/2013 2:56,10,50000000,8490,10340,18830
9/21/2013 2:56,10,50000000,8679,10272,18951
9/21/2013 2:57,10,50000000,8502,10633,19135
9/21/2013 2:57,10,50000000,8773,10487,19260
9/21/2013 2:57,10,50000000,8524,10482,19006
9/21/2013 2:58,10,50000000,8639,10805,19444
9/21/2013 2:58,10,50000000,8678,10472,19150
9/21/2013 2:59,10,50000000,8965,10375,19340
9/21/2013 2:59,10,50000000,8563,10370,18933
9/21/2013 2:59,10,50000000,8348,11000,19348
9/21/2013 3:00,10,50000000,8395,10379,18774
9/21/2013 3:00,10,50000000,8415,11377,19792
9/21/2013 3:01,10,50000000,8778,10656,19434
9/21/2013 3:01,10,50000000,8568,10447,19015
9/21/2013 3:01,10,50000000,8547,10422,18969
9/21/2013 3:02,10,50000000,8630,10958,19588
9/21/2013 3:02,10,50000000,8675,10410,19085
9/21/2013 3:03,10,50000000,8389,10648,19037
9/21/2013 3:03,10,50000000,8422,10452,18874
9/21/2013 3:04,10,60000000,9641,12738,22379
9/21/2013 3:04,10,60000000,10169,12407,22576
9/21/2013 3:04,10,60000000,10118,12309,22427
9/21/2013 3:05,10,60000000,9001,13012,22013
9/21/2013 3:05,10,60000000,10450,12338,22788
9/21/2013 3:06,10,60000000,8936,13208,22144
9/21/2013 3:06,10,60000000,9849,12258,22107
9/21/2013 3:07,10,60000000,10116,12708,22824
9/21/2013 3:07,10,60000000,10232,12715,22947
9/21/2013 3:08,10,60000000,10305,12377,22682
9/21/2013 3:08,10,60000000,9990,12313,22303
9/21/2013 3:09,10,60000000,10142,12408,22550
9/21/2013 3:09,10,60000000,10230,12360,22590
9/21/2013 3:10,10,60000000,10380,12428,22808
9/21/2013 3:10,10,60000000,10224,12514,22738
9/21/2013 3:11,10,60000000,10095,12336,22431
9/21/2013 3:11,10,60000000,10164,12356,22520
9/21/2013 3:12,10,60000000,10000,12653,22653
9/21/2013 3:12,10,60000000,10546,12426,22972
9/21/2013 3:13,10,60000000,10593,14150,24743
9/21/2013 3:13,10,60000000,9917,12340,22257
9/21/2013 3:14,10,60000000,9820,12413,22233
9/21/2013 3:14,10,60000000,10302,12314,22616
9/21/2013 3:14,10,60000000,10038,12384,22422
9/21/2013 3:15,10,60000000,9821,12317,22138
9/21/2013 3:15,10,60000000,10019,12430,22449
9/21/2013 3:16,10,60000000,10031,12394,22425
9/21/2013 3:16,10,60000000,9197,13096,22293
9/21/2013 3:17,10,60000000,10299,12330,22629
9/21/2013 3:17,10,60000000,10193,17437,27630
9/21/2013 3:18,10,60000000,9927,12287,22214
9/21/2013 3:18,10,60000000,9964,12445,22409
9/21/2013 3:19,10,60000000,10815,12737,23552
9/21/2013 3:19,10,60000000,10092,12714,22806
9/21/2013 3:20,10,60000000,9898,12521,22419
9/21/2013 3:20,10,60000000,9778,12318,22096
9/21/2013 3:21,10,60000000,9888,12910,22798
9/21/2013 3:21,10,60000000,9890,12348,22238
9/21/2013 3:22,10,60000000,10533,12708,23241
9/21/2013 3:22,10,60000000,10212,12290,22502
9/21/2013 3:23,10,60000000,9713,12354,22067
9/21/2013 3:23,10,60000000,9945,12366,22311
9/21/2013 3:24,10,60000000,10243,12329,22572
9/21/2013 3:24,10,60000000,10447,12653,23100
9/21/2013 3:25,10,60000000,10191,12370,22561
9/21/2013 3:25,10,60000000,10328,12370,22698
9/21/2013 3:25,10,60000000,9977,12842,22819
9/21/2013 3:26,10,60000000,10340,12424,22764
9/21/2013 3:26,10,60000000,10544,12341,22885
9/21/2013 3:27,10,60000000,10324,12307,22631
9/21/2013 3:27,10,60000000,10015,12322,22337
9/21/2013 3:28,10,60000000,10416,12312,22728
9/21/2013 3:28,10,60000000,10145,12752,22897
9/21/2013 3:29,10,60000000,10286,12378,22664
9/21/2013 3:29,10,60000000,8969,13042,22011
9/21/2013 3:30,10,60000000,10119,12359,22478
9/21/2013 3:30,10,60000000,10001,12716,22717
9/21/2013 3:31,10,60000000,10066,12482,22548
9/21/2013 3:31,10,60000000,10287,12265,22552
9/21/2013 3:32,10,60000000,10041,12364,22405
9/21/2013 3:32,10,60000000,10364,12341,22705
9/21/2013 3:33,10,60000000,9981,12299,22280
9/21/2013 3:33,10,60000000,9861,12710,22571
9/21/2013 3:34,10,60000000,10235,12321,22556
9/21/2013 3:34,10,60000000,8869,13107,21976
9/21/2013 3:35,10,60000000,10297,12316,22613
9/21/2013 3:35,10,60000000,9913,12737,22650
9/21/2013 3:35,10,60000000,10082,12316,22398
9/21/2013 3:36,10,60000000,10325,12355,22680
9/21/2013 3:36,10,60000000,10096,12296,22392
9/21/2013 3:37,10,60000000,10386,12367,22753
9/21/2013 3:37,10,60000000,9837,12463,22300
9/21/2013 3:38,10,60000000,10300,12321,22621
9/21/2013 3:38,10,60000000,10243,12439,22682
9/21/2013 3:39,10,60000000,10085,12476,22561
9/21/2013 3:39,10,60000000,10105,12684,22789
9/21/2013 3:40,10,60000000,10037,12298,22335
9/21/2013 3:40,10,60000000,10307,12335,22642
9/21/2013 3:41,10,60000000,10176,12402,22578
9/21/2013 3:41,10,60000000,10441,12345,22786
9/21/2013 3:42,10,60000000,10191,12373,22564
9/21/2013 3:42,10,60000000,9905,12377,22282
9/21/2013 3:43,10,60000000,10189,12371,22560
9/21/2013 3:43,10,60000000,10267,12740,23007
9/21/2013 3:44,10,60000000,9946,12394,22340
9/21/2013 3:44,10,60000000,10668,12456,23124
9/21/2013 3:45,10,60000000,10115,12317,22432
9/21/2013 3:45,10,60000000,9616,12706,22322
9/21/2013 3:45,10,60000000,10025,12481,22506
9/21/2013 3:46,10,60000000,10758,12319,23077
9/21/2013 3:46,10,60000000,10027,12689,22716
9/21/2013 3:47,10,60000000,10183,12372,22555
9/21/2013 3:47,10,60000000,10232,12305,22537
9/21/2013 3:48,10,60000000,10339,12655,22994
9/21/2013 3:48,10,60000000,9950,12735,22685
9/21/2013 3:49,10,60000000,10113,12347,22460
9/21/2013 3:49,10,60000000,9836,12334,22170
9/21/2013 3:50,10,60000000,10033,12680,22713
9/21/2013 3:50,10,60000000,10486,12347,22833
9/21/2013 3:51,10,60000000,10596,12372,22968
9/21/2013 3:51,10,60000000,10194,12462,22656
9/21/2013 3:52,10,60000000,10153,12422,22575
9/21/2013 3:52,10,60000000,9875,12259,22134
9/21/2013 3:53,10,60000000,10033,12263,22296
9/21/2013 3:53,10,60000000,10292,12855,23147
9/21/2013 3:54,10,60000000,10441,16908,27349
9/21/2013 3:54,10,60000000,9726,12812,22538
9/21/2013 3:55,10,60000000,10123,12366,22489
9/21/2013 3:55,10,60000000,10366,12319,22685
9/21/2013 3:56,10,60000000,10138,12313,22451
9/21/2013 3:56,10,60000000,9885,12386,22271
9/21/2013 3:56,10,60000000,10167,12303,22470
9/21/2013 3:57,10,60000000,10076,12457,22533
9/21/2013 3:57,10,60000000,10527,12403,22930
9/21/2013 3:58,10,60000000,9682,12358,22040
9/21/2013 3:58,10,70000000,10785,14256,25041
9/21/2013 3:59,10,70000000,10862,15314,26176
9/21/2013 4:00,10,70000000,11044,14675,25719
9/21/2013 4:00,10,70000000,10680,14872,25552
9/21/2013 4:01,10,70000000,10869,14378,25247
9/21/2013 4:01,10,70000000,11350,14375,25725
9/21/2013 4:02,10,70000000,11191,14172,25363
9/21/2013 4:02,10,70000000,11306,14294,25600
9/21/2013 4:03,10,70000000,11127,14296,25423
9/21/2013 4:03,10,70000000,11027,14546,25573
9/21/2013 4:04,10,70000000,10977,14283,25260
9/21/2013 4:04,10,70000000,10420,14855,25275
9/21/2013 4:05,10,70000000,10885,14827,25712
9/21/2013 4:05,10,70000000,11072,14821,25893
9/21/2013 4:06,10,70000000,11537,14262,25799
9/21/2013 4:06,10,70000000,11204,14294,25498
9/21/2013 4:07,10,70000000,10648,14133,24781
9/21/2013 4:08,10,70000000,11115,14376,25491
9/21/2013 4:08,10,70000000,11315,14316,25631
9/21/2013 4:09,10,70000000,11542,15010,26552
9/21/2013 4:09,10,70000000,11250,14192,25442
9/21/2013 4:10,10,70000000,11210,14451,25661
9/21/2013 4:10,10,70000000,10704,14599,25303
9/21/2013 4:11,10,70000000,10958,14200,25158
9/21/2013 4:11,10,70000000,11511,14405,25916
9/21/2013 4:12,10,70000000,10632,14180,24812
9/21/2013 4:12,10,70000000,10991,14289,25280
9/21/2013 4:13,10,70000000,11358,14227,25585
9/21/2013 4:13,10,70000000,10966,14229,25195
9/21/2013 4:14,10,70000000,10922,14791,25713
9/21/2013 4:14,10,70000000,10578,14194,24772
9/21/2013 4:15,10,70000000,11326,14248,25574
9/21/2013 4:16,10,70000000,11078,14295,25373
9/21/2013 4:16,10,70000000,11161,14763,25924
9/21/2013 4:17,10,70000000,11495,14534,26029
9/21/2013 4:17,10,70000000,11269,14434,25703
9/21/2013 4:18,10,70000000,11212,19456,30668
9/21/2013 4:18,10,70000000,11088,14192,25280
9/21/2013 4:19,10,70000000,11497,14134,25631
9/21/2013 4:19,10,70000000,10722,14281,25003
9/21/2013 4:20,10,70000000,11143,14428,25571
9/21/2013 4:20,10,70000000,10950,14834,25784
9/21/2013 4:21,10,70000000,11067,14216,25283
9/21/2013 4:22,10,70000000,10672,14597,25269
9/21/2013 4:22,10,70000000,11078,14730,25808
9/21/2013 4:23,10,70000000,11377,14299,25676
9/21/2013 4:23,10,70000000,11408,14554,25962
9/21/2013 4:24,10,70000000,11028,14172,25200
9/21/2013 4:24,10,70000000,11601,14369,25970
9/21/2013 4:25,10,70000000,10918,16377,27295
9/21/2013 4:25,10,70000000,11150,14327,25477
9/21/2013 4:26,10,70000000,10753,14919,25672
9/21/2013 4:26,10,70000000,11459,14238,25697
9/21/2013 4:27,10,70000000,11003,14405,25408
9/21/2013 4:27,10,70000000,10499,14870,25369
9/21/2013 4:28,10,70000000,11080,14289,25369
9/21/2013 4:29,10,70000000,10741,14686,25427
9/21/2013 4:29,10,70000000,11346,14284,25630
9/21/2013 4:30,10,70000000,10812,14328,25140
9/21/2013 4:30,10,70000000,10979,14984,25963
9/21/2013 4:31,10,70000000,11303,14433,25736
9/21/2013 4:31,10,70000000,11731,14388,26119
9/21/2013 4:32,10,70000000,10692,14833,25525
9/21/2013 4:32,10,70000000,11218,14273,25491
9/21/2013 4:33,10,70000000,11202,14235,25437
9/21/2013 4:33,10,70000000,11231,14367,25598
9/21/2013 4:34,10,70000000,10929,14204,25133
9/21/2013 4:34,10,70000000,11426,14258,25684
9/21/2013 4:35,10,70000000,11433,16057,27490
9/21/2013 4:36,10,70000000,11222,14222,25444
9/21/2013 4:36,10,70000000,11748,14476,26224
9/21/2013 4:37,10,70000000,11658,14762,26420
9/21/2013 4:37,10,70000000,11080,14283,25363
9/21/2013 4:38,10,70000000,11304,14871,26175
9/21/2013 4:38,10,70000000,10955,14657,25612
9/21/2013 4:39,10,70000000,10919,14677,25596
9/21/2013 4:39,10,70000000,10854,14238,25092
9/21/2013 4:40,10,70000000,11261,14252,25513
9/21/2013 4:40,10,70000000,11066,14940,26006
9/21/2013 4:41,10,70000000,11203,14557,25760
9/21/2013 4:41,10,70000000,12214,14337,26551
9/21/2013 4:42,10,70000000,11096,14712,25808
9/21/2013 4:43,10,70000000,11294,14591,25885
9/21/2013 4:43,10,70000000,11235,14155,25390
9/21/2013 4:44,10,70000000,10869,14827,25696
9/21/2013 4:44,10,70000000,10991,14235,25226
9/21/2013 4:45,10,70000000,10781,14872,25653
9/21/2013 4:45,10,70000000,11181,14159,25340
9/21/2013 4:46,10,70000000,10966,14232,25198
9/21/2013 4:46,10,70000000,11414,14811,26225
9/21/2013 4:47,10,70000000,10967,14340,25307
9/21/2013 4:47,10,70000000,11124,14179,25303
9/21/2013 4:48,10,70000000,11284,14183,25467
9/21/2013 4:48,10,70000000,10848,14747,25595
9/21/2013 4:49,10,70000000,11115,14769,25884
9/21/2013 4:50,10,70000000,11268,14319,25587
9/21/2013 4:50,10,70000000,10715,15126,25841
9/21/2013 4:51,10,70000000,11106,14377,25483
9/21/2013 4:51,10,70000000,11392,14340,25732
9/21/2013 4:52,10,70000000,10822,14580,25402
9/21/2013 4:52,10,70000000,11016,14424,25440
9/21/2013 4:53,10,70000000,10950,14276,25226
9/21/2013 4:53,10,70000000,10950,14682,25632
9/21/2013 4:54,10,70000000,11313,14721,26034
9/21/2013 4:54,10,70000000,11000,14394,25394
9/21/2013 4:55,10,70000000,11238,14199,25437
9/21/2013 4:55,10,70000000,10810,14195,25005
9/21/2013 4:56,10,70000000,10990,14189,25179
9/21/2013 4:56,10,70000000,11063,14210,25273
9/21/2013 4:57,10,70000000,11217,14289,25506
9/21/2013 4:58,10,70000000,10736,14431,25167
9/21/2013 4:58,10,70000000,11664,14278,25942
9/21/2013 4:59,10,70000000,11481,14248,25729
9/21/2013 4:59,10,70000000,11678,14373,26051
9/21/2013 5:00,10,70000000,11223,14259,25482
9/21/2013 5:00,10,80000000,12553,16555,29108
9/21/2013 5:01,10,80000000,12068,16987,29055
9/21/2013 5:02,10,80000000,12644,16523,29167
9/21/2013 5:02,10,80000000,13172,16700,29872
9/21/2013 5:03,10,80000000,13169,16718,29887
9/21/2013 5:03,10,80000000,12534,16660,29194
9/21/2013 5:04,10,80000000,12920,16783,29703
9/21/2013 5:05,10,80000000,13261,17122,30383
9/21/2013 5:05,10,80000000,12527,16519,29046
9/21/2013 5:06,10,80000000,12239,16852,29091
9/21/2013 5:06,10,80000000,12225,17070,29295
9/21/2013 5:07,10,80000000,12377,16600,28977
9/21/2013 5:08,10,80000000,12740,16550,29290
9/21/2013 5:08,10,80000000,12593,16925,29518
9/21/2013 5:09,10,80000000,12479,16612,29091
9/21/2013 5:09,10,80000000,12112,18217,30329
9/21/2013 5:10,10,80000000,12537,16655,29192
9/21/2013 5:11,10,80000000,12563,16573,29136
9/21/2013 5:11,10,80000000,12965,16739,29704
9/21/2013 5:12,10,80000000,12667,16619,29286
9/21/2013 5:13,10,80000000,11945,16650,28595
9/21/2013 5:13,10,80000000,12977,16588,29565
9/21/2013 5:14,10,80000000,12187,17041,29228
9/21/2013 5:14,10,80000000,11894,16628,28522
9/21/2013 5:15,10,80000000,12484,18301,30785
9/21/2013 5:16,10,80000000,12747,16707,29454
9/21/2013 5:16,10,80000000,12846,16571,29417
9/21/2013 5:17,10,80000000,12803,16604,29407
9/21/2013 5:17,10,80000000,11948,17186,29134
9/21/2013 5:18,10,80000000,12734,17116,29850
9/21/2013 5:19,10,80000000,12137,17411,29548
9/21/2013 5:19,10,80000000,12211,18040,30251
9/21/2013 5:20,10,80000000,12708,16407,29115
9/21/2013 5:20,10,80000000,12306,16575,28881
9/21/2013 5:21,10,80000000,12215,16526,28741
9/21/2013 5:22,10,80000000,12736,17835,30571
9/21/2013 5:22,10,80000000,12853,17247,30100
9/21/2013 5:23,10,80000000,12962,16668,29630
9/21/2013 5:24,10,80000000,12604,16643,29247
9/21/2013 5:24,10,80000000,12541,16676,29217
9/21/2013 5:25,10,80000000,12205,16975,29180
9/21/2013 5:25,10,80000000,12584,17092,29676
9/21/2013 5:26,10,80000000,12650,16893,29543
9/21/2013 5:27,10,80000000,12333,16632,28965
9/21/2013 5:27,10,80000000,12209,17372,29581
9/21/2013 5:28,10,80000000,12174,18083,30257
9/21/2013 5:28,10,80000000,12293,16990,29283
9/21/2013 5:29,10,80000000,12582,16512,29094
9/21/2013 5:30,10,80000000,12202,16602,28804
9/21/2013 5:30,10,80000000,12532,16695,29227
9/21/2013 5:31,10,80000000,13095,16645,29740
9/21/2013 5:31,10,80000000,12097,16513,28610
9/21/2013 5:32,10,80000000,12866,16477,29343
9/21/2013 5:33,10,80000000,13140,16595,29735
9/21/2013 5:33,10,80000000,12913,16576,29489
9/21/2013 5:34,10,80000000,12527,16625,29152
9/21/2013 5:35,10,80000000,12911,16713,29624
9/21/2013 5:35,10,80000000,12539,16529,29068
9/21/2013 5:36,10,80000000,12824,16720,29544
9/21/2013 5:36,10,80000000,12941,16634,29575
9/21/2013 5:37,10,80000000,12130,17360,29490
9/21/2013 5:38,10,80000000,12244,17291,29535
9/21/2013 5:38,10,80000000,12475,16570,29045
9/21/2013 5:39,10,80000000,13337,16681,30018
9/21/2013 5:39,10,80000000,12702,16601,29303
9/21/2013 5:40,10,80000000,12167,16612,28779
9/21/2013 5:41,10,80000000,12445,16668,29113
9/21/2013 5:41,10,80000000,13379,16672,30051
9/21/2013 5:42,10,80000000,12664,17148,29812
9/21/2013 5:43,10,80000000,12625,16641,29266
9/21/2013 5:43,10,80000000,12456,16575,29031
9/21/2013 5:44,10,80000000,12251,17079,29330
9/21/2013 5:44,10,80000000,12328,16582,28910
9/21/2013 5:45,10,80000000,12011,16918,28929
9/21/2013 5:46,10,80000000,13085,16690,29775
9/21/2013 5:46,10,80000000,12594,16712,29306
9/21/2013 5:47,10,80000000,12905,16631,29536
9/21/2013 5:47,10,80000000,12369,16633,29002
9/21/2013 5:48,10,80000000,13107,16510,29617
9/21/2013 5:49,10,80000000,12371,16976,29347
9/21/2013 5:49,10,80000000,12424,16701,29125
9/21/2013 5:50,10,80000000,12533,16636,29169
9/21/2013 5:50,10,80000000,12166,16663,28829
9/21/2013 5:51,10,80000000,12661,16585,29246
9/21/2013 5:52,10,80000000,12314,16591,28905
9/21/2013 5:52,10,80000000,12831,16983,29814
9/21/2013 5:53,10,80000000,12402,16616,29018
9/21/2013 5:53,10,80000000,13075,16738,29813
9/21/2013 5:54,10,80000000,11961,16644,28605
9/21/2013 5:55,10,80000000,12468,16483,28951
9/21/2013 5:55,10,80000000,13353,16603,29956
9/21/2013 5:56,10,80000000,12670,16671,29341
9/21/2013 5:57,10,80000000,12431,17062,29493
9/21/2013 5:57,10,80000000,12505,16617,29122
9/21/2013 5:58,10,80000000,12851,16704,29555
9/21/2013 5:58,10,80000000,12333,16980,29313
9/21/2013 5:59,10,80000000,12213,17388,29601
9/21/2013 6:00,10,80000000,11775,16987,28762
9/21/2013 6:00,10,80000000,12934,17078,30012
9/21/2013 6:01,10,80000000,12759,16649,29408
9/21/2013 6:01,10,80000000,12419,17062,29481
9/21/2013 6:02,10,80000000,12939,16991,29930
9/21/2013 6:03,10,80000000,12428,16752,29180
9/21/2013 6:03,10,80000000,12420,17285,29705
9/21/2013 6:04,10,80000000,12543,16697,29240
9/21/2013 6:04,10,80000000,12084,16955,29039
9/21/2013 6:05,10,80000000,12662,16600,29262
9/21/2013 6:06,10,80000000,12173,16606,28779
9/21/2013 6:06,10,80000000,12434,16686,29120
9/21/2013 6:07,10,80000000,12099,17268,29367
9/21/2013 6:08,10,80000000,12908,16571,29479
9/21/2013 6:08,10,80000000,12584,16661,29245
9/21/2013 6:09,10,80000000,12122,17038,29160
9/21/2013 6:09,10,80000000,12981,16735,29716
9/21/2013 6:10,10,80000000,12380,16636,29016
9/21/2013 6:11,10,90000000,14841,19697,34538
9/21/2013 6:11,10,90000000,14519,21299,35818
9/21/2013 6:12,10,90000000,14749,18586,33335
9/21/2013 6:13,10,90000000,15719,18670,34389
9/21/2013 6:13,10,90000000,15634,18496,34130
9/21/2013 6:14,10,90000000,14897,18623,33520
9/21/2013 6:15,10,90000000,14509,19508,34017
9/21/2013 6:16,10,90000000,15006,18367,33373
9/21/2013 6:16,10,90000000,14841,19796,34637
9/21/2013 6:17,10,90000000,14515,18722,33237
9/21/2013 6:18,10,90000000,15253,18417,33670
9/21/2013 6:18,10,90000000,14987,18547,33534
9/21/2013 6:19,10,90000000,15273,18621,33894
9/21/2013 6:20,10,90000000,14929,18661,33590
9/21/2013 6:20,10,90000000,15366,18592,33958
9/21/2013 6:21,10,90000000,14723,19245,33968
9/21/2013 6:22,10,90000000,14974,19095,34069
9/21/2013 6:23,10,90000000,15574,18885,34459
9/21/2013 6:23,10,90000000,15064,18614,33678
9/21/2013 6:24,10,90000000,14757,18882,33639
9/21/2013 6:25,10,90000000,14491,18961,33452
9/21/2013 6:25,10,90000000,15537,19515,35052
9/21/2013 6:26,10,90000000,14785,18549,33334
9/21/2013 6:27,10,90000000,14482,19104,33586
9/21/2013 6:27,10,90000000,15318,18401,33719
9/21/2013 6:28,10,90000000,14745,18641,33386
9/21/2013 6:29,10,90000000,14965,18588,33553
9/21/2013 6:29,10,90000000,15441,18809,34250
9/21/2013 6:30,10,90000000,15224,18583,33807
9/21/2013 6:31,10,90000000,15060,19225,34285
9/21/2013 6:32,10,90000000,15376,19744,35120
9/21/2013 6:32,10,90000000,15108,18628,33736
9/21/2013 6:33,10,90000000,15018,18491,33509
9/21/2013 6:34,10,90000000,14888,18653,33541
9/21/2013 6:34,10,90000000,14816,18998,33814
9/21/2013 6:35,10,90000000,14833,19217,34050
9/21/2013 6:36,10,90000000,15022,19081,34103
9/21/2013 6:36,10,90000000,15012,18607,33619
9/21/2013 6:37,10,90000000,14835,19672,34507
9/21/2013 6:38,10,90000000,15139,18996,34135
9/21/2013 6:39,10,90000000,15161,18688,33849
9/21/2013 6:39,10,90000000,15219,18858,34077
9/21/2013 6:40,10,90000000,15062,18518,33580
9/21/2013 6:41,10,90000000,14797,18658,33455
9/21/2013 6:41,10,90000000,14728,18977,33705
9/21/2013 6:42,10,90000000,14771,18480,33251
9/21/2013 6:43,10,90000000,14974,18474,33448
9/21/2013 6:43,10,90000000,14796,18595,33391
9/21/2013 6:44,10,90000000,15237,18658,33895
9/21/2013 6:45,10,90000000,15259,18610,33869
9/21/2013 6:46,10,90000000,15295,18646,33941
9/21/2013 6:46,10,90000000,15193,18698,33891
9/21/2013 6:47,10,90000000,15573,19000,34573
9/21/2013 6:48,10,90000000,15365,18735,34100
9/21/2013 6:48,10,90000000,14929,19617,34546
9/21/2013 6:49,10,90000000,14687,18976,33663
9/21/2013 6:50,10,90000000,15047,18541,33588
9/21/2013 6:50,10,90000000,15330,18481,33811
9/21/2013 6:51,10,90000000,14704,18966,33670
9/21/2013 6:52,10,90000000,14357,18572,32929
9/21/2013 6:53,10,90000000,14919,19045,33964
9/21/2013 6:53,10,90000000,14931,18649,33580
9/21/2013 6:54,10,90000000,14341,19368,33709
9/21/2013 6:55,10,90000000,14898,18873,33771
9/21/2013 6:55,10,90000000,15048,19649,34697
9/21/2013 6:56,10,90000000,15158,18612,33770
9/21/2013 6:57,10,90000000,15129,18629,33758
9/21/2013 6:57,10,90000000,14766,19090,33856
9/21/2013 6:58,10,90000000,14826,18441,33267
9/21/2013 6:59,10,90000000,14450,18640,33090
9/21/2013 6:59,10,90000000,14957,18591,33548
9/21/2013 7:00,10,90000000,14951,18675,33626
9/21/2013 7:01,10,90000000,14867,19509,34376
9/21/2013 7:02,10,90000000,14902,19608,34510
9/21/2013 7:02,10,90000000,14936,18573,33509
9/21/2013 7:03,10,90000000,15349,19140,34489
9/21/2013 7:04,10,90000000,15087,18782,33869
9/21/2013 7:04,10,90000000,15020,18759,33779
9/21/2013 7:05,10,90000000,15636,18770,34406
9/21/2013 7:06,10,90000000,15163,18995,34158
9/21/2013 7:06,10,90000000,15196,18975,34171
9/21/2013 7:07,10,90000000,15231,18516,33747
9/21/2013 7:08,10,90000000,15238,18940,34178
9/21/2013 7:09,10,90000000,14760,18578,33338
9/21/2013 7:09,10,90000000,15186,19020,34206
9/21/2013 7:10,10,90000000,14729,18581,33310
9/21/2013 7:11,10,90000000,14711,20029,34740
9/21/2013 7:11,10,90000000,14365,19041,33406
9/21/2013 7:12,10,90000000,14934,19076,34010
9/21/2013 7:13,10,90000000,14731,18534,33265
9/21/2013 7:13,10,90000000,14694,19068,33762
9/21/2013 7:14,10,90000000,14070,18978,33048
9/21/2013 7:15,10,90000000,15178,19035,34213
9/21/2013 7:16,10,90000000,15190,18766,33956
9/21/2013 7:16,10,90000000,15042,18585,33627
9/21/2013 7:17,10,90000000,14913,18501,33414
9/21/2013 7:18,10,90000000,14190,18911,33101
9/21/2013 7:18,10,90000000,15031,19231,34262
9/21/2013 7:19,10,90000000,15079,19003,34082
9/21/2013 7:20,10,90000000,14753,19710,34463
9/21/2013 7:20,10,90000000,14891,18480,33371
9/21/2013 7:21,10,90000000,14201,18826,33027
9/21/2013 7:22,10,90000000,14874,18501,33375
9/21/2013 7:22,10,90000000,14725,18606,33331
9/21/2013 7:23,10,90000000,14927,18867,33794
9/21/2013 7:24,10,90000000,15026,19005,34031
9/21/2013 7:25,10,90000000,15305,18595,33900
9/21/2013 7:25,10,90000000,15095,19105,34200
9/21/2013 7:26,10,90000000,14995,18633,33628
9/21/2013 7:27,10,90000000,14701,18609,33310
9/21/2013 7:27,10,90000000,15281,18516,33797
9/21/2013 7:28,10,90000000,15249,18493,33742
9/21/2013 7:29,10,90000000,15085,18593,33678
9/21/2013 7:29,10,90000000,15935,18970,34905
9/21/2013 7:30,10,90000000,15608,18802,34410
9/21/2013 7:31,10,100000000,16821,20214,37035
9/21/2013 7:32,10,100000000,16525,20482,37007
9/21/2013 7:32,10,100000000,17145,20960,38105
9/21/2013 7:33,10,100000000,17418,21248,38666
9/21/2013 7:34,10,100000000,18052,20358,38410
9/21/2013 7:35,10,100000000,17416,20364,37780
9/21/2013 7:36,10,100000000,17608,20134,37742
9/21/2013 7:36,10,100000000,17244,20768,38012
9/21/2013 7:37,10,100000000,17342,20329,37671
9/21/2013 7:38,10,100000000,17552,20090,37642
9/21/2013 7:39,10,100000000,17122,20227,37349
9/21/2013 7:39,10,100000000,17600,21517,39117
9/21/2013 7:40,10,100000000,18098,20542,38640
9/21/2013 7:41,10,100000000,18047,20326,38373
9/21/2013 7:42,10,100000000,16881,20903,37784
9/21/2013 7:43,10,100000000,17417,20567,37984
9/21/2013 7:43,10,100000000,17429,21685,39114
9/21/2013 7:44,10,100000000,17646,20088,37734
9/21/2013 7:45,10,100000000,17754,20332,38086
9/21/2013 7:46,10,100000000,17407,22195,39602
9/21/2013 7:47,10,100000000,17431,21146,38577
9/21/2013 7:47,10,100000000,17696,20869,38565
9/21/2013 7:48,10,100000000,17507,20585,38092
9/21/2013 7:49,10,100000000,17524,20054,37578
9/21/2013 7:50,10,100000000,17244,20099,37343
9/21/2013 7:50,10,100000000,17137,20225,37362
9/21/2013 7:51,10,100000000,17999,20525,38524
9/21/2013 7:52,10,100000000,17485,20264,37749
9/21/2013 7:53,10,100000000,17605,20118,37723
9/21/2013 7:54,10,100000000,17302,20604,37906
9/21/2013 7:54,10,100000000,16390,20176,36566
9/21/2013 7:55,10,100000000,17651,20256,37907
9/21/2013 7:56,10,100000000,17990,20189,38179
9/21/2013 7:57,10,100000000,16888,20567,37455
9/21/2013 7:57,10,100000000,17605,20334,37939
9/21/2013 7:58,10,100000000,17899,20386,38285
9/21/2013 7:59,10,100000000,17431,21174,38605
9/21/2013 8:00,10,100000000,17145,20301,37446
9/21/2013 8:00,10,100000000,17631,20285,37916
9/21/2013 8:01,10,100000000,17327,20033,37360
9/21/2013 8:02,10,100000000,16984,21274,38258
9/21/2013 8:03,10,100000000,17246,22008,39254
9/21/2013 8:04,10,100000000,17093,20820,37913
9/21/2013 8:04,10,100000000,17391,20245,37636
9/21/2013 8:05,10,100000000,17694,20652,38346
9/21/2013 8:06,10,100000000,16229,20806,37035
9/21/2013 8:07,10,100000000,17972,20828,38800
9/21/2013 8:08,10,100000000,17437,21522,38959
9/21/2013 8:08,10,100000000,17710,21248,38958
9/21/2013 8:09,10,100000000,16982,20401,37383
9/21/2013 8:10,10,100000000,16732,20788,37520
9/21/2013 8:11,10,100000000,18090,20169,38259
9/21/2013 8:11,10,100000000,17593,21205,38798
9/21/2013 8:12,10,100000000,16818,20294,37112
9/21/2013 8:13,10,100000000,17533,20539,38072
9/21/2013 8:14,10,100000000,17836,20145,37981
9/21/2013 8:15,10,100000000,17360,20251,37611
9/21/2013 8:15,10,100000000,17923,21254,39177
9/21/2013 8:16,10,100000000,17640,20921,38561
9/21/2013 8:17,10,100000000,17138,20960,38098
9/21/2013 8:18,10,100000000,17168,20203,37371
9/21/2013 8:18,10,100000000,17510,20732,38242
9/21/2013 8:19,10,100000000,17528,20192,37720
9/21/2013 8:20,10,100000000,17800,20586,38386
9/21/2013 8:21,10,100000000,16376,21093,37469
9/21/2013 8:22,10,100000000,17455,20911,38366
9/21/2013 8:22,10,100000000,17529,20477,38006
9/21/2013 8:23,10,100000000,17709,20613,38322
9/21/2013 8:24,10,100000000,17325,20778,38103
9/21/2013 8:25,10,100000000,17136,21141,38277
9/21/2013 8:25,10,100000000,16943,21110,38053
9/21/2013 8:26,10,100000000,16741,21110,37851
9/21/2013 8:27,10,100000000,18071,20260,38331
9/21/2013 8:28,10,100000000,17926,20119,38045
9/21/2013 8:29,10,100000000,16755,19962,36717
9/21/2013 8:29,10,100000000,17285,20344,37629
9/21/2013 8:30,10,100000000,17369,20447,37816
9/21/2013 8:31,10,100000000,16955,20925,37880
9/21/2013 8:32,10,100000000,17452,20193,37645
9/21/2013 8:32,10,100000000,17454,20152,37606
9/21/2013 8:33,10,100000000,17004,20260,37264
9/21/2013 8:34,10,100000000,18308,20652,38960
9/21/2013 8:35,10,100000000,18000,20255,38255
9/21/2013 8:36,10,100000000,17906,20565,38471
9/21/2013 8:36,10,100000000,17412,20308,37720
9/21/2013 8:37,10,100000000,17940,20094,38034
9/21/2013 8:38,10,100000000,17759,20121,37880
9/21/2013 8:39,10,100000000,17461,20858,38319
9/21/2013 8:39,10,100000000,17446,20031,37477
9/21/2013 8:40,10,100000000,17980,20316,38296
9/21/2013 8:41,10,100000000,17523,20127,37650
9/21/2013 8:42,10,100000000,17370,20353,37723
9/21/2013 8:43,10,100000000,16977,21081,38058
9/21/2013 8:43,10,100000000,17438,20021,37459
9/21/2013 8:44,10,100000000,17454,20143,37597
9/21/2013 8:45,10,100000000,17366,20834,38200
9/21/2013 8:46,10,100000000,18116,21049,39165
9/21/2013 8:46,10,100000000,16729,20332,37061
9/21/2013 8:47,10,100000000,17489,20141,37630
9/21/2013 8:48,10,100000000,17151,20554,37705
9/21/2013 8:49,10,100000000,17965,20933,38898
9/21/2013 8:50,10,100000000,17535,20110,37645
9/21/2013 8:50,10,100000000,17394,20809,38203
9/21/2013 8:51,10,100000000,17021,22091,39112
9/21/2013 8:52,10,100000000,17298,20311,37609
9/21/2013 8:53,10,100000000,16495,20850,37345
9/21/2013 8:53,10,100000000,16617,20573,37190
9/21/2013 8:54,10,100000000,17107,20789,37896
9/21/2013 8:55,10,100000000,17725,20142,37867
9/21/2013 8:56,10,100000000,17660,19984,37644
9/21/2013 8:56,10,100000000,17481,20166,37647
9/21/2013 8:57,10,100000000,17065,20169,37234
9/21/2013 8:58,10,100000000,16569,20819,37388
9/21/2013 8:59,10,100000000,17360,20575,37935
9/21/2013 9:00,10,100000000,17369,20794,38163
9/21/2013 9:00,12,1000,32,25,57
9/21/2013 9:00,12,1000,31,26,57
9/21/2013 9:00,12,1000,30,25,55
9/21/2013 9:00,12,1000,1014,28,1042
9/21/2013 9:00,12,1000,30,26,56
9/21/2013 9:00,12,1000,30,25,55
9/21/2013 9:00,12,1000,28,26,54
9/21/2013 9:00,12,1000,31,25,56
9/21/2013 9:00,12,1000,40,25,65
9/21/2013 9:00,12,1000,29,25,54
9/21/2013 9:00,12,1000,35,27,62
9/21/2013 9:00,12,1000,39,26,65
9/21/2013 9:00,12,1000,31,26,57
9/21/2013 9:00,12,1000,34,27,61
9/21/2013 9:00,12,1000,31,25,56
9/21/2013 9:00,12,1000,30,29,59
9/21/2013 9:00,12,1000,34,26,60
9/21/2013 9:00,12,1000,31,25,56
9/21/2013 9:00,12,1000,29,25,54
9/21/2013 9:00,12,1000,30,26,56
9/21/2013 9:00,12,1000,33,26,59
9/21/2013 9:00,12,1000,30,27,57
9/21/2013 9:00,12,1000,34,26,60
9/21/2013 9:00,12,1000,30,26,56
9/21/2013 9:00,12,1000,32,30,62
9/21/2013 9:00,12,1000,30,26,56
9/21/2013 9:00,12,1000,55,29,84
9/21/2013 9:01,12,1000,29,25,54
9/21/2013 9:01,12,1000,30,25,55
9/21/2013 9:01,12,1000,37,26,63
9/21/2013 9:01,12,1000,27,26,53
9/21/2013 9:01,12,1000,30,26,56
9/21/2013 9:01,12,1000,33,26,59
9/21/2013 9:01,12,1000,26,26,52
9/21/2013 9:01,12,1000,32,32,64
9/21/2013 9:01,12,1000,33,26,59
9/21/2013 9:01,12,1000,29,25,54
9/21/2013 9:01,12,1000,32,25,57
9/21/2013 9:01,12,1000,33,25,58
9/21/2013 9:01,12,1000,34,26,60
9/21/2013 9:01,12,1000,31,26,57
9/21/2013 9:01,12,1000,1019,28,1047
9/21/2013 9:01,12,1000,31,25,56
9/21/2013 9:01,12,1000,30,26,56
9/21/2013 9:01,12,1000,29,26,55
9/21/2013 9:01,12,1000,31,27,58
9/21/2013 9:01,12,1000,28,26,54
9/21/2013 9:01,12,1000,32,26,58
9/21/2013 9:01,12,1000,33,26,59
9/21/2013 9:01,12,1000,27,27,54
9/21/2013 9:01,12,1000,30,26,56
9/21/2013 9:01,12,1000,32,27,59
9/21/2013 9:01,12,1000,31,27,58
9/21/2013 9:01,12,1000,32,27,59
9/21/2013 9:01,12,1000,30,26,56
9/21/2013 9:02,12,1000,28,26,54
9/21/2013 9:02,12,1000,37,29,66
9/21/2013 9:02,12,1000,35,30,65
9/21/2013 9:02,12,1000,31,25,56
9/21/2013 9:02,12,1000,29,27,56
9/21/2013 9:02,12,1000,29,28,57
9/21/2013 9:02,12,1000,32,26,58
9/21/2013 9:02,12,1000,27,26,53
9/21/2013 9:02,12,1000,30,27,57
9/21/2013 9:02,12,1000,30,25,55
9/21/2013 9:02,12,1000,32,27,59
9/21/2013 9:02,12,1000,30,26,56
9/21/2013 9:02,12,1000,30,27,57
9/21/2013 9:02,12,1000,31,25,56
9/21/2013 9:02,12,1000,32,26,58
9/21/2013 9:02,12,1000,32,26,58
9/21/2013 9:02,12,1000,32,29,61
9/21/2013 9:02,12,1000,29,28,57
9/21/2013 9:02,12,1000,34,25,59
9/21/2013 9:02,12,1000,1026,30,1056
9/21/2013 9:02,12,1000,50,27,77
9/21/2013 9:02,12,1000,30,26,56
9/21/2013 9:02,12,1000,28,26,54
9/21/2013 9:02,12,1000,31,27,58
9/21/2013 9:02,12,1000,36,28,64
9/21/2013 9:02,12,1000,1013,29,1042
9/21/2013 9:02,12,1000,37,28,65
9/21/2013 9:02,12,1000,39,25,64
9/21/2013 9:03,12,1000,32,26,58
9/21/2013 9:03,12,1000,36,26,62
9/21/2013 9:03,12,1000,1017,28,1045
9/21/2013 9:03,12,1000,29,25,54
9/21/2013 9:03,12,1000,30,28,58
9/21/2013 9:03,12,1000,33,27,60
9/21/2013 9:03,12,1000,29,25,54
9/21/2013 9:03,12,1000,38,27,65
9/21/2013 9:03,12,1000,28,25,53
9/21/2013 9:03,12,1000,26,26,52
9/21/2013 9:03,12,1000,27,26,53
9/21/2013 9:03,12,1000,32,26,58
9/21/2013 9:03,12,1000,27,26,53
9/21/2013 9:03,12,1000,28,28,56
9/21/2013 9:03,12,1000,31,26,57
9/21/2013 9:03,12,1000,1018,30,1048
9/21/2013 9:03,12,1000,35,26,61
9/21/2013 9:03,12,1000,1013,30,1043
9/21/2013 9:03,12,1000,1026,30,1056
9/21/2013 9:03,12,1000,1012,28,1040
9/21/2013 9:03,12,1000,30,26,56
9/21/2013 9:03,12,1000,29,28,57
9/21/2013 9:03,12,1000,33,27,60
9/21/2013 9:03,12,1000,30,26,56
9/21/2013 9:03,12,1000,30,26,56
9/21/2013 9:03,12,1000,36,25,61
9/21/2013 9:04,12,1000,34,25,59
9/21/2013 9:04,12,1000,29,26,55
9/21/2013 9:04,12,1000,27,29,56
9/21/2013 9:04,12,1000,29,26,55
9/21/2013 9:04,12,1000,31,25,56
9/21/2013 9:04,12,1000,32,25,57
9/21/2013 9:04,12,2000,1019,38,1057
9/21/2013 9:04,12,2000,32,36,68
9/21/2013 9:04,12,2000,31,38,69
9/21/2013 9:04,12,2000,30,36,66
9/21/2013 9:04,12,2000,33,37,70
9/21/2013 9:04,12,2000,39,39,78
9/21/2013 9:04,12,2000,30,36,66
9/21/2013 9:04,12,2000,30,36,66
9/21/2013 9:04,12,2000,31,36,67
9/21/2013 9:04,12,2000,1014,39,1053
9/21/2013 9:04,12,2000,34,36,70
9/21/2013 9:04,12,2000,31,35,66
9/21/2013 9:04,12,2000,30,35,65
9/21/2013 9:04,12,2000,31,38,69
9/21/2013 9:04,12,2000,29,36,65
9/21/2013 9:04,12,2000,32,37,69
9/21/2013 9:04,12,2000,29,36,65
9/21/2013 9:04,12,2000,29,36,65
9/21/2013 9:04,12,2000,32,36,68
9/21/2013 9:04,12,2000,29,35,64
9/21/2013 9:04,12,2000,29,36,65
9/21/2013 9:04,12,2000,35,35,70
9/21/2013 9:05,12,2000,34,35,69
9/21/2013 9:05,12,2000,1017,38,1055
9/21/2013 9:05,12,2000,30,35,65
9/21/2013 9:05,12,2000,1013,40,1053
9/21/2013 9:05,12,2000,1014,39,1053
9/21/2013 9:05,12,2000,31,36,67
9/21/2013 9:05,12,2000,1014,39,1053
9/21/2013 9:05,12,2000,30,36,66
9/21/2013 9:05,12,2000,30,37,67
9/21/2013 9:05,12,2000,28,36,64
9/21/2013 9:05,12,2000,31,36,67
9/21/2013 9:05,12,2000,33,36,69
9/21/2013 9:05,12,2000,30,35,65
9/21/2013 9:05,12,2000,34,36,70
9/21/2013 9:05,12,2000,30,35,65
9/21/2013 9:05,12,2000,1029,40,1069
9/21/2013 9:05,12,2000,33,36,69
9/21/2013 9:05,12,2000,30,36,66
9/21/2013 9:05,12,2000,37,45,82
9/21/2013 9:05,12,2000,29,36,65
9/21/2013 9:05,12,2000,55,38,93
9/21/2013 9:05,12,2000,30,35,65
9/21/2013 9:05,12,2000,29,36,65
9/21/2013 9:05,12,2000,35,36,71
9/21/2013 9:05,12,2000,1018,39,1057
9/21/2013 9:05,12,2000,38,36,74
9/21/2013 9:06,12,2000,30,36,66
9/21/2013 9:06,12,2000,32,37,69
9/21/2013 9:06,12,2000,37,35,72
9/21/2013 9:06,12,2000,44,35,79
9/21/2013 9:06,12,2000,29,36,65
9/21/2013 9:06,12,2000,32,36,68
9/21/2013 9:06,12,2000,29,37,66
9/21/2013 9:06,12,2000,29,37,66
9/21/2013 9:06,12,2000,32,36,68
9/21/2013 9:06,12,2000,73,36,109
9/21/2013 9:06,12,2000,29,37,66
9/21/2013 9:06,12,2000,29,36,65
9/21/2013 9:06,12,2000,32,38,70
9/21/2013 9:06,12,2000,32,36,68
9/21/2013 9:06,12,2000,32,36,68
9/21/2013 9:06,12,2000,30,38,68
9/21/2013 9:06,12,2000,38,38,76
9/21/2013 9:06,12,2000,33,36,69
9/21/2013 9:06,12,2000,27,36,63
9/21/2013 9:06,12,2000,30,37,67
9/21/2013 9:06,12,2000,1016,37,1053
9/21/2013 9:06,12,2000,34,35,69
9/21/2013 9:06,12,2000,30,36,66
9/21/2013 9:06,12,2000,31,36,67
9/21/2013 9:06,12,2000,1025,38,1063
9/21/2013 9:06,12,2000,31,37,68
9/21/2013 9:06,12,2000,33,35,68
9/21/2013 9:07,12,2000,30,36,66
9/21/2013 9:07,12,2000,31,35,66
9/21/2013 9:07,12,2000,31,35,66
9/21/2013 9:07,12,2000,30,36,66
9/21/2013 9:07,12,2000,1032,39,1071
9/21/2013 9:07,12,2000,34,36,70
9/21/2013 9:07,12,2000,28,37,65
9/21/2013 9:07,12,2000,36,36,72
9/21/2013 9:07,12,2000,31,36,67
9/21/2013 9:07,12,2000,1024,38,1062
9/21/2013 9:07,12,2000,1021,40,1061
9/21/2013 9:07,12,2000,30,35,65
9/21/2013 9:07,12,2000,60,37,97
9/21/2013 9:07,12,2000,32,35,67
9/21/2013 9:07,12,2000,36,39,75
9/21/2013 9:07,12,2000,29,35,64
9/21/2013 9:07,12,2000,32,39,71
9/21/2013 9:07,12,2000,36,41,77
9/21/2013 9:07,12,2000,29,37,66
9/21/2013 9:07,12,2000,33,38,71
9/21/2013 9:07,12,2000,33,37,70
9/21/2013 9:07,12,2000,30,37,67
9/21/2013 9:07,12,2000,1011,39,1050
9/21/2013 9:07,12,2000,36,36,72
9/21/2013 9:07,12,2000,29,36,65
9/21/2013 9:08,12,2000,33,36,69
9/21/2013 9:08,12,2000,29,36,65
9/21/2013 9:08,12,2000,39,35,74
9/21/2013 9:08,12,2000,1024,36,1060
9/21/2013 9:08,12,2000,34,37,71
9/21/2013 9:08,12,2000,1016,39,1055
9/21/2013 9:08,12,2000,30,39,69
9/21/2013 9:08,12,2000,34,36,70
9/21/2013 9:08,12,2000,33,35,68
9/21/2013 9:08,12,2000,28,35,63
9/21/2013 9:08,12,2000,34,42,76
9/21/2013 9:08,12,2000,35,40,75
9/21/2013 9:08,12,2000,30,38,68
9/21/2013 9:08,12,2000,37,41,78
9/21/2013 9:08,12,2000,45,38,83
9/21/2013 9:08,12,3000,30,44,74
9/21/2013 9:08,12,3000,29,44,73
9/21/2013 9:08,12,3000,29,45,74
9/21/2013 9:08,12,3000,39,44,83
9/21/2013 9:08,12,3000,37,44,81
9/21/2013 9:08,12,3000,30,44,74
9/21/2013 9:08,12,3000,35,44,79
9/21/2013 9:08,12,3000,33,44,77
9/21/2013 9:08,12,3000,37,45,82
9/21/2013 9:08,12,3000,30,43,73
9/21/2013 9:08,12,3000,35,44,79
9/21/2013 9:08,12,3000,1014,45,1059
9/21/2013 9:09,12,3000,37,44,81
9/21/2013 9:09,12,3000,1019,48,1067
9/21/2013 9:09,12,3000,39,45,84
9/21/2013 9:09,12,3000,32,46,78
9/21/2013 9:09,12,3000,1015,50,1065
9/21/2013 9:09,12,3000,38,46,84
9/21/2013 9:09,12,3000,1014,58,1072
9/21/2013 9:09,12,3000,29,44,73
9/21/2013 9:09,12,3000,35,44,79
9/21/2013 9:09,12,3000,27,44,71
9/21/2013 9:09,12,3000,32,44,76
9/21/2013 9:09,12,3000,33,44,77
9/21/2013 9:09,12,3000,31,46,77
9/21/2013 9:09,12,3000,29,44,73
9/21/2013 9:09,12,3000,34,45,79
9/21/2013 9:09,12,3000,34,44,78
9/21/2013 9:09,12,3000,36,45,81
9/21/2013 9:09,12,3000,40,44,84
9/21/2013 9:09,12,3000,33,45,78
9/21/2013 9:09,12,3000,30,44,74
9/21/2013 9:09,12,3000,30,43,73
9/21/2013 9:09,12,3000,32,47,79
9/21/2013 9:09,12,3000,32,44,76
9/21/2013 9:09,12,3000,30,44,74
9/21/2013 9:09,12,3000,1026,46,1072
9/21/2013 9:09,12,3000,28,44,72
9/21/2013 9:09,12,3000,32,44,76
9/21/2013 9:10,12,3000,34,45,79
9/21/2013 9:10,12,3000,31,44,75
9/21/2013 9:10,12,3000,29,44,73
9/21/2013 9:10,12,3000,29,45,74
9/21/2013 9:10,12,3000,31,43,74
9/21/2013 9:10,12,3000,32,44,76
9/21/2013 9:10,12,3000,1014,49,1063
9/21/2013 9:10,12,3000,1029,48,1077
9/21/2013 9:10,12,3000,32,45,77
9/21/2013 9:10,12,3000,30,46,76
9/21/2013 9:10,12,3000,34,44,78
9/21/2013 9:10,12,3000,31,45,76
9/21/2013 9:10,12,3000,1028,47,1075
9/21/2013 9:10,12,3000,29,45,74
9/21/2013 9:10,12,3000,38,43,81
9/21/2013 9:10,12,3000,33,44,77
9/21/2013 9:10,12,3000,1016,47,1063
9/21/2013 9:10,12,3000,32,43,75
9/21/2013 9:10,12,3000,31,44,75
9/21/2013 9:10,12,3000,32,45,77
9/21/2013 9:10,12,3000,1013,49,1062
9/21/2013 9:10,12,3000,32,46,78
9/21/2013 9:10,12,3000,30,44,74
9/21/2013 9:10,12,3000,1019,49,1068
9/21/2013 9:10,12,3000,30,44,74
9/21/2013 9:11,12,3000,33,45,78
9/21/2013 9:11,12,3000,43,44,87
9/21/2013 9:11,12,3000,29,45,74
9/21/2013 9:11,12,3000,32,44,76
9/21/2013 9:11,12,3000,38,44,82
9/21/2013 9:11,12,3000,32,45,77
9/21/2013 9:11,12,3000,1015,49,1064
9/21/2013 9:11,12,3000,29,44,73
9/21/2013 9:11,12,3000,33,45,78
9/21/2013 9:11,12,3000,33,45,78
9/21/2013 9:11,12,3000,39,45,84
9/21/2013 9:11,12,3000,35,45,80
9/21/2013 9:11,12,3000,31,46,77
9/21/2013 9:11,12,3000,30,44,74
9/21/2013 9:11,12,3000,33,45,78
9/21/2013 9:11,12,3000,1023,48,1071
9/21/2013 9:11,12,3000,30,45,75
9/21/2013 9:11,12,3000,1034,48,1082
9/21/2013 9:11,12,3000,29,43,72
9/21/2013 9:11,12,3000,31,44,75
9/21/2013 9:11,12,3000,33,47,80
9/21/2013 9:11,12,3000,36,45,81
9/21/2013 9:11,12,3000,29,44,73
9/21/2013 9:11,12,3000,39,45,84
9/21/2013 9:11,12,3000,32,45,77
9/21/2013 9:11,12,3000,34,45,79
9/21/2013 9:11,12,3000,30,44,74
9/21/2013 9:11,12,3000,32,43,75
9/21/2013 9:11,12,3000,40,44,84
9/21/2013 9:12,12,3000,31,44,75
9/21/2013 9:12,12,3000,30,44,74
9/21/2013 9:12,12,3000,40,43,83
9/21/2013 9:12,12,3000,35,47,82
9/21/2013 9:12,12,3000,29,44,73
9/21/2013 9:12,12,3000,32,44,76
9/21/2013 9:12,12,3000,46,48,94
9/21/2013 9:12,12,3000,36,45,81
9/21/2013 9:12,12,3000,32,45,77
9/21/2013 9:12,12,3000,32,44,76
9/21/2013 9:12,12,3000,31,45,76
9/21/2013 9:12,12,3000,28,45,73
9/21/2013 9:12,12,3000,38,44,82
9/21/2013 9:12,12,3000,39,46,85
9/21/2013 9:12,12,3000,32,45,77
9/21/2013 9:12,12,3000,29,44,73
9/21/2013 9:12,12,3000,29,43,72
9/21/2013 9:12,12,3000,30,45,75
9/21/2013 9:12,12,3000,1024,48,1072
9/21/2013 9:12,12,3000,31,44,75
9/21/2013 9:12,12,3000,32,46,78
9/21/2013 9:12,12,3000,35,45,80
9/21/2013 9:12,12,4000,39,49,88
9/21/2013 9:12,12,4000,31,50,81
9/21/2013 9:12,12,4000,34,49,83
9/21/2013 9:12,12,4000,1023,54,1077
9/21/2013 9:12,12,4000,31,49,80
9/21/2013 9:12,12,4000,37,49,86
9/21/2013 9:13,12,4000,31,50,81
9/21/2013 9:13,12,4000,33,53,86
9/21/2013 9:13,12,4000,33,51,84
9/21/2013 9:13,12,4000,32,50,82
9/21/2013 9:13,12,4000,31,49,80
9/21/2013 9:13,12,4000,33,52,85
9/21/2013 9:13,12,4000,37,49,86
9/21/2013 9:13,12,4000,31,49,80
9/21/2013 9:13,12,4000,1026,53,1079
9/21/2013 9:13,12,4000,33,52,85
9/21/2013 9:13,12,4000,32,51,83
9/21/2013 9:13,12,4000,29,52,81
9/21/2013 9:13,12,4000,31,49,80
9/21/2013 9:13,12,4000,32,50,82
9/21/2013 9:13,12,4000,32,49,81
9/21/2013 9:13,12,4000,34,50,84
9/21/2013 9:13,12,4000,28,49,77
9/21/2013 9:13,12,4000,31,49,80
9/21/2013 9:13,12,4000,36,50,86
9/21/2013 9:13,12,4000,32,48,80
9/21/2013 9:13,12,4000,33,49,82
9/21/2013 9:13,12,4000,32,51,83
9/21/2013 9:13,12,4000,29,50,79
9/21/2013 9:13,12,4000,29,50,79
9/21/2013 9:13,12,4000,32,48,80
9/21/2013 9:13,12,4000,33,50,83
9/21/2013 9:13,12,4000,35,50,85
9/21/2013 9:13,12,4000,36,50,86
9/21/2013 9:13,12,4000,31,49,80
9/21/2013 9:14,12,4000,29,51,80
9/21/2013 9:14,12,4000,38,49,87
9/21/2013 9:14,12,4000,38,49,87
9/21/2013 9:14,12,4000,30,50,80
9/21/2013 9:14,12,4000,1031,54,1085
9/21/2013 9:14,12,4000,35,49,84
9/21/2013 9:14,12,4000,33,49,82
9/21/2013 9:14,12,4000,33,51,84
9/21/2013 9:14,12,4000,31,49,80
9/21/2013 9:14,12,4000,32,48,80
9/21/2013 9:14,12,4000,32,48,80
9/21/2013 9:14,12,4000,34,51,85
9/21/2013 9:14,12,4000,32,49,81
9/21/2013 9:14,12,4000,32,51,83
9/21/2013 9:14,12,4000,35,50,85
9/21/2013 9:14,12,4000,33,51,84
9/21/2013 9:14,12,4000,37,50,87
9/21/2013 9:14,12,4000,32,49,81
9/21/2013 9:14,12,4000,1016,51,1067
9/21/2013 9:14,12,4000,37,49,86
9/21/2013 9:14,12,4000,39,51,90
9/21/2013 9:14,12,4000,33,50,83
9/21/2013 9:14,12,4000,30,48,78
9/21/2013 9:14,12,4000,31,49,80
9/21/2013 9:14,12,4000,31,49,80
9/21/2013 9:14,12,4000,33,50,83
9/21/2013 9:15,12,4000,45,51,96
9/21/2013 9:15,12,4000,37,53,90
9/21/2013 9:15,12,4000,31,50,81
9/21/2013 9:15,12,4000,37,49,86
9/21/2013 9:15,12,4000,33,49,82
9/21/2013 9:15,12,4000,32,50,82
9/21/2013 9:15,12,4000,34,50,84
9/21/2013 9:15,12,4000,29,51,80
9/21/2013 9:15,12,4000,35,56,91
9/21/2013 9:15,12,4000,36,51,87
9/21/2013 9:15,12,4000,35,48,83
9/21/2013 9:15,12,4000,31,50,81
9/21/2013 9:15,12,4000,34,50,84
9/21/2013 9:15,12,4000,31,49,80
9/21/2013 9:15,12,4000,32,50,82
9/21/2013 9:15,12,4000,38,53,91
9/21/2013 9:15,12,4000,41,53,94
9/21/2013 9:15,12,4000,39,49,88
9/21/2013 9:15,12,4000,35,50,85
9/21/2013 9:15,12,4000,30,48,78
9/21/2013 9:15,12,4000,32,49,81
9/21/2013 9:15,12,4000,32,50,82
9/21/2013 9:15,12,4000,32,50,82
9/21/2013 9:15,12,4000,33,53,86
9/21/2013 9:15,12,4000,32,48,80
9/21/2013 9:15,12,4000,37,48,85
9/21/2013 9:15,12,4000,35,49,84
9/21/2013 9:15,12,4000,33,48,81
9/21/2013 9:15,12,4000,1014,53,1067
9/21/2013 9:15,12,4000,31,56,87
9/21/2013 9:16,12,4000,1013,50,1063
9/21/2013 9:16,12,4000,30,49,79
9/21/2013 9:16,12,4000,30,48,78
9/21/2013 9:16,12,4000,31,49,80
9/21/2013 9:16,12,4000,32,52,84
9/21/2013 9:16,12,4000,32,49,81
9/21/2013 9:16,12,4000,38,49,87
9/21/2013 9:16,12,4000,36,49,85
9/21/2013 9:16,12,4000,35,50,85
9/21/2013 9:16,12,4000,32,52,84
9/21/2013 9:16,12,4000,36,49,85
9/21/2013 9:16,12,4000,31,48,79
9/21/2013 9:16,12,4000,33,51,84
9/21/2013 9:16,12,4000,1014,51,1065
9/21/2013 9:16,12,4000,1015,51,1066
9/21/2013 9:16,12,4000,39,51,90
9/21/2013 9:16,12,4000,32,51,83
9/21/2013 9:16,12,4000,31,49,80
9/21/2013 9:16,12,4000,1015,55,1070
9/21/2013 9:16,12,4000,32,48,80
9/21/2013 9:16,12,4000,35,50,85
9/21/2013 9:16,12,4000,31,51,82
9/21/2013 9:16,12,4000,32,49,81
9/21/2013 9:16,12,4000,32,51,83
9/21/2013 9:16,12,5000,34,53,87
9/21/2013 9:16,12,5000,34,53,87
9/21/2013 9:16,12,5000,38,54,92
9/21/2013 9:16,12,5000,35,53,88
9/21/2013 9:17,12,5000,33,53,86
9/21/2013 9:17,12,5000,37,56,93
9/21/2013 9:17,12,5000,39,55,94
9/21/2013 9:17,12,5000,37,54,91
9/21/2013 9:17,12,5000,35,54,89
9/21/2013 9:17,12,5000,30,54,84
9/21/2013 9:17,12,5000,1024,56,1080
9/21/2013 9:17,12,5000,1036,57,1093
9/21/2013 9:17,12,5000,34,55,89
9/21/2013 9:17,12,5000,35,55,90
9/21/2013 9:17,12,5000,34,53,87
9/21/2013 9:17,12,5000,38,58,96
9/21/2013 9:17,12,5000,37,55,92
9/21/2013 9:17,12,5000,32,55,87
9/21/2013 9:17,12,5000,34,54,88
9/21/2013 9:17,12,5000,34,53,87
9/21/2013 9:17,12,5000,41,54,95
9/21/2013 9:17,12,5000,1015,58,1073
9/21/2013 9:17,12,5000,33,53,86
9/21/2013 9:17,12,5000,34,53,87
9/21/2013 9:17,12,5000,1027,58,1085
9/21/2013 9:17,12,5000,35,55,90
9/21/2013 9:17,12,5000,32,52,84
9/21/2013 9:17,12,5000,32,53,85
9/21/2013 9:17,12,5000,34,54,88
9/21/2013 9:17,12,5000,34,56,90
9/21/2013 9:17,12,5000,1013,57,1070
9/21/2013 9:18,12,5000,33,53,86
9/21/2013 9:18,12,5000,34,52,86
9/21/2013 9:18,12,5000,1031,58,1089
9/21/2013 9:18,12,5000,36,54,90
9/21/2013 9:18,12,5000,40,54,94
9/21/2013 9:18,12,5000,37,54,91
9/21/2013 9:18,12,5000,30,53,83
9/21/2013 9:18,12,5000,32,55,87
9/21/2013 9:18,12,5000,31,54,85
9/21/2013 9:18,12,5000,32,54,86
9/21/2013 9:18,12,5000,43,53,96
9/21/2013 9:18,12,5000,33,53,86
9/21/2013 9:18,12,5000,41,54,95
9/21/2013 9:18,12,5000,35,54,89
9/21/2013 9:18,12,5000,35,53,88
9/21/2013 9:18,12,5000,38,59,97
9/21/2013 9:18,12,5000,36,55,91
9/21/2013 9:18,12,5000,1034,57,1091
9/21/2013 9:18,12,5000,35,53,88
9/21/2013 9:18,12,5000,42,57,99
9/21/2013 9:18,12,5000,33,53,86
9/21/2013 9:18,12,5000,1015,57,1072
9/21/2013 9:18,12,5000,36,53,89
9/21/2013 9:18,12,5000,1014,56,1070
9/21/2013 9:18,12,5000,1014,57,1071
9/21/2013 9:19,12,5000,40,53,93
9/21/2013 9:19,12,5000,1017,58,1075
9/21/2013 9:19,12,5000,34,57,91
9/21/2013 9:19,12,5000,31,54,85
9/21/2013 9:19,12,5000,36,56,92
9/21/2013 9:19,12,5000,34,53,87
9/21/2013 9:19,12,5000,35,56,91
9/21/2013 9:19,12,5000,31,54,85
9/21/2013 9:19,12,5000,33,54,87
9/21/2013 9:19,12,5000,1025,55,1080
9/21/2013 9:19,12,5000,1018,55,1073
9/21/2013 9:19,12,5000,35,53,88
9/21/2013 9:19,12,5000,34,53,87
9/21/2013 9:19,12,5000,34,53,87
9/21/2013 9:19,12,5000,34,53,87
9/21/2013 9:19,12,5000,36,57,93
9/21/2013 9:19,12,5000,30,53,83
9/21/2013 9:19,12,5000,40,53,93
9/21/2013 9:19,12,5000,35,52,87
9/21/2013 9:19,12,5000,33,53,86
9/21/2013 9:19,12,5000,38,56,94
9/21/2013 9:19,12,5000,31,52,83
9/21/2013 9:19,12,5000,35,53,88
9/21/2013 9:19,12,5000,32,55,87
9/21/2013 9:19,12,5000,32,53,85
9/21/2013 9:19,12,5000,31,53,84
9/21/2013 9:20,12,5000,1022,58,1080
9/21/2013 9:20,12,5000,1014,58,1072
9/21/2013 9:20,12,5000,40,56,96
9/21/2013 9:20,12,5000,37,55,92
9/21/2013 9:20,12,5000,34,54,88
9/21/2013 9:20,12,5000,33,57,90
9/21/2013 9:20,12,5000,33,53,86
9/21/2013 9:20,12,5000,40,53,93
9/21/2013 9:20,12,5000,32,52,84
9/21/2013 9:20,12,5000,33,54,87
9/21/2013 9:20,12,5000,32,53,85
9/21/2013 9:20,12,5000,35,53,88
9/21/2013 9:20,12,5000,34,52,86
9/21/2013 9:20,12,5000,33,56,89
9/21/2013 9:20,12,5000,34,56,90
9/21/2013 9:20,12,5000,1017,55,1072
9/21/2013 9:20,12,5000,32,55,87
9/21/2013 9:20,12,5000,33,54,87
9/21/2013 9:20,12,5000,36,52,88
9/21/2013 9:20,12,5000,1017,56,1073
9/21/2013 9:20,12,5000,35,54,89
9/21/2013 9:20,12,5000,35,53,88
9/21/2013 9:20,12,5000,34,56,90
9/21/2013 9:20,12,5000,37,60,97
9/21/2013 9:20,12,5000,38,54,92
9/21/2013 9:20,12,5000,36,55,91
9/21/2013 9:20,12,5000,33,53,86
9/21/2013 9:20,12,5000,35,55,90
9/21/2013 9:21,12,5000,34,55,89
9/21/2013 9:21,12,5000,30,52,82
9/21/2013 9:21,12,5000,34,55,89
9/21/2013 9:21,12,5000,1018,58,1076
9/21/2013 9:21,12,5000,33,55,88
9/21/2013 9:21,12,6000,31,56,87
9/21/2013 9:21,12,6000,35,58,93
9/21/2013 9:21,12,6000,33,57,90
9/21/2013 9:21,12,6000,1016,62,1078
9/21/2013 9:21,12,6000,33,57,90
9/21/2013 9:21,12,6000,35,59,94
9/21/2013 9:21,12,6000,1035,61,1096
9/21/2013 9:21,12,6000,42,58,100
9/21/2013 9:21,12,6000,1038,63,1101
9/21/2013 9:21,12,6000,33,58,91
9/21/2013 9:21,12,6000,34,57,91
9/21/2013 9:21,12,6000,1014,62,1076
9/21/2013 9:21,12,6000,1031,63,1094
9/21/2013 9:21,12,6000,1024,61,1085
9/21/2013 9:21,12,6000,1024,61,1085
9/21/2013 9:21,12,6000,33,56,89
9/21/2013 9:21,12,6000,36,60,96
9/21/2013 9:21,12,6000,34,57,91
9/21/2013 9:21,12,6000,33,58,91
9/21/2013 9:21,12,6000,37,59,96
9/21/2013 9:21,12,6000,44,58,102
9/21/2013 9:22,12,6000,32,58,90
9/21/2013 9:22,12,6000,39,58,97
9/21/2013 9:22,12,6000,39,58,97
9/21/2013 9:22,12,6000,35,61,96
9/21/2013 9:22,12,6000,34,59,93
9/21/2013 9:22,12,6000,38,59,97
9/21/2013 9:22,12,6000,37,61,98
9/21/2013 9:22,12,6000,36,58,94
9/21/2013 9:22,12,6000,41,61,102
9/21/2013 9:22,12,6000,1016,61,1077
9/21/2013 9:22,12,6000,36,57,93
9/21/2013 9:22,12,6000,1017,61,1078
9/21/2013 9:22,12,6000,32,58,90
9/21/2013 9:22,12,6000,37,58,95
9/21/2013 9:22,12,6000,35,57,92
9/21/2013 9:22,12,6000,34,58,92
9/21/2013 9:22,12,6000,34,58,92
9/21/2013 9:22,12,6000,39,59,98
9/21/2013 9:22,12,6000,1020,60,1080
9/21/2013 9:22,12,6000,36,57,93
9/21/2013 9:22,12,6000,1016,61,1077
9/21/2013 9:22,12,6000,1027,60,1087
9/21/2013 9:22,12,6000,35,57,92
9/21/2013 9:22,12,6000,33,60,93
9/21/2013 9:22,12,6000,33,60,93
9/21/2013 9:22,12,6000,36,58,94
9/21/2013 9:22,12,6000,1025,62,1087
9/21/2013 9:23,12,6000,33,57,90
9/21/2013 9:23,12,6000,39,58,97
9/21/2013 9:23,12,6000,32,57,89
9/21/2013 9:23,12,6000,1013,62,1075
9/21/2013 9:23,12,6000,1016,60,1076
9/21/2013 9:23,12,6000,31,59,90
9/21/2013 9:23,12,6000,1015,63,1078
9/21/2013 9:23,12,6000,35,57,92
9/21/2013 9:23,12,6000,1013,62,1075
9/21/2013 9:23,12,6000,35,58,93
9/21/2013 9:23,12,6000,33,58,91
9/21/2013 9:23,12,6000,34,57,91
9/21/2013 9:23,12,6000,37,59,96
9/21/2013 9:23,12,6000,1017,59,1076
9/21/2013 9:23,12,6000,34,61,95
9/21/2013 9:23,12,6000,1019,60,1079
9/21/2013 9:23,12,6000,33,58,91
9/21/2013 9:23,12,6000,1025,62,1087
9/21/2013 9:23,12,6000,1027,58,1085
9/21/2013 9:23,12,6000,45,58,103
9/21/2013 9:23,12,6000,34,57,91
9/21/2013 9:23,12,6000,34,57,91
9/21/2013 9:23,12,6000,37,58,95
9/21/2013 9:24,12,6000,35,56,91
9/21/2013 9:24,12,6000,33,58,91
9/21/2013 9:24,12,6000,37,58,95
9/21/2013 9:24,12,6000,37,58,95
9/21/2013 9:24,12,6000,39,58,97
9/21/2013 9:24,12,6000,41,64,105
9/21/2013 9:24,12,6000,33,58,91
9/21/2013 9:24,12,6000,1021,60,1081
9/21/2013 9:24,12,6000,33,68,101
9/21/2013 9:24,12,6000,34,57,91
9/21/2013 9:24,12,6000,1016,62,1078
9/21/2013 9:24,12,6000,35,60,95
9/21/2013 9:24,12,6000,37,56,93
9/21/2013 9:24,12,6000,38,62,100
9/21/2013 9:24,12,6000,34,58,92
9/21/2013 9:24,12,6000,41,59,100
9/21/2013 9:24,12,6000,34,57,91
9/21/2013 9:24,12,6000,40,59,99
9/21/2013 9:24,12,6000,35,57,92
9/21/2013 9:24,12,6000,36,58,94
9/21/2013 9:24,12,6000,37,60,97
9/21/2013 9:24,12,6000,33,57,90
9/21/2013 9:24,12,6000,43,58,101
9/21/2013 9:24,12,6000,32,56,88
9/21/2013 9:24,12,6000,36,56,92
9/21/2013 9:24,12,6000,35,59,94
9/21/2013 9:24,12,6000,35,58,93
9/21/2013 9:24,12,6000,1033,59,1092
9/21/2013 9:25,12,6000,33,58,91
9/21/2013 9:25,12,6000,34,56,90
9/21/2013 9:25,12,6000,1020,63,1083
9/21/2013 9:25,12,6000,33,57,90
9/21/2013 9:25,12,6000,1031,62,1093
9/21/2013 9:25,12,6000,32,57,89
9/21/2013 9:25,12,6000,40,58,98
9/21/2013 9:25,12,6000,37,60,97
9/21/2013 9:25,12,6000,34,59,93
9/21/2013 9:25,12,6000,35,57,92
9/21/2013 9:25,12,6000,33,58,91
9/21/2013 9:25,12,6000,37,57,94
9/21/2013 9:25,12,6000,33,58,91
9/21/2013 9:25,12,6000,34,57,91
9/21/2013 9:25,12,6000,38,57,95
9/21/2013 9:25,12,6000,35,60,95
9/21/2013 9:25,12,7000,38,62,100
9/21/2013 9:25,12,7000,38,64,102
9/21/2013 9:25,12,7000,1018,63,1081
9/21/2013 9:25,12,7000,37,62,99
9/21/2013 9:25,12,7000,39,59,98
9/21/2013 9:25,12,7000,33,62,95
9/21/2013 9:25,12,7000,34,60,94
9/21/2013 9:25,12,7000,39,61,100
9/21/2013 9:25,12,7000,33,62,95
9/21/2013 9:25,12,7000,39,60,99
9/21/2013 9:25,12,7000,34,61,95
9/21/2013 9:25,12,7000,36,59,95
9/21/2013 9:25,12,7000,37,62,99
9/21/2013 9:26,12,7000,33,60,93
9/21/2013 9:26,12,7000,34,64,98
9/21/2013 9:26,12,7000,36,61,97
9/21/2013 9:26,12,7000,39,63,102
9/21/2013 9:26,12,7000,33,61,94
9/21/2013 9:26,12,7000,35,63,98
9/21/2013 9:26,12,7000,40,63,103
9/21/2013 9:26,12,7000,42,63,105
9/21/2013 9:26,12,7000,39,61,100
9/21/2013 9:26,12,7000,37,62,99
9/21/2013 9:26,12,7000,38,69,107
9/21/2013 9:26,12,7000,43,59,102
9/21/2013 9:26,12,7000,35,62,97
9/21/2013 9:26,12,7000,35,58,93
9/21/2013 9:26,12,7000,35,59,94
9/21/2013 9:26,12,7000,37,62,99
9/21/2013 9:26,12,7000,38,58,96
9/21/2013 9:26,12,7000,34,62,96
9/21/2013 9:26,12,7000,1021,65,1086
9/21/2013 9:26,12,7000,37,61,98
9/21/2013 9:26,12,7000,42,61,103
9/21/2013 9:26,12,7000,34,63,97
9/21/2013 9:26,12,7000,37,60,97
9/21/2013 9:26,12,7000,33,64,97
9/21/2013 9:26,12,7000,41,61,102
9/21/2013 9:26,12,7000,35,60,95
9/21/2013 9:26,12,7000,40,62,102
9/21/2013 9:26,12,7000,41,58,99
9/21/2013 9:26,12,7000,1031,63,1094
9/21/2013 9:27,12,7000,39,60,99
9/21/2013 9:27,12,7000,39,62,101
9/21/2013 9:27,12,7000,34,60,94
9/21/2013 9:27,12,7000,38,66,104
9/21/2013 9:27,12,7000,1028,67,1095
9/21/2013 9:27,12,7000,37,61,98
9/21/2013 9:27,12,7000,42,61,103
9/21/2013 9:27,12,7000,37,64,101
9/21/2013 9:27,12,7000,1016,66,1082
9/21/2013 9:27,12,7000,37,68,105
9/21/2013 9:27,12,7000,38,62,100
9/21/2013 9:27,12,7000,47,62,109
9/21/2013 9:27,12,7000,33,63,96
9/21/2013 9:27,12,7000,34,59,93
9/21/2013 9:27,12,7000,35,60,95
9/21/2013 9:27,12,7000,35,61,96
9/21/2013 9:27,12,7000,34,62,96
9/21/2013 9:27,12,7000,33,60,93
9/21/2013 9:27,12,7000,37,62,99
9/21/2013 9:27,12,7000,43,60,103
9/21/2013 9:27,12,7000,34,63,97
9/21/2013 9:27,12,7000,35,59,94
9/21/2013 9:27,12,7000,36,60,96
9/21/2013 9:27,12,7000,40,58,98
9/21/2013 9:27,12,7000,32,60,92
9/21/2013 9:27,12,7000,46,63,109
9/21/2013 9:27,12,7000,34,62,96
9/21/2013 9:27,12,7000,34,59,93
9/21/2013 9:28,12,7000,40,61,101
9/21/2013 9:28,12,7000,36,60,96
9/21/2013 9:28,12,7000,1027,66,1093
9/21/2013 9:28,12,7000,1026,64,1090
9/21/2013 9:28,12,7000,35,65,100
9/21/2013 9:28,12,7000,35,62,97
9/21/2013 9:28,12,7000,36,61,97
9/21/2013 9:28,12,7000,35,59,94
9/21/2013 9:28,12,7000,35,62,97
9/21/2013 9:28,12,7000,35,61,96
9/21/2013 9:28,12,7000,1016,65,1081
9/21/2013 9:28,12,7000,42,67,109
9/21/2013 9:28,12,7000,1019,62,1081
9/21/2013 9:28,12,7000,33,61,94
9/21/2013 9:28,12,7000,39,62,101
9/21/2013 9:28,12,7000,40,61,101
9/21/2013 9:28,12,7000,42,61,103
9/21/2013 9:28,12,7000,37,61,98
9/21/2013 9:28,12,7000,38,62,100
9/21/2013 9:28,12,7000,42,59,101
9/21/2013 9:28,12,7000,33,60,93
9/21/2013 9:28,12,7000,38,60,98
9/21/2013 9:28,12,7000,33,60,93
9/21/2013 9:28,12,7000,34,61,95
9/21/2013 9:28,12,7000,36,63,99
9/21/2013 9:28,12,7000,35,59,94
9/21/2013 9:28,12,7000,37,61,98
9/21/2013 9:29,12,7000,1039,65,1104
9/21/2013 9:29,12,7000,33,59,92
9/21/2013 9:29,12,7000,41,62,103
9/21/2013 9:29,12,7000,34,63,97
9/21/2013 9:29,12,7000,1021,65,1086
9/21/2013 9:29,12,7000,42,65,107
9/21/2013 9:29,12,7000,36,62,98
9/21/2013 9:29,12,7000,43,63,106
9/21/2013 9:29,12,7000,34,60,94
9/21/2013 9:29,12,7000,34,60,94
9/21/2013 9:29,12,7000,36,64,100
9/21/2013 9:29,12,7000,1017,64,1081
9/21/2013 9:29,12,7000,37,66,103
9/21/2013 9:29,12,7000,33,62,95
9/21/2013 9:29,12,7000,33,58,91
9/21/2013 9:29,12,7000,38,61,99
9/21/2013 9:29,12,7000,35,62,97
9/21/2013 9:29,12,7000,35,63,98
9/21/2013 9:29,12,8000,39,68,107
9/21/2013 9:29,12,8000,35,65,100
9/21/2013 9:29,12,8000,38,60,98
9/21/2013 9:29,12,8000,37,61,98
9/21/2013 9:29,12,8000,37,67,104
9/21/2013 9:29,12,8000,34,60,94
9/21/2013 9:29,12,8000,36,59,95
9/21/2013 9:29,12,8000,42,65,107
9/21/2013 9:29,12,8000,35,66,101
9/21/2013 9:29,12,8000,33,59,92
9/21/2013 9:30,12,8000,41,66,107
9/21/2013 9:30,12,8000,38,64,102
9/21/2013 9:30,12,8000,35,64,99
9/21/2013 9:30,12,8000,33,64,97
9/21/2013 9:30,12,8000,37,62,99
9/21/2013 9:30,12,8000,39,65,104
9/21/2013 9:30,12,8000,36,65,101
9/21/2013 9:30,12,8000,40,62,102
9/21/2013 9:30,12,8000,37,62,99
9/21/2013 9:30,12,8000,45,58,103
9/21/2013 9:30,12,8000,34,63,97
9/21/2013 9:30,12,8000,39,64,103
9/21/2013 9:30,12,8000,44,62,106
9/21/2013 9:30,12,8000,39,61,100
9/21/2013 9:30,12,8000,41,60,101
9/21/2013 9:30,12,8000,37,60,97
9/21/2013 9:30,12,8000,42,61,103
9/21/2013 9:30,12,8000,42,63,105
9/21/2013 9:30,12,8000,34,62,96
9/21/2013 9:30,12,8000,38,65,103
9/21/2013 9:30,12,8000,39,63,102
9/21/2013 9:30,12,8000,38,60,98
9/21/2013 9:30,12,8000,1023,62,1085
9/21/2013 9:30,12,8000,37,59,96
9/21/2013 9:30,12,8000,38,61,99
9/21/2013 9:30,12,8000,38,61,99
9/21/2013 9:30,12,8000,34,62,96
9/21/2013 9:30,12,8000,37,59,96
9/21/2013 9:30,12,8000,35,62,97
9/21/2013 9:31,12,8000,35,63,98
9/21/2013 9:31,12,8000,37,65,102
9/21/2013 9:31,12,8000,36,59,95
9/21/2013 9:31,12,8000,36,62,98
9/21/2013 9:31,12,8000,36,62,98
9/21/2013 9:31,12,8000,1030,66,1096
9/21/2013 9:31,12,8000,36,63,99
9/21/2013 9:31,12,8000,37,59,96
9/21/2013 9:31,12,8000,34,65,99
9/21/2013 9:31,12,8000,44,66,110
9/21/2013 9:31,12,8000,37,62,99
9/21/2013 9:31,12,8000,41,65,106
9/21/2013 9:31,12,8000,46,66,112
9/21/2013 9:31,12,8000,36,61,97
9/21/2013 9:31,12,8000,38,62,100
9/21/2013 9:31,12,8000,36,65,101
9/21/2013 9:31,12,8000,39,64,103
9/21/2013 9:31,12,8000,34,62,96
9/21/2013 9:31,12,8000,36,62,98
9/21/2013 9:31,12,8000,52,62,114
9/21/2013 9:31,12,8000,43,61,104
9/21/2013 9:31,12,8000,1016,63,1079
9/21/2013 9:31,12,8000,38,65,103
9/21/2013 9:31,12,8000,36,63,99
9/21/2013 9:31,12,8000,38,64,102
9/21/2013 9:31,12,8000,38,64,102
9/21/2013 9:31,12,8000,1013,63,1076
9/21/2013 9:32,12,8000,36,62,98
9/21/2013 9:32,12,8000,36,59,95
9/21/2013 9:32,12,8000,33,64,97
9/21/2013 9:32,12,8000,37,59,96
9/21/2013 9:32,12,8000,38,69,107
9/21/2013 9:32,12,8000,1015,65,1080
9/21/2013 9:32,12,8000,40,63,103
9/21/2013 9:32,12,8000,36,64,100
9/21/2013 9:32,12,8000,44,59,103
9/21/2013 9:32,12,8000,40,64,104
9/21/2013 9:32,12,8000,36,58,94
9/21/2013 9:32,12,8000,34,64,98
9/21/2013 9:32,12,8000,1025,63,1088
9/21/2013 9:32,12,8000,37,60,97
9/21/2013 9:32,12,8000,40,61,101
9/21/2013 9:32,12,8000,36,60,96
9/21/2013 9:32,12,8000,41,62,103
9/21/2013 9:32,12,8000,37,60,97
9/21/2013 9:32,12,8000,41,64,105
9/21/2013 9:32,12,8000,1014,66,1080
9/21/2013 9:32,12,8000,35,61,96
9/21/2013 9:32,12,8000,38,62,100
9/21/2013 9:32,12,8000,40,62,102
9/21/2013 9:32,12,8000,38,63,101
9/21/2013 9:32,12,8000,1023,67,1090
9/21/2013 9:32,12,8000,43,64,107
9/21/2013 9:32,12,8000,36,62,98
9/21/2013 9:33,12,8000,39,63,102
9/21/2013 9:33,12,8000,44,64,108
9/21/2013 9:33,12,8000,37,67,104
9/21/2013 9:33,12,8000,1021,66,1087
9/21/2013 9:33,12,8000,1015,63,1078
9/21/2013 9:33,12,8000,38,63,101
9/21/2013 9:33,12,8000,1035,70,1105
9/21/2013 9:33,12,8000,1015,67,1082
9/21/2013 9:33,12,8000,37,61,98
9/21/2013 9:33,12,8000,1018,69,1087
9/21/2013 9:33,12,8000,45,59,104
9/21/2013 9:33,12,8000,39,63,102
9/21/2013 9:33,12,8000,37,63,100
9/21/2013 9:33,12,8000,43,61,104
9/21/2013 9:33,12,8000,37,62,99
9/21/2013 9:33,12,8000,37,65,102
9/21/2013 9:33,12,8000,36,61,97
9/21/2013 9:33,12,8000,41,66,107
9/21/2013 9:33,12,8000,37,62,99
9/21/2013 9:33,12,8000,1036,62,1098
9/21/2013 9:33,12,8000,37,63,100
9/21/2013 9:33,12,8000,36,63,99
9/21/2013 9:33,12,9000,35,63,98
9/21/2013 9:33,12,9000,36,59,95
9/21/2013 9:33,12,9000,1020,66,1086
9/21/2013 9:34,12,9000,39,58,97
9/21/2013 9:34,12,9000,43,65,108
9/21/2013 9:34,12,9000,42,65,107
9/21/2013 9:34,12,9000,39,65,104
9/21/2013 9:34,12,9000,40,60,100
9/21/2013 9:34,12,9000,1036,64,1100
9/21/2013 9:34,12,9000,41,66,107
9/21/2013 9:34,12,9000,41,58,99
9/21/2013 9:34,12,9000,38,61,99
9/21/2013 9:34,12,9000,37,62,99
9/21/2013 9:34,12,9000,1029,67,1096
9/21/2013 9:34,12,9000,38,62,100
9/21/2013 9:34,12,9000,38,62,100
9/21/2013 9:34,12,9000,38,64,102
9/21/2013 9:34,12,9000,35,60,95
9/21/2013 9:34,12,9000,44,62,106
9/21/2013 9:34,12,9000,39,63,102
9/21/2013 9:34,12,9000,37,59,96
9/21/2013 9:34,12,9000,38,60,98
9/21/2013 9:34,12,9000,1019,66,1085
9/21/2013 9:34,12,9000,37,59,96
9/21/2013 9:34,12,9000,1034,70,1104
9/21/2013 9:34,12,9000,37,62,99
9/21/2013 9:34,12,9000,40,62,102
9/21/2013 9:34,12,9000,35,61,96
9/21/2013 9:35,12,9000,1015,64,1079
9/21/2013 9:35,12,9000,1023,63,1086
9/21/2013 9:35,12,9000,1040,67,1107
9/21/2013 9:35,12,9000,36,62,98
9/21/2013 9:35,12,9000,41,66,107
9/21/2013 9:35,12,9000,41,66,107
9/21/2013 9:35,12,9000,41,69,110
9/21/2013 9:35,12,9000,43,62,105
9/21/2013 9:35,12,9000,38,61,99
9/21/2013 9:35,12,9000,38,60,98
9/21/2013 9:35,12,9000,40,61,101
9/21/2013 9:35,12,9000,1031,63,1094
9/21/2013 9:35,12,9000,37,61,98
9/21/2013 9:35,12,9000,38,60,98
9/21/2013 9:35,12,9000,1036,68,1104
9/21/2013 9:35,12,9000,40,64,104
9/21/2013 9:35,12,9000,41,63,104
9/21/2013 9:35,12,9000,41,63,104
9/21/2013 9:35,12,9000,39,59,98
9/21/2013 9:35,12,9000,38,64,102
9/21/2013 9:35,12,9000,1017,69,1086
9/21/2013 9:35,12,9000,39,63,102
9/21/2013 9:35,12,9000,40,66,106
9/21/2013 9:35,12,9000,1017,62,1079
9/21/2013 9:35,12,9000,1017,66,1083
9/21/2013 9:36,12,9000,38,68,106
9/21/2013 9:36,12,9000,38,65,103
9/21/2013 9:36,12,9000,40,70,110
9/21/2013 9:36,12,9000,44,68,112
9/21/2013 9:36,12,9000,40,60,100
9/21/2013 9:36,12,9000,46,60,106
9/21/2013 9:36,12,9000,38,61,99
9/21/2013 9:36,12,9000,1022,67,1089
9/21/2013 9:36,12,9000,41,61,102
9/21/2013 9:36,12,9000,36,65,101
9/21/2013 9:36,12,9000,43,68,111
9/21/2013 9:36,12,9000,38,67,105
9/21/2013 9:36,12,9000,36,72,108
9/21/2013 9:36,12,9000,35,59,94
9/21/2013 9:36,12,9000,38,60,98
9/21/2013 9:36,12,9000,38,58,96
9/21/2013 9:36,12,9000,42,68,110
9/21/2013 9:36,12,9000,38,61,99
9/21/2013 9:36,12,9000,39,67,106
9/21/2013 9:36,12,9000,35,61,96
9/21/2013 9:36,12,9000,37,63,100
9/21/2013 9:36,12,9000,1018,69,1087
9/21/2013 9:36,12,9000,37,64,101
9/21/2013 9:36,12,9000,1022,66,1088
9/21/2013 9:36,12,9000,38,60,98
9/21/2013 9:37,12,9000,36,60,96
9/21/2013 9:37,12,9000,37,59,96
9/21/2013 9:37,12,9000,38,62,100
9/21/2013 9:37,12,9000,1034,63,1097
9/21/2013 9:37,12,9000,40,61,101
9/21/2013 9:37,12,9000,39,65,104
9/21/2013 9:37,12,9000,38,64,102
9/21/2013 9:37,12,9000,38,59,97
9/21/2013 9:37,12,9000,39,66,105
9/21/2013 9:37,12,9000,38,58,96
9/21/2013 9:37,12,9000,1021,62,1083
9/21/2013 9:37,12,9000,1017,65,1082
9/21/2013 9:37,12,9000,39,66,105
9/21/2013 9:37,12,9000,35,64,99
9/21/2013 9:37,12,9000,38,59,97
9/21/2013 9:37,12,9000,42,63,105
9/21/2013 9:37,12,9000,35,61,96
9/21/2013 9:37,12,9000,37,63,100
9/21/2013 9:37,12,9000,40,60,100
9/21/2013 9:37,12,9000,43,62,105
9/21/2013 9:37,12,9000,36,62,98
9/21/2013 9:37,12,9000,41,62,103
9/21/2013 9:37,12,9000,36,64,100
9/21/2013 9:37,12,9000,37,68,105
9/21/2013 9:37,12,9000,39,65,104
9/21/2013 9:37,12,9000,37,59,96
9/21/2013 9:37,12,9000,41,65,106
9/21/2013 9:37,12,9000,38,61,99
9/21/2013 9:38,12,9000,1037,64,1101
9/21/2013 9:38,12,9000,1017,65,1082
9/21/2013 9:38,12,9000,39,60,99
9/21/2013 9:38,12,9000,41,64,105
9/21/2013 9:38,12,9000,42,60,102
9/21/2013 9:38,12,9000,40,63,103
9/21/2013 9:38,12,9000,39,63,102
9/21/2013 9:38,12,9000,1036,62,1098
9/21/2013 9:38,12,9000,38,59,97
9/21/2013 9:38,12,10000,46,64,110
9/21/2013 9:38,12,10000,38,65,103
9/21/2013 9:38,12,10000,41,59,100
9/21/2013 9:38,12,10000,40,61,101
9/21/2013 9:38,12,10000,38,60,98
9/21/2013 9:38,12,10000,38,63,101
9/21/2013 9:38,12,10000,38,63,101
9/21/2013 9:38,12,10000,42,63,105
9/21/2013 9:38,12,10000,40,66,106
9/21/2013 9:38,12,10000,38,63,101
9/21/2013 9:38,12,10000,47,64,111
9/21/2013 9:38,12,10000,39,60,99
9/21/2013 9:38,12,10000,39,59,98
9/21/2013 9:38,12,10000,36,69,105
9/21/2013 9:38,12,10000,1018,64,1082
9/21/2013 9:38,12,10000,40,61,101
9/21/2013 9:38,12,10000,38,59,97
9/21/2013 9:39,12,10000,38,60,98
9/21/2013 9:39,12,10000,1016,68,1084
9/21/2013 9:39,12,10000,37,62,99
9/21/2013 9:39,12,10000,40,63,103
9/21/2013 9:39,12,10000,49,64,113
9/21/2013 9:39,12,10000,40,65,105
9/21/2013 9:39,12,10000,1040,64,1104
9/21/2013 9:39,12,10000,38,61,99
9/21/2013 9:39,12,10000,37,62,99
9/21/2013 9:39,12,10000,37,60,97
9/21/2013 9:39,12,10000,44,65,109
9/21/2013 9:39,12,10000,38,64,102
9/21/2013 9:39,12,10000,40,59,99
9/21/2013 9:39,12,10000,40,62,102
9/21/2013 9:39,12,10000,1026,65,1091
9/21/2013 9:39,12,10000,47,60,107
9/21/2013 9:39,12,10000,1036,64,1100
9/21/2013 9:39,12,10000,41,61,102
9/21/2013 9:39,12,10000,1015,71,1086
9/21/2013 9:39,12,10000,40,62,102
9/21/2013 9:39,12,10000,37,64,101
9/21/2013 9:39,12,10000,40,62,102
9/21/2013 9:39,12,10000,1018,67,1085
9/21/2013 9:39,12,10000,38,64,102
9/21/2013 9:39,12,10000,38,61,99
9/21/2013 9:40,12,10000,39,62,101
9/21/2013 9:40,12,10000,43,64,107
9/21/2013 9:40,12,10000,40,60,100
9/21/2013 9:40,12,10000,44,63,107
9/21/2013 9:40,12,10000,41,64,105
9/21/2013 9:40,12,10000,37,67,104
9/21/2013 9:40,12,10000,43,62,105
9/21/2013 9:40,12,10000,38,61,99
9/21/2013 9:40,12,10000,39,60,99
9/21/2013 9:40,12,10000,37,65,102
9/21/2013 9:40,12,10000,39,60,99
9/21/2013 9:40,12,10000,40,63,103
9/21/2013 9:40,12,10000,44,63,107
9/21/2013 9:40,12,10000,38,64,102
9/21/2013 9:40,12,10000,41,64,105
9/21/2013 9:40,12,10000,38,60,98
9/21/2013 9:40,12,10000,38,62,100
9/21/2013 9:40,12,10000,40,62,102
9/21/2013 9:40,12,10000,39,63,102
9/21/2013 9:40,12,10000,38,60,98
9/21/2013 9:40,12,10000,40,62,102
9/21/2013 9:40,12,10000,38,62,100
9/21/2013 9:40,12,10000,37,61,98
9/21/2013 9:40,12,10000,39,61,100
9/21/2013 9:40,12,10000,45,64,109
9/21/2013 9:40,12,10000,1015,66,1081
9/21/2013 9:40,12,10000,45,63,108
9/21/2013 9:40,12,10000,37,68,105
9/21/2013 9:40,12,10000,43,64,107
9/21/2013 9:41,12,10000,48,60,108
9/21/2013 9:41,12,10000,40,65,105
9/21/2013 9:53,12,10000,38,63,101
9/21/2013 9:53,12,10000,49,62,111
9/21/2013 9:53,12,10000,38,63,101
9/21/2013 9:53,12,10000,43,63,106
9/21/2013 9:53,12,10000,45,62,107
9/21/2013 9:53,12,10000,41,62,103
9/21/2013 9:53,12,10000,37,63,100
9/21/2013 9:53,12,10000,39,60,99
9/21/2013 9:53,12,10000,38,63,101
9/21/2013 9:53,12,10000,1016,66,1082
9/21/2013 9:53,12,10000,39,59,98
9/21/2013 9:53,12,10000,1019,65,1084
9/21/2013 9:53,12,10000,39,60,99
9/21/2013 9:53,12,10000,38,62,100
9/21/2013 9:53,12,10000,46,71,117
9/21/2013 9:53,12,10000,40,63,103
9/21/2013 9:53,12,10000,39,61,100
9/21/2013 9:53,12,10000,40,64,104
9/21/2013 9:53,12,10000,38,59,97
9/21/2013 9:53,12,10000,43,62,105
9/21/2013 9:53,12,10000,42,63,105
9/21/2013 9:53,12,10000,39,62,101
9/21/2013 9:53,12,10000,1018,63,1081
9/21/2013 9:54,12,10000,37,66,103
9/21/2013 9:54,12,10000,38,62,100
9/21/2013 9:54,12,10000,45,62,107
9/21/2013 9:54,12,10000,39,59,98
9/21/2013 9:54,12,10000,38,59,97
9/21/2013 9:54,12,10000,1016,66,1082
9/21/2013 9:54,12,10000,38,60,98
9/21/2013 9:54,12,10000,37,60,97
9/21/2013 9:54,12,10000,42,66,108
9/21/2013 9:54,12,10000,41,62,103
9/21/2013 9:54,12,10000,39,59,98
9/21/2013 9:54,12,10000,42,61,103
9/21/2013 9:54,12,10000,39,61,100
9/21/2013 9:54,12,10000,36,61,97
9/21/2013 9:54,12,10000,38,62,100
9/21/2013 9:54,12,10000,1025,67,1092
9/21/2013 9:54,12,10000,37,63,100
9/21/2013 9:54,12,10000,37,60,97
9/21/2013 9:54,12,10000,40,63,103
9/21/2013 9:54,12,10000,1029,66,1095
9/21/2013 9:54,12,10000,1042,66,1108
9/21/2013 9:54,12,10000,37,59,96
9/21/2013 9:54,12,10000,1035,66,1101
9/21/2013 9:54,12,10000,39,62,101
9/21/2013 9:54,12,10000,43,62,105
9/21/2013 9:54,12,10000,38,61,99
9/21/2013 9:55,12,10000,41,66,107
9/21/2013 9:55,12,10000,1021,66,1087
9/21/2013 9:55,12,10000,36,62,98
9/21/2013 9:55,12,10000,1019,62,1081
9/21/2013 9:55,12,10000,41,62,103
9/21/2013 9:55,12,10000,39,61,100
9/21/2013 9:55,12,10000,1026,65,1091
9/21/2013 9:55,12,10000,37,61,98
9/21/2013 9:55,12,10000,39,65,104
9/21/2013 9:55,12,10000,40,64,104
9/21/2013 9:55,12,10000,1015,63,1078
9/21/2013 9:55,12,10000,1017,68,1085
9/21/2013 9:55,12,10000,37,62,99
9/21/2013 9:55,12,10000,39,66,105
9/21/2013 9:55,12,10000,35,62,97
9/21/2013 9:55,12,10000,38,60,98
9/21/2013 9:55,12,10000,46,66,112
9/21/2013 9:55,12,10000,42,63,105
9/21/2013 9:55,12,10000,38,59,97
9/21/2013 9:55,12,10000,38,61,99
9/21/2013 9:55,12,10000,40,64,104
9/21/2013 9:55,12,10000,47,62,109
9/21/2013 9:55,12,10000,36,61,97
9/21/2013 9:55,12,10000,36,66,102
9/21/2013 9:56,12,10000,44,63,107
9/21/2013 9:56,12,10000,39,66,105
9/21/2013 9:56,12,10000,41,64,105
9/21/2013 9:56,12,10000,45,68,113
9/21/2013 9:56,12,10000,43,64,107
9/21/2013 9:56,12,10000,42,64,106
9/21/2013 9:56,12,10000,36,59,95
9/21/2013 9:56,12,10000,37,66,103
9/21/2013 9:56,12,10000,44,64,108
9/21/2013 9:56,12,10000,34,60,94
9/21/2013 9:56,12,10000,44,61,105
9/21/2013 9:56,12,10000,1020,65,1085
9/21/2013 9:56,12,10000,40,68,108
9/21/2013 9:56,12,10000,45,63,108
9/21/2013 9:56,12,10000,1016,64,1080
9/21/2013 9:56,12,10000,41,63,104
9/21/2013 9:56,12,10000,38,60,98
9/21/2013 9:56,12,10000,40,63,103
9/21/2013 9:56,12,10000,40,62,102
9/21/2013 9:56,12,10000,36,62,98
9/21/2013 9:56,12,10000,38,60,98
9/21/2013 9:56,12,10000,41,64,105
9/21/2013 9:56,12,10000,36,60,96
9/21/2013 9:56,12,10000,45,62,107
9/21/2013 9:56,12,10000,1014,65,1079
9/21/2013 9:56,12,10000,1016,67,1083
9/21/2013 9:57,12,10000,37,61,98
9/21/2013 9:57,12,10000,38,61,99
9/21/2013 9:57,12,10000,41,62,103
9/21/2013 9:57,12,10000,40,63,103
9/21/2013 9:57,12,10000,38,60,98
9/21/2013 9:57,12,10000,38,60,98
9/21/2013 9:57,12,10000,40,61,101
9/21/2013 9:57,12,10000,39,61,100
9/21/2013 9:57,12,10000,39,64,103
9/21/2013 9:57,12,10000,39,62,101
9/21/2013 9:57,12,10000,39,64,103
9/21/2013 9:57,12,10000,40,62,102
9/21/2013 9:57,12,10000,43,64,107
9/21/2013 9:57,12,10000,1020,66,1086
9/21/2013 9:57,12,10000,39,62,101
9/21/2013 9:57,12,10000,1030,70,1100
9/21/2013 9:57,12,10000,37,66,103
9/21/2013 9:57,12,10000,1018,64,1082
9/21/2013 9:57,12,10000,40,62,102
9/21/2013 9:57,12,10000,1039,71,1110
9/21/2013 9:57,12,10000,1023,70,1093
9/21/2013 9:57,12,10000,1037,63,1100
9/21/2013 9:57,12,10000,1032,63,1095
9/21/2013 9:58,12,10000,1030,64,1094
9/21/2013 9:58,12,10000,45,61,106
9/21/2013 9:58,12,10000,1039,65,1104
9/21/2013 9:58,12,10000,1019,68,1087
9/21/2013 9:58,12,10000,39,63,102
9/21/2013 9:58,12,10000,1024,71,1095
9/21/2013 9:58,12,10000,42,62,104
9/21/2013 9:58,12,10000,1021,65,1086
9/21/2013 9:58,12,10000,42,68,110
9/21/2013 9:58,12,10000,40,59,99
9/21/2013 9:58,12,10000,39,61,100
9/21/2013 9:58,12,10000,35,65,100
9/21/2013 9:58,12,10000,38,59,97
9/21/2013 9:58,12,10000,37,61,98
9/21/2013 9:58,12,10000,40,65,105
9/21/2013 9:58,12,10000,39,62,101
9/21/2013 9:58,12,10000,40,67,107
9/21/2013 9:58,12,10000,41,73,114
9/21/2013 9:58,12,10000,39,62,101
9/21/2013 9:58,12,10000,36,64,100
9/21/2013 9:58,12,10000,44,62,106
9/21/2013 9:58,12,10000,39,62,101
9/21/2013 9:58,12,10000,1029,63,1092
9/21/2013 9:58,12,10000,36,62,98
9/21/2013 9:58,12,10000,38,64,102
9/21/2013 9:59,12,10000,1020,64,1084
9/21/2013 9:59,12,10000,39,61,100
9/21/2013 9:59,12,10000,46,64,110
9/21/2013 9:59,12,10000,38,61,99
9/21/2013 9:59,12,10000,37,63,100
9/21/2013 9:59,12,10000,36,64,100
9/21/2013 9:59,12,10000,38,62,100
9/21/2013 9:59,12,10000,40,60,100
9/21/2013 9:59,12,10000,42,63,105
9/21/2013 9:59,12,20000,54,75,129
9/21/2013 9:59,12,20000,42,70,112
9/21/2013 9:59,12,20000,51,68,119
9/21/2013 9:59,12,20000,1042,71,1113
9/21/2013 9:59,12,20000,45,70,115
9/21/2013 9:59,12,20000,49,76,125
9/21/2013 9:59,12,20000,51,71,122
9/21/2013 9:59,12,20000,51,69,120
9/21/2013 9:59,12,20000,45,78,123
9/21/2013 9:59,12,20000,48,69,117
9/21/2013 9:59,12,20000,54,71,125
9/21/2013 9:59,12,20000,46,72,118
9/21/2013 9:59,12,20000,46,68,114
9/21/2013 9:59,12,20000,46,70,116
9/21/2013 9:59,12,20000,46,74,120
9/21/2013 9:59,12,20000,47,70,117
9/21/2013 9:59,12,20000,1041,76,1117
9/21/2013 10:00,12,20000,1021,74,1095
9/21/2013 10:00,12,20000,53,73,126
9/21/2013 10:00,12,20000,48,68,116
9/21/2013 10:00,12,20000,45,67,112
9/21/2013 10:00,12,20000,1022,69,1091
9/21/2013 10:00,12,20000,43,70,113
9/21/2013 10:00,12,20000,46,67,113
9/21/2013 10:00,12,20000,49,68,117
9/21/2013 10:00,12,20000,45,69,114
9/21/2013 10:00,12,20000,58,72,130
9/21/2013 10:00,12,20000,52,74,126
9/21/2013 10:00,12,20000,53,67,120
9/21/2013 10:00,12,20000,1036,71,1107
9/21/2013 10:00,12,20000,55,71,126
9/21/2013 10:00,12,20000,47,66,113
9/21/2013 10:00,12,20000,48,71,119
9/21/2013 10:00,12,20000,45,68,113
9/21/2013 10:00,12,20000,40,68,108
9/21/2013 10:00,12,20000,47,68,115
9/21/2013 10:00,12,20000,43,68,111
9/21/2013 10:00,12,20000,1026,69,1095
9/21/2013 10:00,12,20000,1023,70,1093
9/21/2013 10:00,12,20000,51,77,128
9/21/2013 10:00,12,20000,45,68,113
9/21/2013 10:00,12,20000,44,70,114
9/21/2013 10:00,12,20000,47,72,119
9/21/2013 10:01,12,20000,1043,74,1117
9/21/2013 10:01,12,20000,1037,73,1110
9/21/2013 10:01,12,20000,1040,72,1112
9/21/2013 10:01,12,20000,58,73,131
9/21/2013 10:01,12,20000,45,70,115
9/21/2013 10:01,12,20000,57,75,132
9/21/2013 10:01,12,20000,50,73,123
9/21/2013 10:01,12,20000,45,70,115
9/21/2013 10:01,12,20000,46,72,118
9/21/2013 10:01,12,20000,44,70,114
9/21/2013 10:01,12,20000,46,70,116
9/21/2013 10:01,12,20000,51,70,121
9/21/2013 10:01,12,20000,1025,74,1099
9/21/2013 10:01,12,20000,42,69,111
9/21/2013 10:01,12,20000,42,69,111
9/21/2013 10:01,12,20000,50,73,123
9/21/2013 10:01,12,20000,46,69,115
9/21/2013 10:01,12,20000,48,74,122
9/21/2013 10:01,12,20000,44,70,114
9/21/2013 10:01,12,20000,47,67,114
9/21/2013 10:01,12,20000,42,70,112
9/21/2013 10:01,12,20000,52,69,121
9/21/2013 10:01,12,20000,50,72,122
9/21/2013 10:01,12,20000,49,71,120
9/21/2013 10:01,12,20000,51,72,123
9/21/2013 10:01,12,20000,49,71,120
9/21/2013 10:01,12,20000,45,70,115
9/21/2013 10:02,12,20000,1033,78,1111
9/21/2013 10:02,12,20000,47,72,119
9/21/2013 10:02,12,20000,39,69,108
9/21/2013 10:02,12,20000,48,70,118
9/21/2013 10:02,12,20000,1022,71,1093
9/21/2013 10:02,12,20000,41,68,109
9/21/2013 10:02,12,20000,43,71,114
9/21/2013 10:02,12,20000,53,74,127
9/21/2013 10:02,12,20000,45,68,113
9/21/2013 10:02,12,20000,47,73,120
9/21/2013 10:02,12,20000,48,75,123
9/21/2013 10:02,12,20000,1036,73,1109
9/21/2013 10:02,12,20000,47,68,115
9/21/2013 10:02,12,20000,48,68,116
9/21/2013 10:02,12,20000,48,73,121
9/21/2013 10:02,12,20000,50,72,122
9/21/2013 10:02,12,20000,52,72,124
9/21/2013 10:02,12,20000,47,71,118
9/21/2013 10:02,12,20000,50,76,126
9/21/2013 10:02,12,20000,50,73,123
9/21/2013 10:02,12,20000,44,72,116
9/21/2013 10:02,12,20000,1034,72,1106
9/21/2013 10:02,12,20000,42,69,111
9/21/2013 10:02,12,20000,49,70,119
9/21/2013 10:03,12,20000,47,76,123
9/21/2013 10:03,12,20000,1032,75,1107
9/21/2013 10:03,12,20000,43,70,113
9/21/2013 10:03,12,20000,46,70,116
9/21/2013 10:03,12,20000,50,73,123
9/21/2013 10:03,12,20000,47,71,118
9/21/2013 10:03,12,20000,49,73,122
9/21/2013 10:03,12,20000,48,66,114
9/21/2013 10:03,12,20000,47,71,118
9/21/2013 10:03,12,20000,48,71,119
9/21/2013 10:03,12,20000,60,70,130
9/21/2013 10:03,12,20000,46,71,117
9/21/2013 10:03,12,20000,45,68,113
9/21/2013 10:03,12,20000,42,66,108
9/21/2013 10:03,12,20000,42,69,111
9/21/2013 10:03,12,20000,43,75,118
9/21/2013 10:03,12,20000,46,72,118
9/21/2013 10:03,12,20000,47,68,115
9/21/2013 10:03,12,20000,48,67,115
9/21/2013 10:03,12,20000,1033,77,1110
9/21/2013 10:03,12,20000,50,66,116
9/21/2013 10:03,12,30000,49,71,120
9/21/2013 10:03,12,30000,1037,75,1112
9/21/2013 10:03,12,30000,56,74,130
9/21/2013 10:03,12,30000,52,72,124
9/21/2013 10:04,12,30000,49,77,126
9/21/2013 10:04,12,30000,57,77,134
9/21/2013 10:04,12,30000,49,68,117
9/21/2013 10:04,12,30000,47,73,120
9/21/2013 10:04,12,30000,54,72,126
9/21/2013 10:04,12,30000,49,72,121
9/21/2013 10:04,12,30000,49,76,125
9/21/2013 10:04,12,30000,54,74,128
9/21/2013 10:04,12,30000,50,75,125
9/21/2013 10:04,12,30000,48,73,121
9/21/2013 10:04,12,30000,60,76,136
9/21/2013 10:04,12,30000,49,74,123
9/21/2013 10:04,12,30000,48,72,120
9/21/2013 10:04,12,30000,67,74,141
9/21/2013 10:04,12,30000,50,72,122
9/21/2013 10:04,12,30000,48,73,121
9/21/2013 10:04,12,30000,1032,77,1109
9/21/2013 10:04,12,30000,52,69,121
9/21/2013 10:04,12,30000,50,71,121
9/21/2013 10:04,12,30000,47,70,117
9/21/2013 10:04,12,30000,61,76,137
9/21/2013 10:04,12,30000,1036,73,1109
9/21/2013 10:04,12,30000,66,79,145
9/21/2013 10:04,12,30000,51,74,125
9/21/2013 10:04,12,30000,66,75,141
9/21/2013 10:04,12,30000,54,68,122
9/21/2013 10:05,12,30000,1027,72,1099
9/21/2013 10:05,12,30000,52,76,128
9/21/2013 10:05,12,30000,47,74,121
9/21/2013 10:05,12,30000,1034,77,1111
9/21/2013 10:05,12,30000,47,75,122
9/21/2013 10:05,12,30000,55,75,130
9/21/2013 10:05,12,30000,49,73,122
9/21/2013 10:05,12,30000,54,74,128
9/21/2013 10:05,12,30000,54,74,128
9/21/2013 10:05,12,30000,63,67,130
9/21/2013 10:05,12,30000,45,73,118
9/21/2013 10:05,12,30000,48,74,122
9/21/2013 10:05,12,30000,51,76,127
9/21/2013 10:05,12,30000,50,73,123
9/21/2013 10:05,12,30000,47,71,118
9/21/2013 10:05,12,30000,50,72,122
9/21/2013 10:05,12,30000,47,72,119
9/21/2013 10:05,12,30000,52,75,127
9/21/2013 10:05,12,30000,51,73,124
9/21/2013 10:05,12,30000,51,75,126
9/21/2013 10:05,12,30000,48,73,121
9/21/2013 10:05,12,30000,62,73,135
9/21/2013 10:05,12,30000,50,72,122
9/21/2013 10:05,12,30000,50,68,118
9/21/2013 10:05,12,30000,1039,76,1115
9/21/2013 10:05,12,30000,49,70,119
9/21/2013 10:05,12,30000,50,71,121
9/21/2013 10:06,12,30000,1030,76,1106
9/21/2013 10:06,12,30000,50,77,127
9/21/2013 10:06,12,30000,51,74,125
9/21/2013 10:06,12,30000,52,72,124
9/21/2013 10:06,12,30000,1035,77,1112
9/21/2013 10:06,12,30000,1041,82,1123
9/21/2013 10:06,12,30000,52,73,125
9/21/2013 10:06,12,30000,50,77,127
9/21/2013 10:06,12,30000,1033,77,1110
9/21/2013 10:06,12,30000,1030,78,1108
9/21/2013 10:06,12,30000,57,79,136
9/21/2013 10:06,12,30000,1026,74,1100
9/21/2013 10:06,12,30000,45,71,116
9/21/2013 10:06,12,30000,1032,76,1108
9/21/2013 10:06,12,30000,51,73,124
9/21/2013 10:06,12,30000,1029,79,1108
9/21/2013 10:06,12,30000,47,70,117
9/21/2013 10:06,12,30000,52,72,124
9/21/2013 10:06,12,30000,1044,71,1115
9/21/2013 10:06,12,30000,48,78,126
9/21/2013 10:06,12,30000,52,73,125
9/21/2013 10:07,12,30000,52,73,125
9/21/2013 10:07,12,30000,57,78,135
9/21/2013 10:07,12,30000,55,71,126
9/21/2013 10:07,12,30000,1034,75,1109
9/21/2013 10:07,12,30000,62,74,136
9/21/2013 10:07,12,30000,47,74,121
9/21/2013 10:07,12,30000,55,72,127
9/21/2013 10:07,12,30000,50,74,124
9/21/2013 10:07,12,30000,1069,80,1149
9/21/2013 10:24,12,30000,58,74,132
9/21/2013 10:24,12,30000,1038,76,1114
9/21/2013 10:24,12,30000,56,80,136
9/21/2013 10:24,12,30000,1029,72,1101
9/21/2013 10:24,12,30000,49,73,122
9/21/2013 10:24,12,30000,1035,79,1114
9/21/2013 10:24,12,30000,54,72,126
9/21/2013 10:24,12,30000,50,71,121
9/21/2013 10:24,12,30000,51,73,124
9/21/2013 10:24,12,30000,50,71,121
9/21/2013 10:24,12,30000,51,70,121
9/21/2013 10:24,12,30000,51,74,125
9/21/2013 10:24,12,30000,65,66,131
9/21/2013 10:24,12,30000,52,79,131
9/21/2013 10:24,12,30000,49,78,127
9/21/2013 10:24,12,30000,50,76,126
9/21/2013 10:24,12,30000,63,81,144
9/21/2013 10:24,12,30000,46,73,119
9/21/2013 10:24,12,30000,68,74,142
9/21/2013 10:24,12,30000,50,75,125
9/21/2013 10:24,12,30000,50,73,123
9/21/2013 10:24,12,30000,54,74,128
9/21/2013 10:24,12,30000,51,74,125
9/21/2013 10:24,12,30000,53,76,129
9/21/2013 10:24,12,30000,54,66,120
9/21/2013 10:24,12,30000,64,75,139
9/21/2013 10:25,12,30000,59,73,132
9/21/2013 10:25,12,40000,1031,69,1100
9/21/2013 10:25,12,40000,59,68,127
9/21/2013 10:25,12,40000,1030,69,1099
9/21/2013 10:25,12,40000,59,74,133
9/21/2013 10:25,12,40000,1037,71,1108
9/21/2013 10:25,12,40000,64,67,131
9/21/2013 10:25,12,40000,1032,70,1102
9/21/2013 10:25,12,40000,60,66,126
9/21/2013 10:25,12,40000,54,66,120
9/21/2013 10:25,12,40000,1034,72,1106
9/21/2013 10:25,12,40000,57,72,129
9/21/2013 10:25,12,40000,57,66,123
9/21/2013 10:25,12,40000,62,73,135
9/21/2013 10:25,12,40000,56,75,131
9/21/2013 10:25,12,40000,54,71,125
9/21/2013 10:25,12,40000,56,68,124
9/21/2013 10:25,12,40000,66,73,139
9/21/2013 10:25,12,40000,57,67,124
9/21/2013 10:25,12,40000,55,73,128
9/21/2013 10:25,12,40000,1032,68,1100
9/21/2013 10:25,12,40000,60,71,131
9/21/2013 10:25,12,40000,1035,71,1106
9/21/2013 10:25,12,40000,65,71,136
9/21/2013 10:25,12,40000,1040,69,1109
9/21/2013 10:26,12,40000,64,66,130
9/21/2013 10:26,12,40000,1047,72,1119
9/21/2013 10:26,12,40000,64,69,133
9/21/2013 10:26,12,40000,66,68,134
9/21/2013 10:26,12,40000,56,69,125
9/21/2013 10:26,12,40000,57,79,136
9/21/2013 10:26,12,40000,54,68,122
9/21/2013 10:26,12,40000,58,68,126
9/21/2013 10:26,12,40000,52,70,122
9/21/2013 10:26,12,40000,1037,72,1109
9/21/2013 10:26,12,40000,63,66,129
9/21/2013 10:26,12,40000,60,71,131
9/21/2013 10:26,12,40000,59,70,129
9/21/2013 10:26,12,40000,60,71,131
9/21/2013 10:26,12,40000,61,67,128
9/21/2013 10:26,12,40000,59,66,125
9/21/2013 10:26,12,40000,56,69,125
9/21/2013 10:26,12,40000,66,67,133
9/21/2013 10:26,12,40000,56,66,122
9/21/2013 10:26,12,40000,53,97,150
9/21/2013 10:26,12,40000,63,71,134
9/21/2013 10:26,12,40000,64,71,135
9/21/2013 10:26,12,40000,56,68,124
9/21/2013 10:26,12,40000,56,68,124
9/21/2013 10:26,12,40000,1043,72,1115
9/21/2013 10:26,12,40000,59,69,128
9/21/2013 10:27,12,40000,1048,71,1119
9/21/2013 10:27,12,40000,74,71,145
9/21/2013 10:27,12,40000,59,72,131
9/21/2013 10:27,12,40000,56,69,125
9/21/2013 10:27,12,40000,58,67,125
9/21/2013 10:27,12,40000,67,75,142
9/21/2013 10:27,12,40000,62,68,130
9/21/2013 10:27,12,40000,65,71,136
9/21/2013 10:27,12,40000,58,67,125
9/21/2013 10:27,12,40000,62,69,131
9/21/2013 10:27,12,40000,58,69,127
9/21/2013 10:27,12,40000,58,72,130
9/21/2013 10:27,12,40000,57,76,133
9/21/2013 10:27,12,40000,58,70,128
9/21/2013 10:27,12,40000,54,71,125
9/21/2013 10:27,12,40000,61,72,133
9/21/2013 10:27,12,40000,55,69,124
9/21/2013 10:27,12,40000,69,68,137
9/21/2013 10:27,12,40000,54,66,120
9/21/2013 10:27,12,40000,63,70,133
9/21/2013 10:27,12,40000,61,75,136
9/21/2013 10:27,12,40000,58,72,130
9/21/2013 10:27,12,40000,60,72,132
9/21/2013 10:27,12,40000,59,69,128
9/21/2013 10:27,12,40000,58,71,129
9/21/2013 10:27,12,40000,60,67,127
9/21/2013 10:27,12,40000,60,67,127
9/21/2013 10:28,12,40000,56,65,121
9/21/2013 10:28,12,40000,63,73,136
9/21/2013 10:28,12,40000,63,66,129
9/21/2013 10:28,12,40000,57,71,128
9/21/2013 10:28,12,40000,58,68,126
9/21/2013 10:28,12,40000,57,70,127
9/21/2013 10:28,12,40000,61,72,133
9/21/2013 10:28,12,40000,1032,77,1109
9/21/2013 10:28,12,40000,62,70,132
9/21/2013 10:28,12,40000,69,69,138
9/21/2013 10:28,12,40000,54,69,123
9/21/2013 10:28,12,40000,67,69,136
9/21/2013 10:28,12,40000,1040,70,1110
9/21/2013 10:28,12,40000,57,71,128
9/21/2013 10:28,12,40000,59,72,131
9/21/2013 10:28,12,40000,56,70,126
9/21/2013 10:28,12,40000,61,74,135
9/21/2013 10:28,12,40000,63,70,133
9/21/2013 10:28,12,40000,65,69,134
9/21/2013 10:28,12,40000,57,69,126
9/21/2013 10:28,12,40000,62,70,132
9/21/2013 10:28,12,40000,59,69,128
9/21/2013 10:28,12,40000,60,72,132
9/21/2013 10:28,12,40000,56,67,123
9/21/2013 10:28,12,40000,59,68,127
9/21/2013 10:28,12,40000,61,75,136
9/21/2013 10:29,12,40000,1037,72,1109
9/21/2013 10:29,12,40000,57,69,126
9/21/2013 10:29,12,40000,56,78,134
9/21/2013 10:29,12,40000,56,74,130
9/21/2013 10:29,12,40000,66,66,132
9/21/2013 10:29,12,40000,60,68,128
9/21/2013 10:29,12,40000,52,69,121
9/21/2013 10:29,12,40000,55,69,124
9/21/2013 10:29,12,40000,61,68,129
9/21/2013 10:29,12,40000,54,71,125
9/21/2013 10:29,12,40000,62,69,131
9/21/2013 10:29,12,40000,58,69,127
9/21/2013 10:29,12,50000,58,75,133
9/21/2013 10:29,12,50000,1064,72,1136
9/21/2013 10:29,12,50000,57,74,131
9/21/2013 10:29,12,50000,60,72,132
9/21/2013 10:29,12,50000,55,70,125
9/21/2013 10:29,12,50000,59,78,137
9/21/2013 10:29,12,50000,62,79,141
9/21/2013 10:29,12,50000,67,76,143
9/21/2013 10:29,12,50000,67,73,140
9/21/2013 10:29,12,50000,59,69,128
9/21/2013 10:29,12,50000,60,74,134
9/21/2013 10:29,12,50000,68,70,138
9/21/2013 10:29,12,50000,57,71,128
9/21/2013 10:29,12,50000,64,72,136
9/21/2013 10:29,12,50000,1059,71,1130
9/21/2013 10:29,12,50000,1043,72,1115
9/21/2013 10:30,12,50000,1049,76,1125
9/21/2013 10:30,12,50000,56,73,129
9/21/2013 10:30,12,50000,56,75,131
9/21/2013 10:30,12,50000,60,71,131
9/21/2013 10:30,12,50000,59,69,128
9/21/2013 10:30,12,50000,57,73,130
9/21/2013 10:30,12,50000,1033,75,1108
9/21/2013 10:30,12,50000,1043,74,1117
9/21/2013 10:30,12,50000,1045,77,1122
9/21/2013 10:30,12,50000,65,72,137
9/21/2013 10:30,12,50000,58,72,130
9/21/2013 10:30,12,50000,55,70,125
9/21/2013 10:30,12,50000,62,70,132
9/21/2013 10:30,12,50000,59,70,129
9/21/2013 10:30,12,50000,62,71,133
9/21/2013 10:30,12,50000,64,69,133
9/21/2013 10:30,12,50000,62,78,140
9/21/2013 10:30,12,50000,59,76,135
9/21/2013 10:30,12,50000,59,72,131
9/21/2013 10:30,12,50000,70,71,141
9/21/2013 10:30,12,50000,58,69,127
9/21/2013 10:30,12,50000,65,78,143
9/21/2013 10:30,12,50000,55,71,126
9/21/2013 10:30,12,50000,62,75,137
9/21/2013 10:30,12,50000,69,71,140
9/21/2013 10:31,12,50000,69,70,139
9/21/2013 10:31,12,50000,62,68,130
9/21/2013 10:31,12,50000,64,76,140
9/21/2013 10:31,12,50000,67,82,149
9/21/2013 10:31,12,50000,69,72,141
9/21/2013 10:31,12,50000,58,72,130
9/21/2013 10:31,12,50000,58,70,128
9/21/2013 10:31,12,50000,65,74,139
9/21/2013 10:31,12,50000,61,76,137
9/21/2013 10:31,12,50000,57,69,126
9/21/2013 10:31,12,50000,59,70,129
9/21/2013 10:31,12,50000,59,73,132
9/21/2013 10:31,12,50000,61,76,137
9/21/2013 10:31,12,50000,59,90,149
9/21/2013 10:31,12,50000,63,76,139
9/21/2013 10:31,12,50000,57,72,129
9/21/2013 10:31,12,50000,58,78,136
9/21/2013 10:31,12,50000,1058,75,1133
9/21/2013 10:31,12,50000,1046,74,1120
9/21/2013 10:31,12,50000,58,69,127
9/21/2013 10:31,12,50000,59,77,136
9/21/2013 10:31,12,50000,1065,71,1136
9/21/2013 10:31,12,50000,1051,74,1125
9/21/2013 10:31,12,50000,67,71,138
9/21/2013 10:31,12,50000,82,77,159
9/21/2013 10:32,12,50000,64,73,137
9/21/2013 10:32,12,50000,59,78,137
9/21/2013 10:32,12,50000,59,76,135
9/21/2013 10:32,12,50000,63,78,141
9/21/2013 10:32,12,50000,64,71,135
9/21/2013 10:32,12,50000,1034,74,1108
9/21/2013 10:32,12,50000,62,71,133
9/21/2013 10:32,12,50000,67,76,143
9/21/2013 10:32,12,50000,61,74,135
9/21/2013 10:32,12,50000,77,68,145
9/21/2013 10:32,12,50000,61,71,132
9/21/2013 10:32,12,50000,61,73,134
9/21/2013 10:32,12,50000,1036,75,1111
9/21/2013 10:32,12,50000,67,74,141
9/21/2013 10:32,12,50000,61,73,134
9/21/2013 10:32,12,50000,66,71,137
9/21/2013 10:32,12,50000,58,70,128
9/21/2013 10:32,12,50000,76,70,146
9/21/2013 10:32,12,50000,58,68,126
9/21/2013 10:32,12,50000,60,70,130
9/21/2013 10:32,12,50000,56,72,128
9/21/2013 10:33,12,50000,13485,76,13561
9/21/2013 10:33,12,50000,56,73,129
9/21/2013 10:33,12,50000,1044,76,1120
9/21/2013 10:33,12,50000,1060,74,1134
9/21/2013 10:33,12,50000,55,72,127
9/21/2013 10:33,12,50000,66,73,139
9/21/2013 10:33,12,50000,1052,78,1130
9/21/2013 10:33,12,50000,1045,78,1123
9/21/2013 10:33,12,50000,1037,77,1114
9/21/2013 10:33,12,50000,62,91,153
9/21/2013 10:33,12,50000,67,72,139
9/21/2013 10:33,12,50000,1053,71,1124
9/21/2013 10:33,12,50000,59,76,135
9/21/2013 10:33,12,50000,63,73,136
9/21/2013 10:33,12,50000,56,72,128
9/21/2013 10:33,12,50000,1037,73,1110
9/21/2013 10:33,12,50000,56,75,131
9/21/2013 10:33,12,50000,57,74,131
9/21/2013 10:33,12,50000,1037,78,1115
9/21/2013 10:34,12,50000,67,70,137
9/21/2013 10:34,12,50000,1035,71,1106
9/21/2013 10:34,12,50000,56,75,131
9/21/2013 10:34,12,50000,70,71,141
9/21/2013 10:34,12,50000,1051,77,1128
9/21/2013 10:34,12,50000,5647,75,5722
9/21/2013 10:34,12,50000,1055,76,1131
9/21/2013 10:34,12,50000,1033,77,1110
9/21/2013 10:34,12,50000,64,70,134
9/21/2013 10:34,12,60000,63,74,137
9/21/2013 10:34,12,60000,1036,77,1113
9/21/2013 10:34,12,60000,1058,79,1137
9/21/2013 10:34,12,60000,60,86,146
9/21/2013 10:34,12,60000,62,76,138
9/21/2013 10:34,12,60000,64,75,139
9/21/2013 10:34,12,60000,61,74,135
9/21/2013 10:34,12,60000,67,74,141
9/21/2013 10:34,12,60000,63,73,136
9/21/2013 10:34,12,60000,62,77,139
9/21/2013 10:35,12,60000,1032,77,1109
9/21/2013 10:35,12,60000,73,80,153
9/21/2013 10:35,12,60000,63,74,137
9/21/2013 10:35,12,60000,59,71,130
9/21/2013 10:35,12,60000,64,72,136
9/21/2013 10:35,12,60000,61,74,135
9/21/2013 10:35,12,60000,64,71,135
9/21/2013 10:35,12,60000,64,74,138
9/21/2013 10:35,12,60000,1036,84,1120
9/21/2013 10:35,12,60000,57,78,135
9/21/2013 10:35,12,60000,74,76,150
9/21/2013 10:35,12,60000,1040,76,1116
9/21/2013 10:35,12,60000,70,73,143
9/21/2013 10:35,12,60000,61,78,139
9/21/2013 10:35,12,60000,69,76,145
9/21/2013 10:35,12,60000,67,75,142
9/21/2013 10:35,12,60000,69,76,145
9/21/2013 10:35,12,60000,1032,76,1108
9/21/2013 10:35,12,60000,64,74,138
9/21/2013 10:35,12,60000,58,74,132
9/21/2013 10:35,12,60000,72,78,150
9/21/2013 10:35,12,60000,1034,80,1114
9/21/2013 10:35,12,60000,59,73,132
9/21/2013 10:35,12,60000,65,77,142
9/21/2013 10:36,12,60000,62,73,135
9/21/2013 10:36,12,60000,65,72,137
9/21/2013 10:36,12,60000,1043,81,1124
9/21/2013 10:36,12,60000,72,84,156
9/21/2013 10:36,12,60000,61,72,133
9/21/2013 10:36,12,60000,61,72,133
9/21/2013 10:36,12,60000,66,80,146
9/21/2013 10:36,12,60000,62,73,135
9/21/2013 10:36,12,60000,63,76,139
9/21/2013 10:36,12,60000,68,83,151
9/21/2013 10:36,12,60000,74,73,147
9/21/2013 10:36,12,60000,63,73,136
9/21/2013 10:36,12,60000,60,75,135
9/21/2013 10:36,12,60000,61,73,134
9/21/2013 10:36,12,60000,1062,74,1136
9/21/2013 10:36,12,60000,64,73,137
9/21/2013 10:36,12,60000,68,72,140
9/21/2013 10:36,12,60000,66,78,144
9/21/2013 10:36,12,60000,58,78,136
9/21/2013 10:36,12,60000,63,72,135
9/21/2013 10:36,12,60000,61,83,144
9/21/2013 10:36,12,60000,1038,78,1116
9/21/2013 10:36,12,60000,70,75,145
9/21/2013 10:36,12,60000,71,82,153
9/21/2013 10:36,12,60000,74,79,153
9/21/2013 10:36,12,60000,52,76,128
9/21/2013 10:37,12,60000,1047,75,1122
9/21/2013 10:37,12,60000,69,74,143
9/21/2013 10:37,12,60000,63,71,134
9/21/2013 10:37,12,60000,59,76,135
9/21/2013 10:37,12,60000,1052,74,1126
9/21/2013 10:37,12,60000,65,75,140
9/21/2013 10:37,12,60000,68,74,142
9/21/2013 10:37,12,60000,1064,75,1139
9/21/2013 10:37,12,60000,61,73,134
9/21/2013 10:37,12,60000,60,83,143
9/21/2013 10:37,12,60000,70,81,151
9/21/2013 10:37,12,60000,72,72,144
9/21/2013 10:37,12,60000,64,71,135
9/21/2013 10:37,12,60000,63,75,138
9/21/2013 10:37,12,60000,64,80,144
9/21/2013 10:37,12,60000,1900,73,1973
9/21/2013 10:37,12,60000,60,71,131
9/21/2013 10:37,12,60000,57,75,132
9/21/2013 10:37,12,60000,66,73,139
9/21/2013 10:37,12,60000,1048,75,1123
9/21/2013 10:37,12,60000,60,81,141
9/21/2013 10:37,12,60000,70,78,148
9/21/2013 10:37,12,60000,63,79,142
9/21/2013 10:37,12,60000,61,76,137
9/21/2013 10:37,12,60000,1046,78,1124
9/21/2013 10:38,12,60000,647,80,727
9/21/2013 10:38,12,60000,77,79,156
9/21/2013 10:38,12,60000,69,74,143
9/21/2013 10:38,12,60000,58,73,131
9/21/2013 10:38,12,60000,72,74,146
9/21/2013 10:38,12,60000,60,81,141
9/21/2013 10:38,12,60000,1043,78,1121
9/21/2013 10:38,12,60000,65,78,143
9/21/2013 10:38,12,60000,61,74,135
9/21/2013 10:38,12,60000,59,79,138
9/21/2013 10:38,12,60000,62,79,141
9/21/2013 10:38,12,60000,66,79,145
9/21/2013 10:38,12,60000,74,93,167
9/21/2013 10:55,12,60000,70,76,146
9/21/2013 10:55,12,60000,55,74,129
9/21/2013 10:55,12,60000,71,73,144
9/21/2013 10:55,12,60000,1043,76,1119
9/21/2013 10:55,12,60000,64,71,135
9/21/2013 10:55,12,60000,67,79,146
9/21/2013 10:55,12,60000,1050,79,1129
9/21/2013 10:55,12,60000,61,79,140
9/21/2013 10:55,12,60000,61,82,143
9/21/2013 10:55,12,60000,68,78,146
9/21/2013 10:55,12,60000,64,74,138
9/21/2013 10:55,12,60000,60,76,136
9/21/2013 10:55,12,60000,56,72,128
9/21/2013 10:55,12,60000,68,84,152
9/21/2013 10:55,12,60000,1067,78,1145
9/21/2013 10:55,12,60000,66,71,137
9/21/2013 10:55,12,70000,69,85,154
9/21/2013 10:55,12,70000,1057,80,1137
9/21/2013 10:55,12,70000,71,77,148
9/21/2013 10:55,12,70000,67,75,142
9/21/2013 10:56,12,70000,64,83,147
9/21/2013 10:56,12,70000,64,81,145
9/21/2013 10:56,12,70000,66,76,142
9/21/2013 10:56,12,70000,1037,83,1120
9/21/2013 10:56,12,70000,60,78,138
9/21/2013 10:56,12,70000,70,80,150
9/21/2013 10:56,12,70000,1040,80,1120
9/21/2013 10:56,12,70000,69,77,146
9/21/2013 10:56,12,70000,1062,86,1148
9/21/2013 10:56,12,70000,62,76,138
9/21/2013 10:56,12,70000,68,78,146
9/21/2013 10:56,12,70000,1053,83,1136
9/21/2013 10:56,12,70000,71,76,147
9/21/2013 10:56,12,70000,71,82,153
9/21/2013 10:56,12,70000,66,74,140
9/21/2013 10:56,12,70000,62,77,139
9/21/2013 10:56,12,70000,66,99,165
9/21/2013 10:56,12,70000,1063,79,1142
9/21/2013 10:56,12,70000,82,78,160
9/21/2013 10:56,12,70000,1053,83,1136
9/21/2013 10:56,12,70000,67,80,147
9/21/2013 10:56,12,70000,63,76,139
9/21/2013 10:57,12,70000,70,76,146
9/21/2013 10:57,12,70000,1056,83,1139
9/21/2013 10:57,12,70000,1052,79,1131
9/21/2013 10:57,12,70000,68,79,147
9/21/2013 10:57,12,70000,64,83,147
9/21/2013 10:57,12,70000,1036,78,1114
9/21/2013 10:57,12,70000,1048,79,1127
9/21/2013 10:57,12,70000,1060,77,1137
9/21/2013 10:57,12,70000,68,77,145
9/21/2013 10:57,12,70000,1035,89,1124
9/21/2013 10:57,12,70000,79,80,159
9/21/2013 10:57,12,70000,58,81,139
9/21/2013 10:57,12,70000,69,78,147
9/21/2013 10:57,12,70000,1050,80,1130
9/21/2013 10:57,12,70000,85,77,162
9/21/2013 10:57,12,70000,60,77,137
9/21/2013 10:57,12,70000,66,77,143
9/21/2013 10:57,12,70000,71,81,152
9/21/2013 10:57,12,70000,74,73,147
9/21/2013 10:57,12,70000,68,88,156
9/21/2013 10:57,12,70000,68,82,150
9/21/2013 10:57,12,70000,1037,81,1118
9/21/2013 10:58,12,70000,1060,86,1146
9/21/2013 10:58,12,70000,1060,80,1140
9/21/2013 10:58,12,70000,64,72,136
9/21/2013 10:58,12,70000,1049,85,1134
9/21/2013 10:58,12,70000,71,76,147
9/21/2013 10:58,12,70000,65,87,152
9/21/2013 10:58,12,70000,1070,79,1149
9/21/2013 10:58,12,70000,69,76,145
9/21/2013 10:58,12,70000,66,78,144
9/21/2013 10:58,12,70000,83,77,160
9/21/2013 10:58,12,70000,79,79,158
9/21/2013 10:58,12,70000,65,86,151
9/21/2013 10:58,12,70000,1035,79,1114
9/21/2013 10:58,12,70000,57,77,134
9/21/2013 10:58,12,70000,68,76,144
9/21/2013 10:58,12,70000,64,78,142
9/21/2013 10:58,12,70000,66,78,144
9/21/2013 10:58,12,70000,66,74,140
9/21/2013 10:58,12,70000,60,77,137
9/21/2013 10:58,12,70000,69,77,146
9/21/2013 10:58,12,70000,65,84,149
9/21/2013 10:58,12,70000,87,82,169
9/21/2013 10:58,12,70000,1055,78,1133
9/21/2013 10:58,12,70000,82,80,162
9/21/2013 10:58,12,70000,69,78,147
9/21/2013 10:58,12,70000,69,82,151
9/21/2013 10:59,12,70000,78,82,160
9/21/2013 10:59,12,70000,1043,77,1120
9/21/2013 10:59,12,70000,67,76,143
9/21/2013 10:59,12,70000,72,76,148
9/21/2013 10:59,12,70000,1039,94,1133
9/21/2013 10:59,12,70000,1040,82,1122
9/21/2013 10:59,12,70000,1056,80,1136
9/21/2013 10:59,12,70000,1047,79,1126
9/21/2013 10:59,12,70000,69,87,156
9/21/2013 10:59,12,70000,61,78,139
9/21/2013 10:59,12,70000,1058,78,1136
9/21/2013 10:59,12,70000,91,78,169
9/21/2013 10:59,12,70000,65,75,140
9/21/2013 10:59,12,70000,68,76,144
9/21/2013 10:59,12,70000,68,78,146
9/21/2013 10:59,12,70000,78,76,154
9/21/2013 10:59,12,70000,1053,76,1129
9/21/2013 10:59,12,70000,65,73,138
9/21/2013 10:59,12,70000,67,81,148
9/21/2013 10:59,12,70000,65,77,142
9/21/2013 10:59,12,70000,68,76,144
9/21/2013 10:59,12,70000,67,76,143
9/21/2013 10:59,12,70000,80,75,155
9/21/2013 11:00,12,70000,1047,80,1127
9/21/2013 11:00,12,70000,65,79,144
9/21/2013 11:00,12,70000,79,80,159
9/21/2013 11:00,12,70000,66,78,144
9/21/2013 11:00,12,70000,66,80,146
9/21/2013 11:00,12,70000,66,75,141
9/21/2013 11:00,12,70000,1048,80,1128
9/21/2013 11:00,12,70000,65,75,140
9/21/2013 11:00,12,70000,66,75,141
9/21/2013 11:00,12,70000,67,80,147
9/21/2013 11:00,12,70000,73,78,151
9/21/2013 11:00,12,70000,63,78,141
9/21/2013 11:00,12,70000,69,78,147
9/21/2013 11:00,12,70000,64,77,141
9/21/2013 11:00,12,70000,68,77,145
9/21/2013 11:00,12,70000,59,77,136
9/21/2013 11:00,12,70000,1055,81,1136
9/21/2013 11:00,12,70000,68,77,145
9/21/2013 11:00,12,80000,68,92,160
9/21/2013 11:00,12,80000,68,77,145
9/21/2013 11:17,12,80000,64,80,144
9/21/2013 11:17,12,80000,1056,88,1144
9/21/2013 11:17,12,80000,68,78,146
9/21/2013 11:17,12,80000,1048,82,1130
9/21/2013 11:17,12,80000,79,77,156
9/21/2013 11:17,12,80000,72,84,156
9/21/2013 11:17,12,80000,73,79,152
9/21/2013 11:17,12,80000,1062,83,1145
9/21/2013 11:17,12,80000,67,85,152
9/21/2013 11:17,12,80000,1070,85,1155
9/21/2013 11:17,12,80000,68,79,147
9/21/2013 11:17,12,80000,1050,81,1131
9/21/2013 11:17,12,80000,71,77,148
9/21/2013 11:17,12,80000,69,83,152
9/21/2013 11:18,12,80000,1086,82,1168
9/21/2013 11:18,12,80000,1050,83,1133
9/21/2013 11:18,12,80000,65,80,145
9/21/2013 11:18,12,80000,72,77,149
9/21/2013 11:18,12,80000,76,79,155
9/21/2013 11:18,12,80000,71,80,151
9/21/2013 11:18,12,80000,73,81,154
9/21/2013 11:18,12,80000,74,81,155
9/21/2013 11:18,12,80000,61,81,142
9/21/2013 11:18,12,80000,73,77,150
9/21/2013 11:18,12,80000,1054,86,1140
9/21/2013 11:18,12,80000,1055,87,1142
9/21/2013 11:18,12,80000,69,89,158
9/21/2013 11:18,12,80000,67,81,148
9/21/2013 11:18,12,80000,1049,79,1128
9/21/2013 11:18,12,80000,76,78,154
9/21/2013 11:18,12,80000,75,83,158
9/21/2013 11:18,12,80000,69,77,146
9/21/2013 11:18,12,80000,72,76,148
9/21/2013 11:18,12,80000,77,81,158
9/21/2013 11:18,12,80000,79,81,160
9/21/2013 11:18,12,80000,75,83,158
9/21/2013 11:18,12,80000,66,78,144
9/21/2013 11:18,12,80000,69,78,147
9/21/2013 11:18,12,80000,70,80,150
9/21/2013 11:18,12,80000,68,85,153
9/21/2013 11:18,12,80000,74,82,156
9/21/2013 11:19,12,80000,74,89,163
9/21/2013 11:19,12,80000,1063,82,1145
9/21/2013 11:19,12,80000,1072,87,1159
9/21/2013 11:19,12,80000,1055,84,1139
9/21/2013 11:19,12,80000,66,79,145
9/21/2013 11:19,12,80000,67,80,147
9/21/2013 11:19,12,80000,73,87,160
9/21/2013 11:19,12,80000,69,83,152
9/21/2013 11:19,12,80000,77,79,156
9/21/2013 11:19,12,80000,65,88,153
9/21/2013 11:19,12,80000,71,77,148
9/21/2013 11:19,12,80000,72,81,153
9/21/2013 11:19,12,80000,1058,89,1147
9/21/2013 11:19,12,80000,71,83,154
9/21/2013 11:19,12,80000,71,81,152
9/21/2013 11:19,12,80000,1045,84,1129
9/21/2013 11:19,12,80000,60,78,138
9/21/2013 11:19,12,80000,67,82,149
9/21/2013 11:19,12,80000,1066,82,1148
9/21/2013 11:19,12,80000,65,80,145
9/21/2013 11:19,12,80000,64,87,151
9/21/2013 11:19,12,80000,68,82,150
9/21/2013 11:19,12,80000,1048,83,1131
9/21/2013 11:20,12,80000,75,84,159
9/21/2013 11:20,12,80000,78,80,158
9/21/2013 11:20,12,80000,64,84,148
9/21/2013 11:20,12,80000,1057,84,1141
9/21/2013 11:20,12,80000,70,87,157
9/21/2013 11:20,12,80000,64,78,142
9/21/2013 11:20,12,80000,76,80,156
9/21/2013 11:20,12,80000,66,81,147
9/21/2013 11:20,12,80000,70,82,152
9/21/2013 11:20,12,80000,75,79,154
9/21/2013 11:20,12,80000,69,81,150
9/21/2013 11:20,12,80000,1058,84,1142
9/21/2013 11:20,12,80000,71,82,153
9/21/2013 11:20,12,80000,65,85,150
9/21/2013 11:20,12,80000,1053,85,1138
9/21/2013 11:20,12,80000,64,84,148
9/21/2013 11:20,12,80000,1059,81,1140
9/21/2013 11:20,12,80000,69,78,147
9/21/2013 11:20,12,80000,66,77,143
9/21/2013 11:20,12,80000,69,83,152
9/21/2013 11:20,12,80000,71,81,152
9/21/2013 11:20,12,80000,63,76,139
9/21/2013 11:20,12,80000,68,76,144
9/21/2013 11:20,12,80000,90,82,172
9/21/2013 11:21,12,80000,1052,86,1138
9/21/2013 11:21,12,80000,67,84,151
9/21/2013 11:21,12,80000,65,78,143
9/21/2013 11:21,12,80000,77,77,154
9/21/2013 11:21,12,80000,1062,82,1144
9/21/2013 11:21,12,80000,63,82,145
9/21/2013 11:21,12,80000,76,79,155
9/21/2013 11:21,12,80000,75,80,155
9/21/2013 11:21,12,80000,1064,82,1146
9/21/2013 11:21,12,80000,1052,87,1139
9/21/2013 11:21,12,80000,70,80,150
9/21/2013 11:21,12,80000,64,77,141
9/21/2013 11:21,12,80000,65,79,144
9/21/2013 11:21,12,80000,71,85,156
9/21/2013 11:21,12,80000,66,83,149
9/21/2013 11:21,12,80000,64,83,147
9/21/2013 11:21,12,80000,79,84,163
9/21/2013 11:21,12,80000,64,84,148
9/21/2013 11:21,12,80000,65,81,146
9/21/2013 11:21,12,80000,65,77,142
9/21/2013 11:21,12,80000,66,77,143
9/21/2013 11:21,12,80000,70,79,149
9/21/2013 11:21,12,80000,1044,83,1127
9/21/2013 11:21,12,80000,70,82,152
9/21/2013 11:21,12,90000,74,85,159
9/21/2013 11:21,12,90000,71,86,157
9/21/2013 11:22,12,90000,62,85,147
9/21/2013 11:22,12,90000,68,88,156
9/21/2013 11:22,12,90000,97,88,185
9/21/2013 11:22,12,90000,82,89,171
9/21/2013 11:22,12,90000,71,89,160
9/21/2013 11:22,12,90000,70,86,156
9/21/2013 11:22,12,90000,1058,86,1144
9/21/2013 11:22,12,90000,85,88,173
9/21/2013 11:22,12,90000,86,89,175
9/21/2013 11:22,12,90000,78,87,165
9/21/2013 11:22,12,90000,67,86,153
9/21/2013 11:22,12,90000,1058,91,1149
9/21/2013 11:22,12,90000,79,91,170
9/21/2013 11:22,12,90000,77,85,162
9/21/2013 11:22,12,90000,1064,91,1155
9/21/2013 11:22,12,90000,70,87,157
9/21/2013 11:22,12,90000,1061,88,1149
9/21/2013 11:22,12,90000,76,90,166
9/21/2013 11:22,12,90000,1051,87,1138
9/21/2013 11:22,12,90000,63,86,149
9/21/2013 11:22,12,90000,1056,89,1145
9/21/2013 11:23,12,90000,1059,90,1149
9/21/2013 11:23,12,90000,71,87,158
9/21/2013 11:23,12,90000,71,87,158
9/21/2013 11:23,12,90000,69,84,153
9/21/2013 11:23,12,90000,83,90,173
9/21/2013 11:23,12,90000,76,86,162
9/21/2013 11:23,12,90000,73,90,163
9/21/2013 11:23,12,90000,66,84,150
9/21/2013 11:23,12,90000,74,92,166
9/21/2013 11:23,12,90000,65,87,152
9/21/2013 11:23,12,90000,68,93,161
9/21/2013 11:23,12,90000,78,86,164
9/21/2013 11:23,12,90000,73,88,161
9/21/2013 11:23,12,90000,78,86,164
9/21/2013 11:23,12,90000,71,93,164
9/21/2013 11:23,12,90000,69,93,162
9/21/2013 11:23,12,90000,61,87,148
9/21/2013 11:23,12,90000,70,85,155
9/21/2013 11:23,12,90000,78,85,163
9/21/2013 11:23,12,90000,79,84,163
9/21/2013 11:23,12,90000,69,84,153
9/21/2013 11:23,12,90000,77,90,167
9/21/2013 11:23,12,90000,69,89,158
9/21/2013 11:23,12,90000,79,92,171
9/21/2013 11:23,12,90000,1061,90,1151
9/21/2013 11:24,12,90000,71,91,162
9/21/2013 11:24,12,90000,84,90,174
9/21/2013 11:24,12,90000,66,90,156
9/21/2013 11:24,12,90000,87,85,172
9/21/2013 11:24,12,90000,70,87,157
9/21/2013 11:24,12,90000,73,90,163
9/21/2013 11:24,12,90000,72,85,157
9/21/2013 11:24,12,90000,1058,86,1144
9/21/2013 11:24,12,90000,70,86,156
9/21/2013 11:24,12,90000,1069,89,1158
9/21/2013 11:24,12,90000,74,86,160
9/21/2013 11:24,12,90000,1059,88,1147
9/21/2013 11:24,12,90000,72,90,162
9/21/2013 11:24,12,90000,77,89,166
9/21/2013 11:24,12,90000,69,92,161
9/21/2013 11:24,12,90000,77,86,163
9/21/2013 11:24,12,90000,82,85,167
9/21/2013 11:24,12,90000,73,88,161
9/21/2013 11:24,12,90000,71,88,159
9/21/2013 11:24,12,90000,73,92,165
9/21/2013 11:24,12,90000,70,88,158
9/21/2013 11:24,12,90000,90,89,179
9/21/2013 11:24,12,90000,81,90,171
9/21/2013 11:24,12,90000,72,85,157
9/21/2013 11:25,12,90000,75,93,168
9/21/2013 11:25,12,90000,68,88,156
9/21/2013 11:25,12,90000,67,88,155
9/21/2013 11:25,12,90000,75,87,162
9/21/2013 11:25,12,90000,70,86,156
9/21/2013 11:25,12,90000,67,93,160
9/21/2013 11:25,12,90000,71,88,159
9/21/2013 11:25,12,90000,69,81,150
9/21/2013 11:25,12,90000,1047,90,1137
9/21/2013 11:25,12,90000,74,94,168
9/21/2013 11:25,12,90000,84,86,170
9/21/2013 11:25,12,90000,95,90,185
9/21/2013 11:25,12,90000,67,82,149
9/21/2013 11:25,12,90000,69,87,156
9/21/2013 11:25,12,90000,71,84,155
9/21/2013 11:25,12,90000,1053,87,1140
9/21/2013 11:25,12,90000,92,90,182
9/21/2013 11:25,12,90000,79,88,167
9/21/2013 11:25,12,90000,1058,89,1147
9/21/2013 11:25,12,90000,70,88,158
9/21/2013 11:25,12,90000,73,90,163
9/21/2013 11:25,12,90000,78,87,165
9/21/2013 11:25,12,90000,75,87,162
9/21/2013 11:26,12,90000,1054,87,1141
9/21/2013 11:26,12,90000,97,88,185
9/21/2013 11:26,12,90000,87,87,174
9/21/2013 11:26,12,90000,76,90,166
9/21/2013 11:26,12,90000,78,86,164
9/21/2013 11:26,12,90000,80,90,170
9/21/2013 11:26,12,90000,1049,93,1142
9/21/2013 11:26,12,90000,81,92,173
9/21/2013 11:26,12,90000,78,86,164
9/21/2013 11:26,12,90000,68,87,155
9/21/2013 11:26,12,90000,78,86,164
9/21/2013 11:26,12,90000,72,88,160
9/21/2013 11:26,12,90000,76,88,164
9/21/2013 11:26,12,90000,67,87,154
9/21/2013 11:26,12,90000,1044,87,1131
9/21/2013 11:26,12,90000,78,87,165
9/21/2013 11:26,12,90000,71,90,161
9/21/2013 11:26,12,90000,72,85,157
9/21/2013 11:26,12,90000,65,90,155
9/21/2013 11:26,12,90000,66,85,151
9/21/2013 11:26,12,100000,88,90,178
9/21/2013 11:26,12,100000,87,86,173
9/21/2013 11:26,12,100000,80,90,170
9/21/2013 11:26,12,100000,80,87,167
9/21/2013 11:26,12,100000,69,89,158
9/21/2013 11:26,12,100000,82,86,168
9/21/2013 11:26,12,100000,80,91,171
9/21/2013 11:26,12,100000,78,89,167
9/21/2013 11:27,12,100000,1059,94,1153
9/21/2013 11:27,12,100000,77,84,161
9/21/2013 11:27,12,100000,75,90,165
9/21/2013 11:27,12,100000,79,86,165
9/21/2013 11:27,12,100000,77,88,165
9/21/2013 11:27,12,100000,71,85,156
9/21/2013 11:27,12,100000,73,90,163
9/21/2013 11:27,12,100000,74,88,162
9/21/2013 11:27,12,100000,83,90,173
9/21/2013 11:27,12,100000,79,90,169
9/21/2013 11:27,12,100000,74,89,163
9/21/2013 11:27,12,100000,69,84,153
9/21/2013 11:27,12,100000,84,89,173
9/21/2013 11:27,12,100000,1057,96,1153
9/21/2013 11:27,12,100000,92,90,182
9/21/2013 11:27,12,100000,1063,91,1154
9/21/2013 11:27,12,100000,75,90,165
9/21/2013 11:27,12,100000,88,89,177
9/21/2013 11:27,12,100000,105,88,193
9/21/2013 11:27,12,100000,1067,99,1166
9/21/2013 11:27,12,100000,67,88,155
9/21/2013 11:27,12,100000,75,94,169
9/21/2013 11:27,12,100000,1049,95,1144
9/21/2013 11:27,12,100000,75,92,167
9/21/2013 11:27,12,100000,1058,90,1148
9/21/2013 11:28,12,100000,1064,93,1157
9/21/2013 11:28,12,100000,73,89,162
9/21/2013 11:28,12,100000,81,94,175
9/21/2013 11:28,12,100000,73,88,161
9/21/2013 11:28,12,100000,76,92,168
9/21/2013 11:28,12,100000,82,95,177
9/21/2013 11:28,12,100000,86,91,177
9/21/2013 11:28,12,100000,77,92,169
9/21/2013 11:28,12,100000,76,90,166
9/21/2013 11:28,12,100000,80,88,168
9/21/2013 11:28,12,100000,91,94,185
9/21/2013 11:28,12,100000,75,90,165
9/21/2013 11:28,12,100000,68,91,159
9/21/2013 11:28,12,100000,1050,89,1139
9/21/2013 11:28,12,100000,74,87,161
9/21/2013 11:28,12,100000,75,88,163
9/21/2013 11:28,12,100000,75,90,165
9/21/2013 11:28,12,100000,79,93,172
9/21/2013 11:28,12,100000,88,88,176
9/21/2013 11:28,12,100000,81,93,174
9/21/2013 11:28,12,100000,74,92,166
9/21/2013 11:28,12,100000,72,90,162
9/21/2013 11:28,12,100000,67,91,158
9/21/2013 11:28,12,100000,71,89,160
9/21/2013 11:28,12,100000,78,85,163
9/21/2013 11:28,12,100000,75,87,162
9/21/2013 11:28,12,100000,84,82,166
9/21/2013 11:29,12,100000,73,91,164
9/21/2013 11:29,12,100000,77,88,165
9/21/2013 11:29,12,100000,75,91,166
9/21/2013 11:29,12,100000,84,88,172
9/21/2013 11:29,12,100000,77,89,166
9/21/2013 11:29,12,100000,83,92,175
9/21/2013 11:29,12,100000,70,88,158
9/21/2013 11:29,12,100000,67,94,161
9/21/2013 11:29,12,100000,1055,91,1146
9/21/2013 11:29,12,100000,1074,96,1170
9/21/2013 11:29,12,100000,86,92,178
9/21/2013 11:29,12,100000,75,88,163
9/21/2013 11:29,12,100000,1057,94,1151
9/21/2013 11:29,12,100000,91,90,181
9/21/2013 11:29,12,100000,1058,95,1153
9/21/2013 11:29,12,100000,73,96,169
9/21/2013 11:29,12,100000,1058,96,1154
9/21/2013 11:29,12,100000,83,92,175
9/21/2013 11:29,12,100000,1048,92,1140
9/21/2013 11:29,12,100000,1052,97,1149
9/21/2013 11:29,12,100000,87,93,180
9/21/2013 11:29,12,100000,87,88,175
9/21/2013 11:29,12,100000,84,90,174
9/21/2013 11:29,12,100000,89,89,178
9/21/2013 11:30,12,100000,74,89,163
9/21/2013 11:30,12,100000,83,90,173
9/21/2013 11:30,12,100000,71,88,159
9/21/2013 11:30,12,100000,87,89,176
9/21/2013 11:30,12,100000,84,88,172
9/21/2013 11:30,12,100000,1074,88,1162
9/21/2013 11:30,12,100000,71,89,160
9/21/2013 11:30,12,100000,70,92,162
9/21/2013 11:30,12,100000,79,90,169
9/21/2013 11:30,12,100000,77,89,166
9/21/2013 11:30,12,100000,76,85,161
9/21/2013 11:30,12,100000,74,89,163
9/21/2013 11:30,12,100000,70,86,156
9/21/2013 11:30,12,100000,84,86,170
9/21/2013 11:30,12,100000,84,89,173
9/21/2013 11:30,12,100000,1056,94,1150
9/21/2013 11:30,12,100000,86,88,174
9/21/2013 11:30,12,100000,70,90,160
9/21/2013 11:30,12,100000,77,89,166
9/21/2013 11:30,12,100000,82,84,166
9/21/2013 11:30,12,100000,78,91,169
9/21/2013 11:30,12,100000,82,93,175
9/21/2013 11:30,12,100000,67,84,151
9/21/2013 11:30,12,100000,70,86,156
9/21/2013 11:30,12,100000,76,88,164
9/21/2013 11:30,12,100000,74,92,166
9/21/2013 11:30,12,100000,76,86,162
9/21/2013 11:31,12,100000,83,85,168
9/21/2013 11:31,12,100000,74,99,173
9/21/2013 11:31,12,100000,70,88,158
9/21/2013 11:31,12,100000,98,90,188
9/21/2013 11:31,12,100000,1052,93,1145
9/21/2013 11:31,12,100000,1068,97,1165
9/21/2013 11:31,12,100000,76,90,166
9/21/2013 11:31,12,100000,80,90,170
9/21/2013 11:31,12,100000,79,95,174
9/21/2013 11:31,12,100000,78,91,169
9/21/2013 11:31,12,100000,68,91,159
9/21/2013 11:31,12,100000,1067,91,1158
9/21/2013 11:31,12,100000,1075,98,1173
9/21/2013 11:31,12,100000,68,92,160
9/21/2013 11:31,12,100000,78,92,170
9/21/2013 11:31,12,100000,70,87,157
9/21/2013 11:31,12,100000,75,87,162
9/21/2013 11:31,12,100000,82,89,171
9/21/2013 11:31,12,100000,99,85,184
9/21/2013 11:31,12,100000,89,90,179
9/21/2013 11:31,12,100000,67,96,163
9/21/2013 11:31,12,100000,1060,91,1151
9/21/2013 11:31,12,100000,79,88,167
9/21/2013 11:32,12,100000,1047,97,1144
9/21/2013 11:32,12,100000,91,90,181
9/21/2013 11:32,12,100000,78,91,169
9/21/2013 11:32,12,100000,74,89,163
9/21/2013 11:32,12,100000,72,99,171
9/21/2013 11:32,12,100000,76,90,166
9/21/2013 11:32,12,100000,65,91,156
9/21/2013 11:32,12,100000,72,99,171
9/21/2013 11:32,12,100000,73,91,164
9/21/2013 11:32,12,100000,87,100,187
9/21/2013 11:32,12,100000,90,86,176
9/21/2013 11:32,12,100000,73,88,161
9/21/2013 11:32,12,100000,1079,91,1170
9/21/2013 11:32,12,100000,83,89,172
9/21/2013 11:32,12,100000,80,98,178
9/21/2013 11:32,12,100000,82,96,178
9/21/2013 11:32,12,100000,80,89,169
9/21/2013 11:32,12,100000,95,92,187
9/21/2013 11:32,12,100000,72,88,160
9/21/2013 11:32,12,100000,96,93,189
9/21/2013 11:32,12,100000,1073,89,1162
9/21/2013 11:32,12,100000,78,89,167
9/21/2013 11:32,12,100000,78,89,167
9/21/2013 11:32,12,100000,87,91,178
9/21/2013 11:32,12,100000,78,89,167
9/21/2013 11:32,12,100000,76,87,163
9/21/2013 11:33,12,100000,80,90,170
9/21/2013 11:33,12,100000,1060,92,1152
9/21/2013 11:33,12,100000,77,90,167
9/21/2013 11:33,12,100000,67,87,154
9/21/2013 11:33,12,100000,1070,97,1167
9/21/2013 11:33,12,100000,1066,89,1155
9/21/2013 11:33,12,100000,1074,90,1164
9/21/2013 11:33,12,100000,87,86,173
9/21/2013 11:33,12,100000,86,86,172
9/21/2013 11:33,12,100000,72,92,164
9/21/2013 11:33,12,100000,69,86,155
9/21/2013 11:33,12,100000,80,87,167
9/21/2013 11:33,12,100000,77,90,167
9/21/2013 11:33,12,100000,112,89,201
9/21/2013 11:33,12,100000,1054,89,1143
9/21/2013 11:33,12,100000,81,95,176
9/21/2013 11:33,12,100000,76,84,160
9/21/2013 11:33,12,100000,68,88,156
9/21/2013 11:33,12,100000,82,87,169
9/21/2013 11:33,12,100000,75,88,163
9/21/2013 11:33,12,100000,72,90,162
9/21/2013 11:33,12,100000,74,91,165
9/21/2013 11:33,12,100000,90,91,181
9/21/2013 11:34,12,100000,74,89,163
9/21/2013 11:34,12,100000,81,85,166
9/21/2013 11:34,12,100000,1071,90,1161
9/21/2013 11:34,12,100000,72,88,160
9/21/2013 11:34,12,100000,76,89,165
9/21/2013 11:34,12,100000,70,87,157
9/21/2013 11:34,12,100000,76,96,172
9/21/2013 11:34,12,100000,76,91,167
9/21/2013 11:34,12,100000,1056,89,1145
9/21/2013 11:34,12,100000,79,86,165
9/21/2013 11:34,12,100000,75,95,170
9/21/2013 11:34,12,100000,78,85,163
9/21/2013 11:34,12,100000,67,88,155
9/21/2013 11:34,12,100000,1055,93,1148
9/21/2013 11:34,12,100000,73,91,164
9/21/2013 11:34,12,100000,72,85,157
9/21/2013 11:34,12,100000,1053,90,1143
9/21/2013 11:34,12,100000,81,93,174
9/21/2013 11:34,12,100000,76,91,167
9/21/2013 11:34,12,100000,76,86,162
9/21/2013 11:34,12,100000,79,90,169
9/21/2013 11:34,12,100000,76,92,168
9/21/2013 11:34,12,100000,74,87,161
9/21/2013 11:35,12,100000,1061,91,1152
9/21/2013 11:35,12,100000,76,88,164
9/21/2013 11:35,12,100000,71,94,165
9/21/2013 11:35,12,100000,76,88,164
9/21/2013 11:35,12,100000,73,95,168
9/21/2013 11:35,12,100000,1058,92,1150
9/21/2013 11:35,12,100000,83,87,170
9/21/2013 11:35,12,100000,84,87,171
9/21/2013 11:35,12,100000,68,92,160
9/21/2013 11:35,12,100000,82,91,173
9/21/2013 11:35,12,100000,78,91,169
9/21/2013 11:35,12,100000,75,95,170
9/21/2013 11:35,12,100000,84,87,171
9/21/2013 11:35,12,100000,73,89,162
9/21/2013 11:35,12,100000,67,94,161
9/21/2013 11:35,12,100000,88,90,178
9/21/2013 11:35,12,100000,79,92,171
9/21/2013 11:35,12,100000,80,92,172
9/21/2013 11:35,12,100000,1064,89,1153
9/21/2013 11:35,12,100000,76,87,163
9/21/2013 11:35,12,100000,70,92,162
9/21/2013 11:35,12,100000,75,90,165
9/21/2013 11:35,12,100000,79,90,169
9/21/2013 11:35,12,100000,71,93,164
9/21/2013 11:35,12,200000,1090,114,1204
9/21/2013 11:35,12,200000,117,111,228
9/21/2013 11:36,12,200000,89,112,201
9/21/2013 11:36,12,200000,102,108,210
9/21/2013 11:36,12,200000,103,111,214
9/21/2013 11:36,12,200000,102,111,213
9/21/2013 11:36,12,200000,89,116,205
9/21/2013 11:36,12,200000,97,113,210
9/21/2013 11:36,12,200000,113,110,223
9/21/2013 11:36,12,200000,108,111,219
9/21/2013 11:36,12,200000,91,111,202
9/21/2013 11:36,12,200000,86,110,196
9/21/2013 11:36,12,200000,92,119,211
9/21/2013 11:36,12,200000,126,112,238
9/21/2013 11:36,12,200000,106,111,217
9/21/2013 11:36,12,200000,92,110,202
9/21/2013 11:36,12,200000,112,111,223
9/21/2013 11:36,12,200000,92,117,209
9/21/2013 11:36,12,200000,1055,111,1166
9/21/2013 11:36,12,200000,89,114,203
9/21/2013 11:36,12,200000,90,113,203
9/21/2013 11:36,12,200000,1057,114,1171
9/21/2013 11:36,12,200000,99,113,212
9/21/2013 11:36,12,200000,280,115,395
9/21/2013 11:36,12,200000,1076,118,1194
9/21/2013 11:36,12,200000,102,114,216
9/21/2013 11:36,12,200000,109,115,224
9/21/2013 11:37,12,200000,95,118,213
9/21/2013 11:37,12,200000,102,120,222
9/21/2013 11:37,12,200000,1076,115,1191
9/21/2013 11:37,12,200000,105,109,214
9/21/2013 11:37,12,200000,100,111,211
9/21/2013 11:37,12,200000,103,112,215
9/21/2013 11:37,12,200000,93,111,204
9/21/2013 11:37,12,200000,95,112,207
9/21/2013 11:37,12,200000,101,109,210
9/21/2013 11:37,12,200000,95,110,205
9/21/2013 11:37,12,200000,100,110,210
9/21/2013 11:37,12,200000,1080,112,1192
9/21/2013 11:37,12,200000,134,109,243
9/21/2013 11:37,12,200000,100,118,218
9/21/2013 11:37,12,200000,86,111,197
9/21/2013 11:37,12,200000,125,110,235
9/21/2013 11:37,12,200000,81,114,195
9/21/2013 11:37,12,200000,100,109,209
9/21/2013 11:37,12,200000,1065,117,1182
9/21/2013 11:37,12,200000,85,112,197
9/21/2013 11:37,12,200000,95,113,208
9/21/2013 11:37,12,200000,92,111,203
9/21/2013 11:37,12,200000,81,112,193
9/21/2013 11:37,12,200000,110,112,222
9/21/2013 11:38,12,200000,1083,114,1197
9/21/2013 11:38,12,200000,1056,113,1169
9/21/2013 11:38,12,200000,86,113,199
9/21/2013 11:38,12,200000,91,109,200
9/21/2013 11:38,12,200000,86,108,194
9/21/2013 11:38,12,200000,1067,112,1179
9/21/2013 11:38,12,200000,79,111,190
9/21/2013 11:38,12,200000,1076,114,1190
9/21/2013 11:38,12,200000,1078,116,1194
9/21/2013 11:38,12,200000,1063,112,1175
9/21/2013 11:38,12,200000,89,113,202
9/21/2013 11:38,12,200000,95,113,208
9/21/2013 11:38,12,200000,86,110,196
9/21/2013 11:38,12,200000,98,112,210
9/21/2013 11:38,12,200000,1065,117,1182
9/21/2013 11:38,12,200000,97,113,210
9/21/2013 11:38,12,200000,89,113,202
9/21/2013 11:38,12,200000,1071,113,1184
9/21/2013 11:38,12,200000,1091,113,1204
9/21/2013 11:38,12,200000,90,115,205
9/21/2013 11:38,12,200000,102,111,213
9/21/2013 11:38,12,200000,92,111,203
9/21/2013 11:39,12,200000,97,115,212
9/21/2013 11:39,12,200000,110,108,218
9/21/2013 11:39,12,200000,108,111,219
9/21/2013 11:39,12,200000,98,110,208
9/21/2013 11:39,12,200000,102,112,214
9/21/2013 11:39,12,200000,91,112,203
9/21/2013 11:39,12,200000,97,111,208
9/21/2013 11:39,12,200000,80,117,197
9/21/2013 11:39,12,200000,1068,113,1181
9/21/2013 11:39,12,200000,1044,114,1158
9/21/2013 11:39,12,200000,1061,110,1171
9/21/2013 11:39,12,200000,99,114,213
9/21/2013 11:39,12,200000,90,109,199
9/21/2013 11:39,12,200000,100,112,212
9/21/2013 11:39,12,200000,86,112,198
9/21/2013 11:39,12,200000,1071,111,1182
9/21/2013 11:39,12,200000,102,107,209
9/21/2013 11:39,12,200000,1076,115,1191
9/21/2013 11:39,12,200000,1087,119,1206
9/21/2013 11:39,12,200000,92,111,203
9/21/2013 11:39,12,200000,90,119,209
9/21/2013 11:39,12,200000,104,111,215
9/21/2013 11:39,12,200000,93,112,205
9/21/2013 11:39,12,200000,107,110,217
9/21/2013 11:40,12,200000,83,110,193
9/21/2013 11:40,12,200000,85,114,199
9/21/2013 11:40,12,200000,105,114,219
9/21/2013 11:40,12,200000,93,113,206
9/21/2013 11:40,12,200000,108,120,228
9/21/2013 11:40,12,200000,89,109,198
9/21/2013 11:40,12,200000,1076,113,1189
9/21/2013 11:40,12,200000,107,112,219
9/21/2013 11:40,12,200000,101,113,214
9/21/2013 11:40,12,200000,95,111,206
9/21/2013 11:40,12,200000,1071,117,1188
9/21/2013 11:40,12,200000,97,117,214
9/21/2013 11:40,12,200000,1074,117,1191
9/21/2013 11:40,12,200000,90,109,199
9/21/2013 11:40,12,200000,88,111,199
9/21/2013 11:40,12,200000,88,108,196
9/21/2013 11:40,12,200000,101,112,213
9/21/2013 11:40,12,200000,1072,117,1189
9/21/2013 11:40,12,300000,112,150,262
9/21/2013 11:40,12,300000,97,142,239
9/21/2013 11:40,12,300000,132,149,281
9/21/2013 11:40,12,300000,1098,140,1238
9/21/2013 11:40,12,300000,1104,141,1245
9/21/2013 11:40,12,300000,137,138,275
9/21/2013 11:41,12,300000,102,140,242
9/21/2013 11:41,12,300000,1122,142,1264
9/21/2013 11:41,12,300000,110,137,247
9/21/2013 11:41,12,300000,132,141,273
9/21/2013 11:41,12,300000,99,145,244
9/21/2013 11:41,12,300000,112,139,251
9/21/2013 11:41,12,300000,1124,137,1261
9/21/2013 11:41,12,300000,118,134,252
9/21/2013 11:41,12,300000,107,141,248
9/21/2013 11:41,12,300000,106,140,246
9/21/2013 11:41,12,300000,117,139,256
9/21/2013 11:41,12,300000,99,141,240
9/21/2013 11:41,12,300000,106,142,248
9/21/2013 11:41,12,300000,1111,144,1255
9/21/2013 11:41,12,300000,1099,140,1239
9/21/2013 11:41,12,300000,110,141,251
9/21/2013 11:41,12,300000,136,142,278
9/21/2013 11:41,12,300000,124,138,262
9/21/2013 11:41,12,300000,112,136,248
9/21/2013 11:41,12,300000,1084,140,1224
9/21/2013 11:41,12,300000,119,141,260
9/21/2013 11:41,12,300000,107,139,246
9/21/2013 11:42,12,300000,138,141,279
9/21/2013 11:42,12,300000,1079,145,1224
9/21/2013 11:42,12,300000,1068,151,1219
9/21/2013 11:42,12,300000,1102,140,1242
9/21/2013 11:42,12,300000,120,141,261
9/21/2013 11:42,12,300000,1099,142,1241
9/21/2013 11:42,12,300000,117,139,256
9/21/2013 11:42,12,300000,1110,142,1252
9/21/2013 11:42,12,300000,113,141,254
9/21/2013 11:42,12,300000,120,141,261
9/21/2013 11:42,12,300000,1067,143,1210
9/21/2013 11:42,12,300000,101,137,238
9/21/2013 11:42,12,300000,1107,141,1248
9/21/2013 11:42,12,300000,134,140,274
9/21/2013 11:42,12,300000,108,134,242
9/21/2013 11:42,12,300000,94,139,233
9/21/2013 11:42,12,300000,1061,138,1199
9/21/2013 11:42,12,300000,120,147,267
9/21/2013 11:42,12,300000,102,141,243
9/21/2013 11:42,12,300000,138,144,282
9/21/2013 11:42,12,300000,107,141,248
9/21/2013 11:42,12,300000,147,141,288
9/21/2013 11:42,12,300000,133,139,272
9/21/2013 11:43,12,300000,1151,144,1295
9/21/2013 11:43,12,300000,1089,141,1230
9/21/2013 11:43,12,300000,138,136,274
9/21/2013 11:43,12,300000,105,135,240
9/21/2013 11:43,12,300000,121,136,257
9/21/2013 11:43,12,300000,120,137,257
9/21/2013 11:43,12,300000,1120,137,1257
9/21/2013 11:43,12,300000,111,135,246
9/21/2013 11:43,12,300000,1098,139,1237
9/21/2013 11:43,12,300000,117,141,258
9/21/2013 11:43,12,300000,114,143,257
9/21/2013 11:43,12,300000,1086,141,1227
9/21/2013 11:43,12,300000,1103,143,1246
9/21/2013 11:43,12,300000,1106,145,1251
9/21/2013 11:43,12,300000,1091,143,1234
9/21/2013 11:43,12,300000,130,145,275
9/21/2013 11:43,12,300000,117,146,263
9/21/2013 11:43,12,300000,1091,144,1235
9/21/2013 11:43,12,300000,137,133,270
9/21/2013 11:44,12,300000,1076,145,1221
9/21/2013 11:44,12,300000,127,139,266
9/21/2013 11:44,12,300000,1092,140,1232
9/21/2013 11:44,12,300000,128,141,269
9/21/2013 11:44,12,300000,1110,142,1252
9/21/2013 11:44,12,300000,135,138,273
9/21/2013 11:44,12,300000,130,137,267
9/21/2013 11:44,12,300000,138,140,278
9/21/2013 11:44,12,300000,1083,146,1229
9/21/2013 11:44,12,300000,1099,147,1246
9/21/2013 11:44,12,300000,1108,137,1245
9/21/2013 11:44,12,300000,1092,142,1234
9/21/2013 11:44,12,300000,115,139,254
9/21/2013 11:44,12,300000,127,143,270
9/21/2013 11:44,12,300000,106,138,244
9/21/2013 11:44,12,300000,121,140,261
9/21/2013 11:44,12,300000,1113,143,1256
9/21/2013 11:44,12,300000,102,142,244
9/21/2013 11:44,12,300000,1081,143,1224
9/21/2013 11:44,12,300000,1117,139,1256
9/21/2013 11:44,12,300000,109,141,250
9/21/2013 11:45,12,300000,1081,141,1222
9/21/2013 11:45,12,300000,1087,145,1232
9/21/2013 11:45,12,300000,108,148,256
9/21/2013 11:45,12,300000,119,143,262
9/21/2013 11:45,12,300000,1081,143,1224
9/21/2013 11:45,12,300000,1085,147,1232
9/21/2013 11:45,12,300000,100,142,242
9/21/2013 12:01,12,300000,119,141,260
9/21/2013 12:02,12,300000,125,136,261
9/21/2013 12:02,12,300000,146,141,287
9/21/2013 12:02,12,300000,123,140,263
9/21/2013 12:02,12,300000,99,141,240
9/21/2013 12:02,12,300000,115,148,263
9/21/2013 12:02,12,300000,99,136,235
9/21/2013 12:02,12,300000,96,139,235
9/21/2013 12:02,12,300000,1085,143,1228
9/21/2013 12:02,12,300000,102,145,247
9/21/2013 12:02,12,300000,142,142,284
9/21/2013 12:02,12,300000,105,145,250
9/21/2013 12:02,12,300000,100,143,243
9/21/2013 12:02,12,300000,1105,138,1243
9/21/2013 12:02,12,300000,111,135,246
9/21/2013 12:02,12,300000,128,141,269
9/21/2013 12:02,12,400000,124,165,289
9/21/2013 12:02,12,400000,1125,164,1289
9/21/2013 12:02,12,400000,140,161,301
9/21/2013 12:02,12,400000,136,162,298
9/21/2013 12:02,12,400000,120,165,285
9/21/2013 12:02,12,400000,1105,168,1273
9/21/2013 12:02,12,400000,123,160,283
9/21/2013 12:02,12,400000,1108,200,1308
9/21/2013 12:03,12,400000,1112,166,1278
9/21/2013 12:03,12,400000,1140,169,1309
9/21/2013 12:03,12,400000,126,161,287
9/21/2013 12:03,12,400000,110,161,271
9/21/2013 12:03,12,400000,1124,166,1290
9/21/2013 12:03,12,400000,133,164,297
9/21/2013 12:03,12,400000,146,165,311
9/21/2013 12:03,12,400000,1131,161,1292
9/21/2013 12:03,12,400000,99,162,261
9/21/2013 12:03,12,400000,1123,165,1288
9/21/2013 12:03,12,400000,131,200,331
9/21/2013 12:03,12,400000,112,159,271
9/21/2013 12:03,12,400000,149,162,311
9/21/2013 12:03,12,400000,1106,167,1273
9/21/2013 12:03,12,400000,129,170,299
9/21/2013 12:03,12,400000,159,161,320
9/21/2013 12:03,12,400000,126,161,287
9/21/2013 12:03,12,400000,153,200,353
9/21/2013 12:03,12,400000,119,162,281
9/21/2013 12:03,12,400000,1106,165,1271
9/21/2013 12:03,12,400000,183,201,384
9/21/2013 12:03,12,400000,156,160,316
9/21/2013 12:03,12,400000,119,198,317
9/21/2013 12:04,12,400000,124,166,290
9/21/2013 12:04,12,400000,133,163,296
9/21/2013 12:04,12,400000,133,168,301
9/21/2013 12:04,12,400000,120,164,284
9/21/2013 12:04,12,400000,118,162,280
9/21/2013 12:04,12,400000,171,159,330
9/21/2013 12:04,12,400000,135,193,328
9/21/2013 12:04,12,400000,118,184,302
9/21/2013 12:04,12,400000,131,192,323
9/21/2013 12:04,12,400000,127,165,292
9/21/2013 12:04,12,400000,144,163,307
9/21/2013 12:04,12,400000,156,163,319
9/21/2013 12:04,12,400000,131,168,299
9/21/2013 12:04,12,400000,113,161,274
9/21/2013 12:04,12,400000,131,163,294
9/21/2013 12:04,12,400000,154,162,316
9/21/2013 12:04,12,400000,107,161,268
9/21/2013 12:04,12,400000,125,159,284
9/21/2013 12:04,12,400000,156,167,323
9/21/2013 12:04,12,400000,189,162,351
9/21/2013 12:04,12,400000,136,164,300
9/21/2013 12:04,12,400000,1155,196,1351
9/21/2013 12:04,12,400000,1086,196,1282
9/21/2013 12:04,12,400000,122,162,284
9/21/2013 12:05,12,400000,1142,165,1307
9/21/2013 12:05,12,400000,1135,163,1298
9/21/2013 12:05,12,400000,205,162,367
9/21/2013 12:05,12,400000,1104,201,1305
9/21/2013 12:05,12,400000,146,165,311
9/21/2013 12:05,12,400000,140,171,311
9/21/2013 12:05,12,400000,141,159,300
9/21/2013 12:05,12,400000,1090,169,1259
9/21/2013 12:05,12,400000,169,161,330
9/21/2013 12:05,12,400000,1108,162,1270
9/21/2013 12:05,12,400000,1114,159,1273
9/21/2013 12:05,12,400000,1121,168,1289
9/21/2013 12:05,12,400000,133,163,296
9/21/2013 12:05,12,400000,1100,165,1265
9/21/2013 12:05,12,400000,135,164,299
9/21/2013 12:05,12,400000,159,164,323
9/21/2013 12:05,12,400000,128,162,290
9/21/2013 12:05,12,400000,110,159,269
9/21/2013 12:05,12,400000,152,168,320
9/21/2013 12:05,12,400000,134,162,296
9/21/2013 12:06,12,400000,138,163,301
9/21/2013 12:06,12,400000,175,164,339
9/21/2013 12:06,12,400000,147,168,315
9/21/2013 12:06,12,400000,144,160,304
9/21/2013 12:06,12,400000,159,163,322
9/21/2013 12:06,12,400000,172,166,338
9/21/2013 12:06,12,400000,128,164,292
9/21/2013 12:06,12,400000,154,163,317
9/21/2013 12:06,12,400000,1087,172,1259
9/21/2013 12:06,12,400000,139,165,304
9/21/2013 12:06,12,400000,134,162,296
9/21/2013 12:06,12,400000,123,161,284
9/21/2013 12:06,12,400000,126,168,294
9/21/2013 12:06,12,400000,136,162,298
9/21/2013 12:06,12,400000,1109,171,1280
9/21/2013 12:06,12,400000,1079,163,1242
9/21/2013 12:06,12,400000,119,166,285
9/21/2013 12:06,12,400000,133,160,293
9/21/2013 12:06,12,400000,119,163,282
9/21/2013 12:06,12,400000,135,160,295
9/21/2013 12:06,12,400000,157,164,321
9/21/2013 12:06,12,400000,158,160,318
9/21/2013 12:06,12,400000,140,196,336
9/21/2013 12:07,12,400000,139,165,304
9/21/2013 12:07,12,400000,127,162,289
9/21/2013 12:07,12,400000,1088,166,1254
9/21/2013 12:07,12,400000,131,161,292
9/21/2013 12:07,12,400000,1142,164,1306
9/21/2013 12:07,12,400000,134,164,298
9/21/2013 12:07,12,400000,1113,168,1281
9/21/2013 12:07,12,400000,172,166,338
9/21/2013 12:07,12,400000,115,162,277
9/21/2013 12:07,12,400000,139,167,306
9/21/2013 12:07,12,400000,1120,202,1322
9/21/2013 12:07,12,400000,133,164,297
9/21/2013 12:07,12,400000,131,167,298
9/21/2013 12:07,12,400000,1099,198,1297
9/21/2013 12:07,12,400000,1116,195,1311
9/21/2013 12:07,12,400000,160,163,323
9/21/2013 12:07,12,400000,115,163,278
9/21/2013 12:07,12,500000,154,185,339
9/21/2013 12:07,12,500000,165,184,349
9/21/2013 12:07,12,500000,203,184,387
9/21/2013 12:07,12,500000,191,185,376
9/21/2013 12:08,12,500000,1154,190,1344
9/21/2013 12:08,12,500000,192,184,376
9/21/2013 12:08,12,500000,183,186,369
9/21/2013 12:08,12,500000,162,188,350
9/21/2013 12:08,12,500000,157,183,340
9/21/2013 12:08,12,500000,121,222,343
9/21/2013 12:08,12,500000,176,186,362
9/21/2013 12:08,12,500000,194,191,385
9/21/2013 12:08,12,500000,200,186,386
9/21/2013 12:08,12,500000,154,223,377
9/21/2013 12:08,12,500000,172,187,359
9/21/2013 12:08,12,500000,144,218,362
9/21/2013 12:08,12,500000,175,184,359
9/21/2013 12:08,12,500000,176,185,361
9/21/2013 12:08,12,500000,172,184,356
9/21/2013 12:08,12,500000,190,184,374
9/21/2013 12:08,12,500000,193,188,381
9/21/2013 12:08,12,500000,181,182,363
9/21/2013 12:08,12,500000,170,224,394
9/21/2013 12:08,12,500000,174,189,363
9/21/2013 12:08,12,500000,167,214,381
9/21/2013 12:08,12,500000,191,184,375
9/21/2013 12:08,12,500000,1171,192,1363
9/21/2013 12:08,12,500000,171,214,385
9/21/2013 12:08,12,500000,150,218,368
9/21/2013 12:09,12,500000,194,181,375
9/21/2013 12:09,12,500000,1108,227,1335
9/21/2013 12:09,12,500000,160,223,383
9/21/2013 12:09,12,500000,136,218,354
9/21/2013 12:09,12,500000,181,186,367
9/21/2013 12:09,12,500000,111,218,329
9/21/2013 12:09,12,500000,192,186,378
9/21/2013 12:09,12,500000,1155,181,1336
9/21/2013 12:09,12,500000,147,183,330
9/21/2013 12:09,12,500000,1168,185,1353
9/21/2013 12:09,12,500000,177,189,366
9/21/2013 12:09,12,500000,1159,184,1343
9/21/2013 12:09,12,500000,172,186,358
9/21/2013 12:09,12,500000,1131,186,1317
9/21/2013 12:09,12,500000,184,183,367
9/21/2013 12:09,12,500000,159,180,339
9/21/2013 12:09,12,500000,168,187,355
9/21/2013 12:09,12,500000,1155,225,1380
9/21/2013 12:09,12,500000,155,184,339
9/21/2013 12:09,12,500000,142,224,366
9/21/2013 12:09,12,500000,1107,225,1332
9/21/2013 12:10,12,500000,1139,185,1324
9/21/2013 12:10,12,500000,1094,215,1309
9/21/2013 12:10,12,500000,182,184,366
9/21/2013 12:10,12,500000,1090,222,1312
9/21/2013 12:10,12,500000,178,187,365
9/21/2013 12:10,12,500000,1158,189,1347
9/21/2013 12:10,12,500000,160,185,345
9/21/2013 12:10,12,500000,156,220,376
9/21/2013 12:10,12,500000,186,185,371
9/21/2013 12:10,12,500000,1134,187,1321
9/21/2013 12:10,12,500000,179,185,364
9/21/2013 12:10,12,500000,165,183,348
9/21/2013 12:10,12,500000,188,183,371
9/21/2013 12:10,12,500000,172,270,442
9/21/2013 12:10,12,500000,171,185,356
9/21/2013 12:10,12,500000,127,218,345
9/21/2013 12:10,12,500000,164,226,390
9/21/2013 12:10,12,500000,1106,221,1327
9/21/2013 12:10,12,500000,182,188,370
9/21/2013 12:10,12,500000,143,217,360
9/21/2013 12:11,12,500000,1108,228,1336
9/21/2013 12:11,12,500000,186,186,372
9/21/2013 12:11,12,500000,159,185,344
9/21/2013 12:11,12,500000,1172,182,1354
9/21/2013 12:11,12,500000,195,181,376
9/21/2013 12:11,12,500000,173,183,356
9/21/2013 12:11,12,500000,1171,191,1362
9/21/2013 12:11,12,500000,1151,225,1376
9/21/2013 12:11,12,500000,132,222,354
9/21/2013 12:11,12,500000,1162,185,1347
9/21/2013 12:11,12,500000,148,220,368
9/21/2013 12:11,12,500000,105,218,323
9/21/2013 12:11,12,500000,162,183,345
9/21/2013 12:11,12,500000,121,221,342
9/21/2013 12:11,12,500000,1131,217,1348
9/21/2013 12:11,12,500000,1120,199,1319
9/21/2013 12:11,12,500000,213,189,402
9/21/2013 12:11,12,500000,234,182,416
9/21/2013 12:11,12,500000,164,184,348
9/21/2013 12:11,12,500000,193,184,377
9/21/2013 12:11,12,500000,192,184,376
9/21/2013 12:12,12,500000,152,227,379
9/21/2013 12:12,12,500000,192,186,378
9/21/2013 12:12,12,500000,162,229,391
9/21/2013 12:12,12,500000,181,184,365
9/21/2013 12:12,12,500000,219,185,404
9/21/2013 12:12,12,500000,1204,187,1391
9/21/2013 12:12,12,500000,188,182,370
9/21/2013 12:12,12,500000,180,186,366
9/21/2013 12:12,12,500000,161,186,347
9/21/2013 12:12,12,500000,134,225,359
9/21/2013 12:12,12,500000,145,220,365
9/21/2013 12:12,12,500000,192,185,377
9/21/2013 12:12,12,500000,1139,189,1328
9/21/2013 12:12,12,500000,170,186,356
9/21/2013 12:12,12,500000,1115,223,1338
9/21/2013 12:12,12,500000,171,192,363
9/21/2013 12:12,12,500000,207,184,391
9/21/2013 12:12,12,500000,1157,187,1344
9/21/2013 12:12,12,500000,204,191,395
9/21/2013 12:12,12,500000,141,216,357
9/21/2013 12:12,12,500000,176,187,363
9/21/2013 12:13,12,500000,1161,187,1348
9/21/2013 12:13,12,500000,177,185,362
9/21/2013 12:13,12,500000,1155,187,1342
9/21/2013 12:13,12,600000,181,208,389
9/21/2013 12:13,12,600000,1154,203,1357
9/21/2013 12:13,12,600000,213,200,413
9/21/2013 12:13,12,600000,218,200,418
9/21/2013 12:13,12,600000,188,198,386
9/21/2013 12:13,12,600000,166,202,368
9/21/2013 12:13,12,600000,204,207,411
9/21/2013 12:13,12,600000,175,211,386
9/21/2013 12:13,12,600000,170,208,378
9/21/2013 12:13,12,600000,177,204,381
9/21/2013 12:13,12,600000,171,204,375
9/21/2013 12:13,12,600000,200,203,403
9/21/2013 12:13,12,600000,177,201,378
9/21/2013 12:13,12,600000,209,207,416
9/21/2013 12:13,12,600000,168,208,376
9/21/2013 12:13,12,600000,187,206,393
9/21/2013 12:13,12,600000,178,205,383
9/21/2013 12:13,12,600000,1138,208,1346
9/21/2013 12:13,12,600000,220,205,425
9/21/2013 12:13,12,600000,197,200,397
9/21/2013 12:14,12,600000,198,208,406
9/21/2013 12:14,12,600000,164,203,367
9/21/2013 12:14,12,600000,1144,248,1392
9/21/2013 12:14,12,600000,207,205,412
9/21/2013 12:14,12,600000,165,203,368
9/21/2013 12:14,12,600000,201,205,406
9/21/2013 12:14,12,600000,191,205,396
9/21/2013 12:14,12,600000,1120,247,1367
9/21/2013 12:14,12,600000,169,205,374
9/21/2013 12:14,12,600000,190,206,396
9/21/2013 12:14,12,600000,1142,207,1349
9/21/2013 12:14,12,600000,118,239,357
9/21/2013 12:14,12,600000,172,202,374
9/21/2013 12:14,12,600000,177,239,416
9/21/2013 12:14,12,600000,184,204,388
9/21/2013 12:14,12,600000,170,202,372
9/21/2013 12:14,12,600000,160,207,367
9/21/2013 12:14,12,600000,173,205,378
9/21/2013 12:14,12,600000,171,201,372
9/21/2013 12:14,12,600000,146,206,352
9/21/2013 12:14,12,600000,1118,205,1323
9/21/2013 12:14,12,600000,220,208,428
9/21/2013 12:15,12,600000,1184,207,1391
9/21/2013 12:15,12,600000,222,212,434
9/21/2013 12:15,12,600000,189,203,392
9/21/2013 12:15,12,600000,191,203,394
9/21/2013 12:15,12,600000,171,211,382
9/21/2013 12:15,12,600000,1180,205,1385
9/21/2013 12:15,12,600000,1169,209,1378
9/21/2013 12:15,12,600000,217,204,421
9/21/2013 12:15,12,600000,1146,201,1347
9/21/2013 12:15,12,600000,170,208,378
9/21/2013 12:15,12,600000,184,204,388
9/21/2013 12:15,12,600000,166,198,364
9/21/2013 12:15,12,600000,176,205,381
9/21/2013 12:15,12,600000,1169,206,1375
9/21/2013 12:15,12,600000,189,206,395
9/21/2013 12:15,12,600000,191,200,391
9/21/2013 12:15,12,600000,188,207,395
9/21/2013 12:15,12,600000,1135,203,1338
9/21/2013 12:15,12,600000,176,206,382
9/21/2013 12:15,12,600000,212,206,418
9/21/2013 12:15,12,600000,195,202,397
9/21/2013 12:15,12,600000,203,205,408
9/21/2013 12:16,12,600000,188,203,391
9/21/2013 12:16,12,600000,155,243,398
9/21/2013 12:16,12,600000,170,243,413
9/21/2013 12:16,12,600000,1152,213,1365
9/21/2013 12:16,12,600000,176,203,379
9/21/2013 12:16,12,600000,202,202,404
9/21/2013 12:16,12,600000,206,204,410
9/21/2013 12:16,12,600000,196,209,405
9/21/2013 12:16,12,600000,260,257,517
9/21/2013 12:16,12,600000,1149,202,1351
9/21/2013 12:16,12,600000,215,201,416
9/21/2013 12:16,12,600000,175,202,377
9/21/2013 12:16,12,600000,1140,205,1345
9/21/2013 12:16,12,600000,193,207,400
9/21/2013 12:16,12,600000,1176,206,1382
9/21/2013 12:16,12,600000,193,205,398
9/21/2013 12:16,12,600000,1168,206,1374
9/21/2013 12:16,12,600000,205,207,412
9/21/2013 12:16,12,600000,182,204,386
9/21/2013 12:16,12,600000,219,203,422
9/21/2013 12:16,12,600000,194,206,400
9/21/2013 12:16,12,600000,167,205,372
9/21/2013 12:17,12,600000,1158,209,1367
9/21/2013 12:17,12,600000,186,201,387
9/21/2013 12:17,12,600000,188,201,389
9/21/2013 12:17,12,600000,194,197,391
9/21/2013 12:17,12,600000,197,202,399
9/21/2013 12:17,12,600000,215,208,423
9/21/2013 12:17,12,600000,147,241,388
9/21/2013 12:17,12,600000,201,210,411
9/21/2013 12:17,12,600000,183,212,395
9/21/2013 12:17,12,600000,192,200,392
9/21/2013 12:17,12,600000,192,208,400
9/21/2013 12:17,12,600000,200,199,399
9/21/2013 12:17,12,600000,177,201,378
9/21/2013 12:17,12,600000,203,204,407
9/21/2013 12:17,12,600000,1143,245,1388
9/21/2013 12:17,12,600000,185,200,385
9/21/2013 12:17,12,600000,174,239,413
9/21/2013 12:17,12,600000,181,205,386
9/21/2013 12:17,12,600000,205,206,411
9/21/2013 12:17,12,600000,1173,209,1382
9/21/2013 12:17,12,600000,161,243,404
9/21/2013 12:17,12,600000,187,198,385
9/21/2013 12:17,12,600000,201,206,407
9/21/2013 12:17,12,600000,234,208,442
9/21/2013 12:18,12,600000,203,212,415
9/21/2013 12:18,12,600000,190,209,399
9/21/2013 12:18,12,600000,192,204,396
9/21/2013 12:18,12,600000,168,205,373
9/21/2013 12:18,12,600000,1149,211,1360
9/21/2013 12:18,12,700000,220,232,452
9/21/2013 12:18,12,700000,176,239,415
9/21/2013 12:18,12,700000,171,234,405
9/21/2013 12:18,12,700000,209,241,450
9/21/2013 12:18,12,700000,195,233,428
9/21/2013 12:18,12,700000,173,234,407
9/21/2013 12:18,12,700000,194,234,428
9/21/2013 12:18,12,700000,188,231,419
9/21/2013 12:18,12,700000,175,239,414
9/21/2013 12:18,12,700000,182,233,415
9/21/2013 12:18,12,700000,171,235,406
9/21/2013 12:18,12,700000,181,235,416
9/21/2013 12:18,12,700000,198,231,429
9/21/2013 12:18,12,700000,199,236,435
9/21/2013 12:18,12,700000,221,242,463
9/21/2013 12:18,12,700000,205,235,440
9/21/2013 12:18,12,700000,1164,234,1398
9/21/2013 12:18,12,700000,232,233,465
9/21/2013 12:19,12,700000,237,233,470
9/21/2013 12:19,12,700000,191,239,430
9/21/2013 12:19,12,700000,202,230,432
9/21/2013 12:19,12,700000,203,237,440
9/21/2013 12:19,12,700000,190,232,422
9/21/2013 12:19,12,700000,211,234,445
9/21/2013 12:19,12,700000,205,234,439
9/21/2013 12:19,12,700000,1140,234,1374
9/21/2013 12:19,12,700000,215,235,450
9/21/2013 12:19,12,700000,163,236,399
9/21/2013 12:19,12,700000,1146,239,1385
9/21/2013 12:19,12,700000,1198,237,1435
9/21/2013 12:19,12,700000,192,238,430
9/21/2013 12:19,12,700000,1126,239,1365
9/21/2013 12:19,12,700000,177,235,412
9/21/2013 12:19,12,700000,210,234,444
9/21/2013 12:19,12,700000,187,233,420
9/21/2013 12:19,12,700000,245,238,483
9/21/2013 12:19,12,700000,173,237,410
9/21/2013 12:19,12,700000,218,234,452
9/21/2013 12:19,12,700000,193,234,427
9/21/2013 12:20,12,700000,195,235,430
9/21/2013 12:20,12,700000,211,234,445
9/21/2013 12:20,12,700000,202,232,434
9/21/2013 12:20,12,700000,204,229,433
9/21/2013 12:20,12,700000,204,234,438
9/21/2013 12:20,12,700000,191,236,427
9/21/2013 12:20,12,700000,201,233,434
9/21/2013 12:20,12,700000,217,233,450
9/21/2013 12:20,12,700000,236,232,468
9/21/2013 12:20,12,700000,198,239,437
9/21/2013 12:20,12,700000,1153,240,1393
9/21/2013 12:20,12,700000,181,231,412
9/21/2013 12:20,12,700000,1115,235,1350
9/21/2013 12:20,12,700000,194,233,427
9/21/2013 12:20,12,700000,186,242,428
9/21/2013 12:20,12,700000,208,233,441
9/21/2013 12:20,12,700000,177,238,415
9/21/2013 12:20,12,700000,198,234,432
9/21/2013 12:20,12,700000,192,230,422
9/21/2013 12:20,12,700000,259,244,503
9/21/2013 12:20,12,700000,192,234,426
9/21/2013 12:20,12,700000,187,235,422
9/21/2013 12:21,12,700000,173,232,405
9/21/2013 12:21,12,700000,195,234,429
9/21/2013 12:21,12,700000,173,236,409
9/21/2013 12:21,12,700000,214,235,449
9/21/2013 12:21,12,700000,225,230,455
9/21/2013 12:21,12,700000,208,244,452
9/21/2013 12:21,12,700000,202,235,437
9/21/2013 12:21,12,700000,1142,237,1379
9/21/2013 12:21,12,700000,165,238,403
9/21/2013 12:21,12,700000,178,239,417
9/21/2013 12:21,12,700000,246,238,484
9/21/2013 12:21,12,700000,183,234,417
9/21/2013 12:21,12,700000,199,231,430
9/21/2013 12:21,12,700000,203,235,438
9/21/2013 12:21,12,700000,193,231,424
9/21/2013 12:21,12,700000,220,235,455
9/21/2013 12:21,12,700000,195,234,429
9/21/2013 12:21,12,700000,1209,244,1453
9/21/2013 12:21,12,700000,1169,242,1411
9/21/2013 12:21,12,700000,1174,242,1416
9/21/2013 12:21,12,700000,196,239,435
9/21/2013 12:21,12,700000,1161,239,1400
9/21/2013 12:22,12,700000,220,231,451
9/21/2013 12:22,12,700000,191,233,424
9/21/2013 12:22,12,700000,200,236,436
9/21/2013 12:22,12,700000,197,236,433
9/21/2013 12:22,12,700000,192,232,424
9/21/2013 12:22,12,700000,198,235,433
9/21/2013 12:22,12,700000,174,231,405
9/21/2013 12:22,12,700000,185,236,421
9/21/2013 12:22,12,700000,219,235,454
9/21/2013 12:22,12,700000,217,231,448
9/21/2013 12:22,12,700000,166,240,406
9/21/2013 12:22,12,700000,198,240,438
9/21/2013 12:22,12,700000,232,228,460
9/21/2013 12:22,12,700000,238,234,472
9/21/2013 12:22,12,700000,1145,235,1380
9/21/2013 12:22,12,700000,225,238,463
9/21/2013 12:22,12,700000,198,234,432
9/21/2013 12:22,12,700000,225,235,460
9/21/2013 12:22,12,700000,1152,245,1397
9/21/2013 12:22,12,700000,221,232,453
9/21/2013 12:22,12,700000,195,235,430
9/21/2013 12:22,12,700000,208,240,448
9/21/2013 12:23,12,700000,190,233,423
9/21/2013 12:23,12,700000,200,233,433
9/21/2013 12:23,12,700000,180,233,413
9/21/2013 12:23,12,700000,1137,234,1371
9/21/2013 12:23,12,700000,1154,241,1395
9/21/2013 12:23,12,700000,178,254,432
9/21/2013 12:23,12,700000,184,233,417
9/21/2013 12:23,12,700000,177,235,412
9/21/2013 12:23,12,700000,206,231,437
9/21/2013 12:23,12,700000,212,240,452
9/21/2013 12:23,12,800000,178,269,447
9/21/2013 12:23,12,800000,198,260,458
9/21/2013 12:23,12,800000,220,264,484
9/21/2013 12:23,12,800000,188,267,455
9/21/2013 12:23,12,800000,218,267,485
9/21/2013 12:23,12,800000,1150,270,1420
9/21/2013 12:23,12,800000,1241,271,1512
9/21/2013 12:23,12,800000,268,269,537
9/21/2013 12:23,12,800000,201,266,467
9/21/2013 12:23,12,800000,222,266,488
9/21/2013 12:23,12,800000,180,265,445
9/21/2013 12:23,12,800000,254,274,528
9/21/2013 12:24,12,800000,229,279,508
9/21/2013 12:24,12,800000,175,266,441
9/21/2013 12:24,12,800000,184,268,452
9/21/2013 12:24,12,800000,194,268,462
9/21/2013 12:24,12,800000,270,271,541
9/21/2013 12:24,12,800000,204,268,472
9/21/2013 12:24,12,800000,184,268,452
9/21/2013 12:24,12,800000,196,265,461
9/21/2013 12:24,12,800000,224,266,490
9/21/2013 12:24,12,800000,1190,272,1462
9/21/2013 12:24,12,800000,236,275,511
9/21/2013 12:24,12,800000,252,265,517
9/21/2013 12:24,12,800000,222,272,494
9/21/2013 12:24,12,800000,201,261,462
9/21/2013 12:24,12,800000,246,269,515
9/21/2013 12:24,12,800000,192,266,458
9/21/2013 12:24,12,800000,215,266,481
9/21/2013 12:24,12,800000,209,269,478
9/21/2013 12:24,12,800000,272,270,542
9/21/2013 12:24,12,800000,197,268,465
9/21/2013 12:24,12,800000,1170,267,1437
9/21/2013 12:24,12,800000,204,264,468
9/21/2013 12:24,12,800000,178,268,446
9/21/2013 12:25,12,800000,1215,271,1486
9/21/2013 12:25,12,800000,198,273,471
9/21/2013 12:25,12,800000,252,271,523
9/21/2013 12:25,12,800000,199,265,464
9/21/2013 12:25,12,800000,251,268,519
9/21/2013 12:25,12,800000,227,264,491
9/21/2013 12:25,12,800000,259,266,525
9/21/2013 12:25,12,800000,190,269,459
9/21/2013 12:25,12,800000,236,272,508
9/21/2013 12:25,12,800000,1184,269,1453
9/21/2013 12:25,12,800000,196,264,460
9/21/2013 12:25,12,800000,185,269,454
9/21/2013 12:25,12,800000,204,266,470
9/21/2013 12:25,12,800000,179,268,447
9/21/2013 12:25,12,800000,185,273,458
9/21/2013 12:25,12,800000,232,263,495
9/21/2013 12:25,12,800000,215,269,484
9/21/2013 12:25,12,800000,199,267,466
9/21/2013 12:25,12,800000,189,267,456
9/21/2013 12:25,12,800000,238,272,510
9/21/2013 12:25,12,800000,239,270,509
9/21/2013 12:25,12,800000,221,273,494
9/21/2013 12:26,12,800000,202,264,466
9/21/2013 12:26,12,800000,245,269,514
9/21/2013 12:26,12,800000,185,266,451
9/21/2013 12:26,12,800000,1158,271,1429
9/21/2013 12:26,12,800000,250,272,522
9/21/2013 12:26,12,800000,185,267,452
9/21/2013 12:26,12,800000,241,271,512
9/21/2013 12:26,12,800000,216,270,486
9/21/2013 12:26,12,800000,217,265,482
9/21/2013 12:26,12,800000,238,265,503
9/21/2013 12:26,12,800000,1160,273,1433
9/21/2013 12:26,12,800000,235,267,502
9/21/2013 12:26,12,800000,200,270,470
9/21/2013 12:26,12,800000,1171,272,1443
9/21/2013 12:26,12,800000,173,263,436
9/21/2013 12:26,12,800000,1167,268,1435
9/21/2013 12:26,12,800000,1151,273,1424
9/21/2013 12:26,12,800000,1161,270,1431
9/21/2013 12:26,12,800000,222,270,492
9/21/2013 12:26,12,800000,227,269,496
9/21/2013 12:26,12,800000,206,266,472
9/21/2013 12:27,12,800000,1178,273,1451
9/21/2013 12:27,12,800000,225,267,492
9/21/2013 12:27,12,800000,214,269,483
9/21/2013 12:27,12,800000,231,269,500
9/21/2013 12:27,12,800000,197,262,459
9/21/2013 12:27,12,800000,228,263,491
9/21/2013 12:27,12,800000,208,266,474
9/21/2013 12:27,12,800000,238,271,509
9/21/2013 12:27,12,800000,178,270,448
9/21/2013 12:27,12,800000,179,268,447
9/21/2013 12:27,12,800000,222,275,497
9/21/2013 12:27,12,800000,222,269,491
9/21/2013 12:27,12,800000,197,269,466
9/21/2013 12:27,12,800000,215,266,481
9/21/2013 12:27,12,800000,215,310,525
9/21/2013 12:27,12,800000,249,270,519
9/21/2013 12:27,12,800000,247,271,518
9/21/2013 12:27,12,800000,200,275,475
9/21/2013 12:27,12,800000,227,273,500
9/21/2013 12:27,12,800000,212,269,481
9/21/2013 12:27,12,800000,1156,271,1427
9/21/2013 12:27,12,800000,1151,270,1421
9/21/2013 12:28,12,800000,274,266,540
9/21/2013 12:28,12,800000,241,269,510
9/21/2013 12:28,12,800000,223,267,490
9/21/2013 12:28,12,800000,191,262,453
9/21/2013 12:28,12,800000,237,269,506
9/21/2013 12:28,12,800000,254,271,525
9/21/2013 12:28,12,800000,195,264,459
9/21/2013 12:28,12,800000,1213,273,1486
9/21/2013 12:28,12,800000,203,270,473
9/21/2013 12:28,12,800000,195,265,460
9/21/2013 12:28,12,800000,187,267,454
9/21/2013 12:28,12,800000,207,272,479
9/21/2013 12:28,12,800000,205,269,474
9/21/2013 12:28,12,800000,208,278,486
9/21/2013 12:28,12,800000,203,268,471
9/21/2013 12:28,12,900000,222,276,498
9/21/2013 12:28,12,900000,255,284,539
9/21/2013 12:28,12,900000,248,289,537
9/21/2013 12:28,12,900000,224,281,505
9/21/2013 12:28,12,900000,1175,282,1457
9/21/2013 12:28,12,900000,228,284,512
9/21/2013 12:29,12,900000,223,281,504
9/21/2013 12:29,12,900000,203,280,483
9/21/2013 12:29,12,900000,258,287,545
9/21/2013 12:29,12,900000,1143,282,1425
9/21/2013 12:29,12,900000,211,295,506
9/21/2013 12:29,12,900000,219,277,496
9/21/2013 12:29,12,900000,255,286,541
9/21/2013 12:29,12,900000,197,283,480
9/21/2013 12:29,12,900000,210,285,495
9/21/2013 12:29,12,900000,194,285,479
9/21/2013 12:29,12,900000,204,284,488
9/21/2013 12:29,12,900000,1152,282,1434
9/21/2013 12:29,12,900000,1175,281,1456
9/21/2013 12:29,12,900000,1161,282,1443
9/21/2013 12:29,12,900000,217,287,504
9/21/2013 12:29,12,900000,222,286,508
9/21/2013 12:29,12,900000,207,283,490
9/21/2013 12:29,12,900000,214,281,495
9/21/2013 12:29,12,900000,1235,282,1517
9/21/2013 12:29,12,900000,1125,286,1411
9/21/2013 12:30,12,900000,220,282,502
9/21/2013 12:30,12,900000,1176,282,1458
9/21/2013 12:30,12,900000,208,284,492
9/21/2013 12:30,12,900000,208,287,495
9/21/2013 12:30,12,900000,235,279,514
9/21/2013 12:30,12,900000,1147,288,1435
9/21/2013 12:30,12,900000,281,281,562
9/21/2013 12:30,12,900000,1182,283,1465
9/21/2013 12:30,12,900000,197,285,482
9/21/2013 12:30,12,900000,221,285,506
9/21/2013 12:30,12,900000,197,284,481
9/21/2013 12:30,12,900000,209,279,488
9/21/2013 12:30,12,900000,1174,288,1462
9/21/2013 12:30,12,900000,1188,284,1472
9/21/2013 12:30,12,900000,206,298,504
9/21/2013 12:30,12,900000,1166,289,1455
9/21/2013 12:30,12,900000,243,285,528
9/21/2013 12:30,12,900000,205,293,498
9/21/2013 12:30,12,900000,1169,291,1460
9/21/2013 12:31,12,900000,202,284,486
9/21/2013 12:31,12,900000,206,278,484
9/21/2013 12:31,12,900000,236,283,519
9/21/2013 12:31,12,900000,1154,287,1441
9/21/2013 12:31,12,900000,1144,291,1435
9/21/2013 12:31,12,900000,1156,281,1437
9/21/2013 12:31,12,900000,254,288,542
9/21/2013 12:31,12,900000,1193,279,1472
9/21/2013 12:31,12,900000,1175,281,1456
9/21/2013 12:31,12,900000,232,286,518
9/21/2013 12:31,12,900000,226,281,507
9/21/2013 12:31,12,900000,215,283,498
9/21/2013 12:31,12,900000,244,281,525
9/21/2013 12:31,12,900000,202,283,485
9/21/2013 12:31,12,900000,187,291,478
9/21/2013 12:31,12,900000,246,287,533
9/21/2013 12:31,12,900000,181,283,464
9/21/2013 12:31,12,900000,195,286,481
9/21/2013 12:31,12,900000,204,295,499
9/21/2013 12:32,12,900000,1176,296,1472
9/21/2013 12:32,12,900000,199,283,482
9/21/2013 12:32,12,900000,260,283,543
9/21/2013 12:32,12,900000,211,283,494
9/21/2013 12:32,12,900000,194,283,477
9/21/2013 12:32,12,900000,253,283,536
9/21/2013 12:32,12,900000,219,279,498
9/21/2013 12:32,12,900000,229,287,516
9/21/2013 12:32,12,900000,1146,296,1442
9/21/2013 12:32,12,900000,1175,282,1457
9/21/2013 12:32,12,900000,216,286,502
9/21/2013 12:32,12,900000,217,279,496
9/21/2013 12:32,12,900000,201,280,481
9/21/2013 12:32,12,900000,225,283,508
9/21/2013 12:32,12,900000,1155,285,1440
9/21/2013 12:32,12,900000,262,285,547
9/21/2013 12:32,12,900000,214,286,500
9/21/2013 12:32,12,900000,217,292,509
9/21/2013 12:32,12,900000,270,282,552
9/21/2013 12:32,12,900000,210,282,492
9/21/2013 12:32,12,900000,214,281,495
9/21/2013 12:33,12,900000,208,283,491
9/21/2013 12:33,12,900000,224,282,506
9/21/2013 12:33,12,900000,1132,323,1455
9/21/2013 12:33,12,900000,196,283,479
9/21/2013 12:33,12,900000,207,281,488
9/21/2013 12:33,12,900000,255,281,536
9/21/2013 12:33,12,900000,204,306,510
9/21/2013 12:33,12,900000,1147,299,1446
9/21/2013 12:33,12,900000,250,286,536
9/21/2013 12:33,12,900000,179,282,461
9/21/2013 12:33,12,900000,1150,300,1450
9/21/2013 12:33,12,900000,1162,290,1452
9/21/2013 12:33,12,900000,208,285,493
9/21/2013 12:33,12,900000,200,282,482
9/21/2013 12:33,12,900000,249,282,531
9/21/2013 12:33,12,900000,228,284,512
9/21/2013 12:33,12,900000,219,281,500
9/21/2013 12:33,12,900000,216,289,505
9/21/2013 12:33,12,900000,216,279,495
9/21/2013 12:33,12,900000,1184,283,1467
9/21/2013 12:33,12,900000,234,281,515
9/21/2013 12:34,12,900000,1159,284,1443
9/21/2013 12:34,12,900000,203,285,488
9/21/2013 12:34,12,900000,259,284,543
9/21/2013 12:34,12,900000,1169,277,1446
9/21/2013 12:34,12,900000,203,289,492
9/21/2013 12:34,12,900000,1179,279,1458
9/21/2013 12:34,12,900000,192,292,484
9/21/2013 12:35,12,900000,6264,282,6546
9/21/2013 12:35,12,900000,197,286,483
9/21/2013 12:35,12,1000000,1157,324,1481
9/21/2013 12:35,12,1000000,187,327,514
9/21/2013 12:35,12,1000000,237,325,562
9/21/2013 12:36,12,1000000,18699,327,19026
9/21/2013 12:36,12,1000000,193,320,513
9/21/2013 12:36,12,1000000,195,320,515
9/21/2013 12:36,12,1000000,1174,324,1498
9/21/2013 12:36,12,1000000,222,321,543
9/21/2013 12:36,12,1000000,12308,331,12639
9/21/2013 12:36,12,1000000,219,323,542
9/21/2013 12:37,12,1000000,212,325,537
9/21/2013 12:37,12,1000000,1227,323,1550
9/21/2013 12:37,12,1000000,213,318,531
9/21/2013 12:37,12,1000000,6004,320,6324
9/21/2013 12:37,12,1000000,190,332,522
9/21/2013 12:37,12,1000000,258,314,572
9/21/2013 12:37,12,1000000,188,321,509
9/21/2013 12:37,12,1000000,1183,320,1503
9/21/2013 12:37,12,1000000,224,323,547
9/21/2013 12:37,12,1000000,1184,341,1525
9/21/2013 12:37,12,1000000,230,326,556
9/21/2013 12:38,12,1000000,1206,327,1533
9/21/2013 12:38,12,1000000,252,322,574
9/21/2013 12:38,12,1000000,210,325,535
9/21/2013 12:38,12,1000000,254,392,646
9/21/2013 12:38,12,1000000,1157,328,1485
9/21/2013 12:38,12,1000000,1173,324,1497
9/21/2013 12:38,12,1000000,246,328,574
9/21/2013 12:38,12,1000000,1146,326,1472
9/21/2013 12:38,12,1000000,190,322,512
9/21/2013 12:39,12,1000000,206,320,526
9/21/2013 12:39,12,1000000,215,321,536
9/21/2013 12:39,12,1000000,205,330,535
9/21/2013 12:39,12,1000000,1170,329,1499
9/21/2013 12:39,12,1000000,311,330,641
9/21/2013 12:40,12,1000000,225,323,548
9/21/2013 12:40,12,1000000,17224,322,17546
9/21/2013 12:40,12,1000000,213,322,535
9/21/2013 12:41,12,1000000,204,335,539
9/21/2013 12:41,12,1000000,267,339,606
9/21/2013 12:41,12,1000000,247,332,579
9/21/2013 12:41,12,1000000,214,325,539
9/21/2013 12:41,12,1000000,1163,323,1486
9/21/2013 12:42,12,1000000,281,350,631
9/21/2013 12:42,12,1000000,248,329,577
9/21/2013 12:42,12,1000000,1174,333,1507
9/21/2013 12:42,12,1000000,6137,331,6468
9/21/2013 12:42,12,1000000,7817,333,8150
9/21/2013 12:42,12,1000000,253,322,575
9/21/2013 12:42,12,1000000,1152,325,1477
9/21/2013 12:43,12,1000000,1155,328,1483
9/21/2013 12:44,12,1000000,240,330,570
9/21/2013 12:44,12,1000000,200,335,535
9/21/2013 12:44,12,1000000,257,334,591
9/21/2013 12:45,12,1000000,211,319,530
9/21/2013 12:45,12,1000000,8096,328,8424
9/21/2013 12:46,12,1000000,208,320,528
9/21/2013 12:46,12,1000000,221,322,543
9/21/2013 12:46,12,1000000,192,331,523
9/21/2013 12:46,12,1000000,225,329,554
9/21/2013 12:46,12,1000000,240,332,572
9/21/2013 12:46,12,1000000,189,328,517
9/21/2013 12:47,12,1000000,225,330,555
9/21/2013 12:47,12,1000000,259,322,581
9/21/2013 12:47,12,1000000,6393,328,6721
9/21/2013 12:47,12,1000000,223,331,554
9/21/2013 12:47,12,1000000,224,331,555
9/21/2013 12:47,12,1000000,1177,321,1498
9/21/2013 12:47,12,1000000,211,329,540
9/21/2013 12:47,12,1000000,231,321,552
9/21/2013 12:47,12,1000000,230,315,545
9/21/2013 12:48,12,1000000,212,315,527
9/21/2013 12:48,12,1000000,240,319,559
9/21/2013 12:48,12,1000000,11624,327,11951
9/21/2013 12:48,12,1000000,200,329,529
9/21/2013 12:48,12,1000000,205,330,535
9/21/2013 12:48,12,1000000,1147,323,1470
9/21/2013 12:49,12,1000000,257,325,582
9/21/2013 12:54,12,1000000,320750,312,321062
9/21/2013 12:56,12,1000000,127255,327,127582
9/21/2013 12:56,12,1000000,1134,318,1452
9/21/2013 12:56,12,1000000,229,328,557
9/21/2013 12:56,12,1000000,237,319,556
9/21/2013 12:56,12,1000000,194,327,521
9/21/2013 12:56,12,1000000,242,327,569
9/21/2013 12:56,12,1000000,182,324,506
9/21/2013 12:56,12,1000000,199,326,525
9/21/2013 12:56,12,1000000,226,326,552
9/21/2013 12:57,12,1000000,216,327,543
9/21/2013 12:57,12,1000000,211,324,535
9/21/2013 12:57,12,1000000,192,328,520
9/21/2013 12:57,12,1000000,267,321,588
9/21/2013 12:57,12,1000000,195,319,514
9/21/2013 12:57,12,1000000,1210,320,1530
9/21/2013 12:57,12,1000000,213,324,537
9/21/2013 12:57,12,1000000,210,326,536
9/21/2013 12:57,12,1000000,199,321,520
9/21/2013 12:57,12,1000000,1141,319,1460
9/21/2013 12:57,12,1000000,184,320,504
9/21/2013 12:57,12,1000000,207,328,535
9/21/2013 12:57,12,1000000,205,324,529
9/21/2013 12:57,12,1000000,1134,328,1462
9/21/2013 12:57,12,1000000,211,331,542
9/21/2013 12:58,12,1000000,1187,326,1513
9/21/2013 12:58,12,1000000,213,329,542
9/21/2013 12:58,12,1000000,1182,332,1514
9/21/2013 12:58,12,1000000,238,333,571
9/21/2013 12:58,12,1000000,190,317,507
9/21/2013 12:58,12,1000000,245,318,563
9/21/2013 12:58,12,1000000,209,324,533
9/21/2013 12:58,12,1000000,217,331,548
9/21/2013 12:58,12,1000000,240,325,565
9/21/2013 12:58,12,1000000,194,327,521
9/21/2013 12:58,12,1000000,8493,320,8813
9/21/2013 12:58,12,1000000,200,320,520
9/21/2013 12:58,12,1000000,234,328,562
9/21/2013 12:58,12,1000000,200,324,524
9/21/2013 12:59,12,1000000,7470,317,7787
9/21/2013 12:59,12,1000000,204,322,526
9/21/2013 12:59,12,1000000,220,331,551
9/21/2013 12:59,12,1000000,251,332,583
9/21/2013 12:59,12,1000000,1151,327,1478
9/21/2013 12:59,12,1000000,254,327,581
9/21/2013 12:59,12,1000000,1170,321,1491
9/21/2013 12:59,12,1000000,1101,323,1424
9/21/2013 12:59,12,1000000,214,317,531
9/21/2013 12:59,12,1000000,1196,330,1526
9/21/2013 12:59,12,1000000,177,320,497
9/21/2013 1:00,12,1000000,1140,325,1465
9/21/2013 1:00,12,1000000,1151,321,1472
9/21/2013 1:00,12,1000000,1121,332,1453
9/21/2013 1:00,12,1000000,238,325,563
9/21/2013 1:00,12,1000000,216,325,541
9/21/2013 1:00,12,1000000,176,328,504
9/21/2013 1:00,12,1000000,1165,324,1489
9/21/2013 1:00,12,1000000,1198,328,1526
9/21/2013 1:00,12,1000000,208,329,537
9/21/2013 1:00,12,1000000,1192,321,1513
9/21/2013 1:00,12,1000000,1165,324,1489
9/21/2013 1:00,12,1000000,222,321,543
9/21/2013 1:01,12,1000000,1174,332,1506
9/21/2013 1:01,12,1000000,1212,320,1532
9/21/2013 1:01,12,1000000,180,322,502
9/21/2013 1:01,12,1000000,216,327,543
9/21/2013 1:01,12,1000000,1155,326,1481
9/21/2013 1:01,12,1000000,191,317,508
9/21/2013 1:01,12,1000000,216,329,545
9/21/2013 1:01,12,1000000,202,319,521
9/21/2013 1:01,12,1000000,257,327,584
9/21/2013 1:01,12,1000000,201,324,525
9/21/2013 1:01,12,1000000,217,324,541
9/21/2013 1:01,12,1000000,1157,326,1483
9/21/2013 1:01,12,1000000,205,329,534
9/21/2013 1:01,12,1000000,1152,317,1469
9/21/2013 1:01,12,1000000,210,323,533
9/21/2013 1:01,12,1000000,214,326,540
9/21/2013 1:01,12,1000000,1176,319,1495
9/21/2013 1:01,12,1000000,192,324,516
9/21/2013 1:01,12,1000000,212,322,534
9/21/2013 1:02,12,1000000,205,327,532
9/21/2013 1:02,12,1000000,1160,330,1490
9/21/2013 1:02,12,1000000,210,326,536
9/21/2013 1:02,12,1000000,195,325,520
9/21/2013 1:02,12,1000000,241,324,565
9/21/2013 1:02,12,1000000,202,328,530
9/21/2013 1:02,12,1000000,216,328,544
9/21/2013 1:02,12,1000000,193,326,519
9/21/2013 1:02,12,1000000,191,332,523
9/21/2013 1:02,12,1000000,244,319,563
9/21/2013 1:02,12,1000000,1146,323,1469
9/21/2013 1:02,12,1000000,1174,336,1510
9/21/2013 1:02,12,1000000,229,321,550
9/21/2013 1:02,12,1000000,267,323,590
9/21/2013 1:02,12,1000000,1206,323,1529
9/21/2013 1:02,12,1000000,190,319,509
9/21/2013 1:02,12,1000000,218,325,543
9/21/2013 1:02,12,1000000,1178,322,1500
9/21/2013 1:02,12,1000000,180,315,495
9/21/2013 1:03,12,1000000,212,319,531
9/21/2013 1:03,12,1000000,188,320,508
9/21/2013 1:03,12,1000000,217,324,541
9/21/2013 1:03,12,1000000,189,331,520
9/21/2013 1:03,12,1000000,228,330,558
9/21/2013 1:03,12,1000000,192,321,513
9/21/2013 1:03,12,1000000,1164,327,1491
9/21/2013 1:03,12,1000000,202,321,523
9/21/2013 1:03,12,1000000,206,327,533
9/21/2013 1:03,12,1000000,204,324,528
9/21/2013 1:03,12,1000000,1194,327,1521
9/21/2013 1:03,12,1000000,227,324,551
9/21/2013 1:03,12,1000000,266,324,590
9/21/2013 1:03,12,1000000,1204,325,1529
9/21/2013 1:03,12,1000000,1148,323,1471
9/21/2013 1:03,12,1000000,244,319,563
9/21/2013 1:03,12,1000000,209,323,532
9/21/2013 1:03,12,1000000,1143,332,1475
9/21/2013 1:03,12,1000000,1196,323,1519
9/21/2013 1:04,12,1000000,1151,325,1476
9/21/2013 1:04,12,1000000,1204,320,1524
9/21/2013 1:04,12,1000000,1135,326,1461
9/21/2013 1:04,12,1000000,200,323,523
9/21/2013 1:04,12,1000000,194,319,513
9/21/2013 1:04,12,1000000,243,326,569
9/21/2013 1:04,12,1000000,1159,323,1482
9/21/2013 1:04,12,1000000,213,321,534
9/21/2013 1:04,12,1000000,206,320,526
9/21/2013 1:04,12,1000000,313,322,635
9/21/2013 1:04,12,1000000,187,324,511
9/21/2013 1:04,12,1000000,188,318,506
9/21/2013 1:04,12,1000000,211,326,537
9/21/2013 1:04,12,1000000,189,325,514
9/21/2013 1:04,12,1000000,200,320,520
9/21/2013 1:04,12,1000000,246,321,567
9/21/2013 1:04,12,1000000,1150,323,1473
9/21/2013 1:04,12,1000000,216,328,544
9/21/2013 1:04,12,1000000,230,328,558
9/21/2013 1:05,12,1000000,190,320,510
9/21/2013 1:05,12,1000000,225,328,553
9/21/2013 1:05,12,1000000,212,326,538
9/21/2013 1:05,12,1000000,1163,324,1487
9/21/2013 1:05,12,1000000,1141,325,1466
9/21/2013 1:05,12,1000000,1184,325,1509
9/21/2013 1:05,12,1000000,1209,323,1532
9/21/2013 1:05,12,1000000,1163,324,1487
9/21/2013 1:05,12,1000000,212,319,531
9/21/2013 1:05,12,1000000,1160,318,1478
9/21/2013 1:05,12,1000000,1211,322,1533
9/21/2013 1:05,12,1000000,1216,317,1533
9/21/2013 1:05,12,1000000,1167,320,1487
9/21/2013 1:05,12,1000000,1150,326,1476
9/21/2013 1:05,12,2000000,343,549,892
9/21/2013 1:05,12,2000000,352,591,943
9/21/2013 1:05,12,2000000,356,550,906
9/21/2013 1:06,12,2000000,359,592,951
9/21/2013 1:06,12,2000000,320,564,884
9/21/2013 1:06,12,2000000,342,599,941
9/21/2013 1:06,12,2000000,353,577,930
9/21/2013 1:06,12,2000000,328,566,894
9/21/2013 1:06,12,2000000,336,595,931
9/21/2013 1:08,12,2000000,328,570,898
9/21/2013 1:08,12,2000000,342,589,931
9/21/2013 1:08,12,2000000,342,571,913
9/21/2013 1:08,12,2000000,333,562,895
9/21/2013 1:08,12,2000000,1242,562,1804
9/21/2013 1:08,12,2000000,332,582,914
9/21/2013 1:08,12,2000000,320,590,910
9/21/2013 1:08,12,2000000,330,551,881
9/21/2013 1:08,12,2000000,1281,611,1892
9/21/2013 1:08,12,2000000,1306,598,1904
9/21/2013 1:08,12,2000000,336,543,879
9/21/2013 1:08,12,2000000,387,570,957
9/21/2013 1:08,12,2000000,1258,547,1805
9/21/2013 1:08,12,2000000,316,587,903
9/21/2013 1:08,12,2000000,307,587,894
9/21/2013 1:08,12,2000000,316,592,908
9/21/2013 1:09,12,2000000,9815,590,10405
9/21/2013 1:09,12,2000000,1224,543,1767
9/21/2013 1:09,12,2000000,317,593,910
9/21/2013 1:09,12,2000000,1256,559,1815
9/21/2013 1:09,12,2000000,1278,562,1840
9/21/2013 1:09,12,2000000,334,589,923
9/21/2013 1:09,12,2000000,1237,590,1827
9/21/2013 1:09,12,2000000,1226,588,1814
9/21/2013 1:10,12,2000000,340,579,919
9/21/2013 1:10,12,2000000,1218,574,1792
9/21/2013 1:10,12,2000000,353,585,938
9/21/2013 1:10,12,2000000,379,550,929
9/21/2013 1:10,12,2000000,20739,585,21324
9/21/2013 1:10,12,2000000,358,571,929
9/21/2013 1:10,12,2000000,355,595,950
9/21/2013 1:11,12,2000000,354,564,918
9/21/2013 1:11,12,2000000,1268,601,1869
9/21/2013 1:12,12,2000000,289,565,854
9/21/2013 1:12,12,2000000,1267,575,1842
9/21/2013 1:12,12,2000000,360,566,926
9/21/2013 1:12,12,2000000,372,584,956
9/21/2013 1:12,12,2000000,346,554,900
9/21/2013 1:12,12,2000000,884,573,1457
9/21/2013 1:12,12,2000000,1219,585,1804
9/21/2013 1:13,12,2000000,1212,558,1770
9/21/2013 1:13,12,2000000,374,569,943
9/21/2013 1:13,12,2000000,345,574,919
9/21/2013 1:13,12,2000000,10198,561,10759
9/21/2013 1:13,12,2000000,355,568,923
9/21/2013 1:13,12,2000000,1217,572,1789
9/21/2013 1:13,12,2000000,1215,556,1771
9/21/2013 1:13,12,2000000,1271,586,1857
9/21/2013 1:13,12,2000000,1302,566,1868
9/21/2013 1:14,12,2000000,1291,590,1881
9/21/2013 1:30,12,2000000,342,596,938
9/21/2013 1:31,12,2000000,1272,598,1870
9/21/2013 1:31,12,2000000,359,579,938
9/21/2013 1:31,12,2000000,1269,597,1866
9/21/2013 1:31,12,2000000,349,547,896
9/21/2013 1:31,12,2000000,305,586,891
9/21/2013 1:31,12,2000000,346,545,891
9/21/2013 1:31,12,2000000,318,596,914
9/21/2013 1:31,12,2000000,1224,553,1777
9/21/2013 1:31,12,2000000,349,584,933
9/21/2013 1:31,12,2000000,1332,561,1893
9/21/2013 1:31,12,2000000,1303,586,1889
9/21/2013 1:31,12,2000000,372,582,954
9/21/2013 1:31,12,2000000,314,584,898
9/21/2013 1:31,12,2000000,1229,608,1837
9/21/2013 1:31,12,2000000,337,590,927
9/21/2013 1:32,12,2000000,1285,546,1831
9/21/2013 1:32,12,2000000,1243,555,1798
9/21/2013 1:32,12,2000000,316,586,902
9/21/2013 1:32,12,2000000,365,543,908
9/21/2013 1:32,12,2000000,311,556,867
9/21/2013 1:32,12,2000000,1306,563,1869
9/21/2013 1:32,12,2000000,1233,556,1789
9/21/2013 1:32,12,2000000,335,590,925
9/21/2013 1:32,12,2000000,322,565,887
9/21/2013 1:32,12,2000000,372,585,957
9/21/2013 1:32,12,2000000,371,583,954
9/21/2013 1:32,12,2000000,372,579,951
9/21/2013 1:32,12,2000000,345,557,902
9/21/2013 1:32,12,2000000,338,559,897
9/21/2013 1:33,12,2000000,381,564,945
9/21/2013 1:33,12,2000000,324,603,927
9/21/2013 1:33,12,2000000,1286,575,1861
9/21/2013 1:33,12,2000000,348,595,943
9/21/2013 1:33,12,2000000,333,584,917
9/21/2013 1:33,12,2000000,1298,571,1869
9/21/2013 1:33,12,2000000,332,546,878
9/21/2013 1:33,12,2000000,337,543,880
9/21/2013 1:33,12,2000000,296,562,858
9/21/2013 1:33,12,2000000,327,574,901
9/21/2013 1:33,12,2000000,337,580,917
9/21/2013 1:33,12,2000000,1207,553,1760
9/21/2013 1:33,12,2000000,339,559,898
9/21/2013 1:33,12,2000000,341,593,934
9/21/2013 1:33,12,2000000,363,589,952
9/21/2013 1:33,12,2000000,333,587,920
9/21/2013 1:33,12,2000000,337,584,921
9/21/2013 1:34,12,2000000,325,593,918
9/21/2013 1:34,12,2000000,1320,588,1908
9/21/2013 1:34,12,2000000,304,559,863
9/21/2013 1:34,12,2000000,1241,572,1813
9/21/2013 1:34,12,2000000,345,582,927
9/21/2013 1:34,12,2000000,346,587,933
9/21/2013 1:34,12,2000000,354,582,936
9/21/2013 1:34,12,2000000,1264,572,1836
9/21/2013 1:34,12,3000000,428,813,1241
9/21/2013 1:34,12,3000000,1228,842,2070
9/21/2013 1:34,12,3000000,435,835,1270
9/21/2013 1:34,12,3000000,720,836,1556
9/21/2013 1:34,12,3000000,390,831,1221
9/21/2013 1:34,12,3000000,409,821,1230
9/21/2013 1:34,12,3000000,431,813,1244
9/21/2013 1:34,12,3000000,409,832,1241
9/21/2013 1:35,12,3000000,571,811,1382
9/21/2013 1:35,12,3000000,586,830,1416
9/21/2013 1:35,12,3000000,411,777,1188
9/21/2013 1:35,12,3000000,446,815,1261
9/21/2013 1:35,12,3000000,1316,821,2137
9/21/2013 1:35,12,3000000,440,821,1261
9/21/2013 1:35,12,3000000,399,820,1219
9/21/2013 1:35,12,3000000,1320,823,2143
9/21/2013 1:35,12,3000000,413,805,1218
9/21/2013 1:35,12,3000000,435,795,1230
9/21/2013 1:35,12,3000000,402,838,1240
9/21/2013 1:35,12,3000000,1271,795,2066
9/21/2013 1:35,12,3000000,1271,826,2097
9/21/2013 1:35,12,3000000,388,813,1201
9/21/2013 1:36,12,3000000,421,818,1239
9/21/2013 1:36,12,3000000,421,832,1253
9/21/2013 1:36,12,3000000,1263,828,2091
9/21/2013 1:36,12,3000000,399,836,1235
9/21/2013 1:36,12,3000000,1312,818,2130
9/21/2013 1:36,12,3000000,1283,838,2121
9/21/2013 1:36,12,3000000,1305,800,2105
9/21/2013 1:36,12,3000000,1282,842,2124
9/21/2013 1:36,12,3000000,671,840,1511
9/21/2013 1:36,12,3000000,462,841,1303
9/21/2013 1:36,12,3000000,1289,845,2134
9/21/2013 1:36,12,3000000,449,822,1271
9/21/2013 1:36,12,3000000,1228,812,2040
9/21/2013 1:36,12,3000000,614,825,1439
9/21/2013 1:37,12,3000000,435,802,1237
9/21/2013 1:37,12,3000000,1286,841,2127
9/21/2013 1:37,12,3000000,1236,835,2071
9/21/2013 1:37,12,3000000,485,820,1305
9/21/2013 1:37,12,3000000,626,844,1470
9/21/2013 1:37,12,3000000,420,846,1266
9/21/2013 1:37,12,3000000,394,788,1182
9/21/2013 1:37,12,3000000,403,799,1202
9/21/2013 1:37,12,3000000,1263,836,2099
9/21/2013 1:37,12,3000000,1322,835,2157
9/21/2013 1:37,12,3000000,616,833,1449
9/21/2013 1:37,12,3000000,408,818,1226
9/21/2013 1:37,12,3000000,435,812,1247
9/21/2013 1:37,12,3000000,574,826,1400
9/21/2013 1:37,12,3000000,408,799,1207
9/21/2013 1:38,12,3000000,1242,839,2081
9/21/2013 1:38,12,3000000,423,836,1259
9/21/2013 1:38,12,3000000,425,818,1243
9/21/2013 1:38,12,3000000,422,806,1228
9/21/2013 1:38,12,3000000,402,825,1227
9/21/2013 1:38,12,3000000,427,816,1243
9/21/2013 1:38,12,3000000,459,829,1288
9/21/2013 1:38,12,3000000,448,821,1269
9/21/2013 1:38,12,3000000,416,813,1229
9/21/2013 1:38,12,3000000,630,827,1457
9/21/2013 1:38,12,3000000,581,790,1371
9/21/2013 1:38,12,3000000,1304,822,2126
9/21/2013 1:38,12,3000000,422,804,1226
9/21/2013 1:38,12,3000000,1290,811,2101
9/21/2013 1:38,12,3000000,449,801,1250
9/21/2013 1:39,12,3000000,433,815,1248
9/21/2013 1:39,12,3000000,392,791,1183
9/21/2013 1:39,12,3000000,1330,828,2158
9/21/2013 1:39,12,3000000,1246,825,2071
9/21/2013 1:39,12,3000000,434,837,1271
9/21/2013 1:39,12,3000000,1331,801,2132
9/21/2013 1:56,12,3000000,420,819,1239
9/21/2013 1:56,12,3000000,493,835,1328
9/21/2013 1:56,12,3000000,411,812,1223
9/21/2013 1:56,12,3000000,3502,813,4315
9/21/2013 1:56,12,3000000,433,814,1247
9/21/2013 1:56,12,3000000,409,852,1261
9/21/2013 1:56,12,3000000,589,833,1422
9/21/2013 1:56,12,3000000,1294,812,2106
9/21/2013 1:56,12,3000000,403,842,1245
9/21/2013 1:56,12,3000000,401,839,1240
9/21/2013 1:56,12,3000000,641,817,1458
9/21/2013 1:57,12,3000000,634,819,1453
9/21/2013 1:57,12,3000000,418,835,1253
9/21/2013 1:57,12,3000000,511,832,1343
9/21/2013 1:57,12,3000000,631,841,1472
9/21/2013 1:57,12,3000000,440,837,1277
9/21/2013 1:57,12,3000000,600,830,1430
9/21/2013 1:57,12,3000000,405,803,1208
9/21/2013 1:57,12,3000000,1337,845,2182
9/21/2013 1:57,12,3000000,779,841,1620
9/21/2013 1:57,12,3000000,449,821,1270
9/21/2013 1:57,12,3000000,433,814,1247
9/21/2013 1:57,12,3000000,389,829,1218
9/21/2013 1:57,12,3000000,598,846,1444
9/21/2013 1:57,12,3000000,384,830,1214
9/21/2013 1:58,12,3000000,1284,835,2119
9/21/2013 1:58,12,3000000,417,820,1237
9/21/2013 1:58,12,3000000,415,830,1245
9/21/2013 1:58,12,3000000,516,829,1345
9/21/2013 1:58,12,3000000,631,805,1436
9/21/2013 1:58,12,3000000,418,789,1207
9/21/2013 1:58,12,3000000,430,828,1258
9/21/2013 1:58,12,3000000,806,843,1649
9/21/2013 1:58,12,3000000,417,800,1217
9/21/2013 1:58,12,3000000,420,816,1236
9/21/2013 1:58,12,3000000,396,820,1216
9/21/2013 1:58,12,3000000,1320,827,2147
9/21/2013 1:58,12,3000000,788,842,1630
9/21/2013 1:58,12,3000000,1277,823,2100
9/21/2013 1:59,12,3000000,425,816,1241
9/21/2013 1:59,12,3000000,417,831,1248
9/21/2013 1:59,12,3000000,455,813,1268
9/21/2013 1:59,12,4000000,659,1085,1744
9/21/2013 1:59,12,4000000,761,1085,1846
9/21/2013 1:59,12,4000000,738,1107,1845
9/21/2013 1:59,12,4000000,1358,1077,2435
9/21/2013 1:59,12,4000000,928,1099,2027
9/21/2013 1:59,12,4000000,528,1097,1625
9/21/2013 1:59,12,4000000,1346,1075,2421
9/21/2013 1:59,12,4000000,1358,1071,2429
9/21/2013 1:59,12,4000000,743,1089,1832
9/21/2013 1:59,12,4000000,745,1074,1819
9/21/2013 2:00,12,4000000,999,1108,2107
9/21/2013 2:00,12,4000000,738,1107,1845
9/21/2013 2:00,12,4000000,563,1048,1611
9/21/2013 2:00,12,4000000,711,1063,1774
9/21/2013 2:00,12,4000000,1385,1078,2463
9/21/2013 2:00,12,4000000,718,1017,1735
9/21/2013 2:00,12,4000000,754,1083,1837
9/21/2013 2:00,12,4000000,542,1064,1606
9/21/2013 2:00,12,4000000,1347,1047,2394
9/21/2013 2:00,12,4000000,626,1064,1690
9/21/2013 2:00,12,4000000,1310,1099,2409
9/21/2013 2:00,12,4000000,523,1089,1612
9/21/2013 2:00,12,4000000,529,1057,1586
9/21/2013 2:01,12,4000000,494,1100,1594
9/21/2013 2:01,12,4000000,1403,1102,2505
9/21/2013 2:01,12,4000000,549,1059,1608
9/21/2013 2:01,12,4000000,945,1087,2032
9/21/2013 2:01,12,4000000,567,1062,1629
9/21/2013 2:01,12,4000000,519,1101,1620
9/21/2013 2:01,12,4000000,559,1084,1643
9/21/2013 2:01,12,4000000,1416,1098,2514
9/21/2013 2:01,12,4000000,591,1039,1630
9/21/2013 2:01,12,4000000,509,1087,1596
9/21/2013 2:01,12,4000000,528,1066,1594
9/21/2013 2:02,12,4000000,1397,1072,2469
9/21/2013 2:02,12,4000000,1369,1111,2480
9/21/2013 2:02,12,4000000,494,1072,1566
9/21/2013 2:02,12,4000000,520,1077,1597
9/21/2013 2:02,12,4000000,549,1014,1563
9/21/2013 2:02,12,4000000,561,1072,1633
9/21/2013 2:02,12,4000000,517,1080,1597
9/21/2013 2:02,12,4000000,599,1101,1700
9/21/2013 2:02,12,4000000,703,1077,1780
9/21/2013 2:02,12,4000000,558,1073,1631
9/21/2013 2:02,12,4000000,927,1084,2011
9/21/2013 2:02,12,4000000,513,1091,1604
9/21/2013 2:02,12,4000000,542,1103,1645
9/21/2013 2:02,12,4000000,719,1076,1795
9/21/2013 2:03,12,4000000,696,1047,1743
9/21/2013 2:03,12,4000000,794,1092,1886
9/21/2013 2:03,12,4000000,547,1438,1985
9/21/2013 2:03,12,4000000,539,1082,1621
9/21/2013 2:03,12,4000000,533,1061,1594
9/21/2013 2:03,12,4000000,1382,1067,2449
9/21/2013 2:03,12,4000000,530,1086,1616
9/21/2013 2:03,12,4000000,1382,1076,2458
9/21/2013 2:03,12,4000000,1354,1081,2435
9/21/2013 2:03,12,4000000,1315,1105,2420
9/21/2013 2:03,12,4000000,549,1074,1623
9/21/2013 2:04,12,4000000,1308,1068,2376
9/21/2013 2:04,12,4000000,1327,1072,2399
9/21/2013 2:04,12,4000000,1330,1091,2421
9/21/2013 2:04,12,4000000,1371,1072,2443
9/21/2013 2:04,12,4000000,535,1069,1604
9/21/2013 2:04,12,4000000,574,1067,1641
9/21/2013 2:04,12,4000000,857,1084,1941
9/21/2013 2:04,12,4000000,747,1070,1817
9/21/2013 2:04,12,4000000,559,1059,1618
9/21/2013 2:04,12,4000000,722,1069,1791
9/21/2013 2:04,12,4000000,1357,1079,2436
9/21/2013 2:04,12,4000000,1369,1078,2447
9/21/2013 2:04,12,4000000,1370,1078,2448
9/21/2013 2:05,12,4000000,689,1039,1728
9/21/2013 2:05,12,4000000,730,1102,1832
9/21/2013 2:05,12,4000000,530,1424,1954
9/21/2013 2:05,12,4000000,558,1062,1620
9/21/2013 2:05,12,4000000,933,1103,2036
9/21/2013 2:05,12,4000000,710,1094,1804
9/21/2013 2:05,12,4000000,549,1077,1626
9/21/2013 2:05,12,4000000,1411,1099,2510
9/21/2013 2:05,12,4000000,539,1092,1631
9/21/2013 2:05,12,4000000,756,1093,1849
9/21/2013 2:05,12,4000000,1369,1099,2468
9/21/2013 2:05,12,4000000,1389,1248,2637
9/21/2013 2:05,12,4000000,553,1092,1645
9/21/2013 2:06,12,4000000,2588,1089,3677
9/21/2013 2:06,12,4000000,700,1114,1814
9/21/2013 2:06,12,4000000,523,1082,1605
9/21/2013 2:06,12,4000000,644,1099,1743
9/21/2013 2:06,12,4000000,6105,1061,7166
9/21/2013 2:06,12,4000000,1351,1105,2456
9/21/2013 2:06,12,4000000,505,1052,1557
9/21/2013 2:07,12,4000000,714,1081,1795
9/21/2013 2:07,12,4000000,755,1090,1845
9/21/2013 2:07,12,4000000,720,1073,1793
9/21/2013 2:07,12,4000000,809,1104,1913
9/21/2013 2:07,12,4000000,517,1056,1573
9/21/2013 2:07,12,4000000,491,1093,1584
9/21/2013 2:07,12,4000000,1328,1107,2435
9/21/2013 2:07,12,4000000,743,1223,1966
9/21/2013 2:07,12,4000000,710,1082,1792
9/21/2013 2:07,12,4000000,669,1083,1752
9/21/2013 2:07,12,4000000,549,1104,1653
9/21/2013 2:07,12,4000000,1324,1097,2421
9/21/2013 2:07,12,4000000,1356,1127,2483
9/21/2013 2:08,12,4000000,1397,1088,2485
9/21/2013 2:08,12,4000000,694,1016,1710
9/21/2013 2:08,12,4000000,920,1079,1999
9/21/2013 2:08,12,4000000,707,1096,1803
9/21/2013 2:08,12,4000000,534,1062,1596
9/21/2013 2:08,12,4000000,1453,1071,2524
9/21/2013 2:08,12,4000000,1426,1060,2486
9/21/2013 2:08,12,4000000,538,1066,1604
9/21/2013 2:08,12,4000000,1372,1096,2468
9/21/2013 2:08,12,4000000,783,1069,1852
9/21/2013 2:08,12,5000000,768,1315,2083
9/21/2013 2:08,12,5000000,985,1274,2259
9/21/2013 2:09,12,5000000,1389,1270,2659
9/21/2013 2:09,12,5000000,623,1363,1986
9/21/2013 2:09,12,5000000,791,1292,2083
9/21/2013 2:09,12,5000000,801,1348,2149
9/21/2013 2:09,12,5000000,3765,1298,5063
9/21/2013 2:09,12,5000000,664,1321,1985
9/21/2013 2:09,12,5000000,874,1256,2130
9/21/2013 2:09,12,5000000,594,1337,1931
9/21/2013 2:09,12,5000000,616,1292,1908
9/21/2013 2:09,12,5000000,917,1334,2251
9/21/2013 2:09,12,5000000,774,1315,2089
9/21/2013 2:09,12,5000000,770,1304,2074
9/21/2013 2:10,12,5000000,671,1322,1993
9/21/2013 2:10,12,5000000,781,1345,2126
9/21/2013 2:10,12,5000000,685,1384,2069
9/21/2013 2:10,12,5000000,1393,1288,2681
9/21/2013 2:10,12,5000000,633,1284,1917
9/21/2013 2:10,12,5000000,1378,1314,2692
9/21/2013 2:10,12,5000000,969,1364,2333
9/21/2013 2:10,12,5000000,780,1291,2071
9/21/2013 2:10,12,5000000,777,1321,2098
9/21/2013 2:10,12,5000000,681,1387,2068
9/21/2013 2:10,12,5000000,1380,1359,2739
9/21/2013 2:10,12,5000000,1538,1342,2880
9/21/2013 2:11,12,5000000,1387,1303,2690
9/21/2013 2:11,12,5000000,806,1280,2086
9/21/2013 2:11,12,5000000,1610,1311,2921
9/21/2013 2:11,12,5000000,1393,1302,2695
9/21/2013 2:11,12,5000000,1303,1814,3117
9/21/2013 2:11,12,5000000,1380,1361,2741
9/21/2013 2:11,12,5000000,803,1361,2164
9/21/2013 2:11,12,5000000,798,1256,2054
9/21/2013 2:11,12,5000000,1352,1358,2710
9/21/2013 2:11,12,5000000,618,1359,1977
9/21/2013 2:12,12,5000000,632,1372,2004
9/21/2013 2:12,12,5000000,778,1289,2067
9/21/2013 2:12,12,5000000,1491,1259,2750
9/21/2013 2:12,12,5000000,664,1341,2005
9/21/2013 2:12,12,5000000,607,1354,1961
9/21/2013 2:12,12,5000000,679,1330,2009
9/21/2013 2:12,12,5000000,1384,1313,2697
9/21/2013 2:12,12,5000000,981,1402,2383
9/21/2013 2:12,12,5000000,629,1300,1929
9/21/2013 2:12,12,5000000,1014,1376,2390
9/21/2013 2:12,12,5000000,1349,1286,2635
9/21/2013 2:13,12,5000000,845,1345,2190
9/21/2013 2:13,12,5000000,991,1509,2500
9/21/2013 2:13,12,5000000,798,1242,2040
9/21/2013 2:13,12,5000000,843,1363,2206
9/21/2013 2:13,12,5000000,783,1335,2118
9/21/2013 2:13,12,5000000,767,1292,2059
9/21/2013 2:13,12,5000000,807,1355,2162
9/21/2013 2:13,12,5000000,1020,1343,2363
9/21/2013 2:13,12,5000000,958,1389,2347
9/21/2013 2:13,12,5000000,1369,1271,2640
9/21/2013 2:13,12,5000000,849,1356,2205
9/21/2013 2:13,12,5000000,846,1314,2160
9/21/2013 2:14,12,5000000,750,1327,2077
9/21/2013 2:14,12,5000000,765,1316,2081
9/21/2013 2:14,12,5000000,777,1302,2079
9/21/2013 2:14,12,5000000,765,1310,2075
9/21/2013 2:14,12,5000000,1414,1429,2843
9/21/2013 2:14,12,5000000,1382,1295,2677
9/21/2013 2:14,12,5000000,654,1386,2040
9/21/2013 2:14,12,5000000,620,1298,1918
9/21/2013 2:14,12,5000000,1373,1385,2758
9/21/2013 2:14,12,5000000,781,1261,2042
9/21/2013 2:14,12,5000000,817,1294,2111
9/21/2013 2:15,12,5000000,1350,1329,2679
9/21/2013 2:15,12,5000000,1405,1386,2791
9/21/2013 2:15,12,5000000,622,1394,2016
9/21/2013 2:15,12,5000000,1011,1331,2342
9/21/2013 2:15,12,5000000,934,1381,2315
9/21/2013 2:15,12,5000000,1436,1399,2835
9/21/2013 2:15,12,5000000,610,1381,1991
9/21/2013 2:15,12,5000000,987,1315,2302
9/21/2013 2:15,12,5000000,1019,1364,2383
9/21/2013 2:15,12,5000000,786,1344,2130
9/21/2013 2:15,12,5000000,1593,1318,2911
9/21/2013 2:15,12,5000000,648,1349,1997
9/21/2013 2:16,12,5000000,644,1382,2026
9/21/2013 2:16,12,5000000,843,1352,2195
9/21/2013 2:16,12,5000000,822,1334,2156
9/21/2013 2:16,12,5000000,815,1268,2083
9/21/2013 2:16,12,5000000,651,1268,1919
9/21/2013 2:16,12,5000000,994,1323,2317
9/21/2013 2:16,12,5000000,728,1369,2097
9/21/2013 2:16,12,5000000,633,1289,1922
9/21/2013 2:16,12,5000000,855,1380,2235
9/21/2013 2:16,12,5000000,1453,1317,2770
9/21/2013 2:16,12,5000000,802,1330,2132
9/21/2013 2:16,12,5000000,807,1349,2156
9/21/2013 2:17,12,5000000,773,1273,2046
9/21/2013 2:17,12,5000000,1444,1363,2807
9/21/2013 2:17,12,5000000,743,1373,2116
9/21/2013 2:17,12,5000000,623,1272,1895
9/21/2013 2:17,12,5000000,782,1267,2049
9/21/2013 2:17,12,5000000,800,1331,2131
9/21/2013 2:17,12,5000000,738,1264,2002
9/21/2013 2:17,12,5000000,973,1576,2549
9/21/2013 2:17,12,5000000,1046,1293,2339
9/21/2013 2:17,12,5000000,807,1721,2528
9/21/2013 2:17,12,5000000,770,1354,2124
9/21/2013 2:17,12,5000000,758,1348,2106
9/21/2013 2:18,12,5000000,820,1339,2159
9/21/2013 2:18,12,5000000,1401,1340,2741
9/21/2013 2:18,12,5000000,1421,1283,2704
9/21/2013 2:18,12,5000000,1276,1303,2579
9/21/2013 2:18,12,5000000,626,1326,1952
9/21/2013 2:18,12,5000000,1385,1346,2731
9/21/2013 2:18,12,5000000,1392,1355,2747
9/21/2013 2:18,12,5000000,631,1326,1957
9/21/2013 2:18,12,5000000,1411,1379,2790
9/21/2013 2:18,12,6000000,1015,1602,2617
9/21/2013 2:18,12,6000000,1010,1643,2653
9/21/2013 2:19,12,6000000,1046,1624,2670
9/21/2013 2:19,12,6000000,850,1474,2324
9/21/2013 2:19,12,6000000,904,1533,2437
9/21/2013 2:19,12,6000000,773,1579,2352
9/21/2013 2:19,12,6000000,1473,1557,3030
9/21/2013 2:19,12,6000000,861,1498,2359
9/21/2013 2:19,12,6000000,1429,1494,2923
9/21/2013 2:19,12,6000000,819,1641,2460
9/21/2013 2:19,12,6000000,746,1491,2237
9/21/2013 2:19,12,6000000,714,1573,2287
9/21/2013 2:19,12,6000000,1427,1520,2947
9/21/2013 2:20,12,6000000,853,1586,2439
9/21/2013 2:20,12,6000000,987,1564,2551
9/21/2013 2:20,12,6000000,1553,1609,3162
9/21/2013 2:20,12,6000000,1501,1593,3094
9/21/2013 2:20,12,6000000,731,1591,2322
9/21/2013 2:20,12,6000000,881,1558,2439
9/21/2013 2:20,12,6000000,1017,1573,2590
9/21/2013 2:20,12,6000000,1030,1630,2660
9/21/2013 2:20,12,6000000,1124,1486,2610
9/21/2013 2:20,12,6000000,884,1542,2426
9/21/2013 2:20,12,6000000,1475,1537,3012
9/21/2013 2:21,12,6000000,1497,1567,3064
9/21/2013 2:21,12,6000000,910,1601,2511
9/21/2013 2:21,12,6000000,836,1499,2335
9/21/2013 2:21,12,6000000,932,1508,2440
9/21/2013 2:21,12,6000000,970,1606,2576
9/21/2013 2:21,12,6000000,845,1590,2435
9/21/2013 2:21,12,6000000,1136,1570,2706
9/21/2013 2:21,12,6000000,1045,1589,2634
9/21/2013 2:21,12,6000000,934,1552,2486
9/21/2013 2:21,12,6000000,822,1625,2447
9/21/2013 2:22,12,6000000,833,1568,2401
9/21/2013 2:22,12,6000000,973,1542,2515
9/21/2013 2:22,12,6000000,1456,1570,3026
9/21/2013 2:22,12,6000000,1009,1520,2529
9/21/2013 2:22,12,6000000,895,1866,2761
9/21/2013 2:22,12,6000000,1419,1578,2997
9/21/2013 2:22,12,6000000,659,1565,2224
9/21/2013 2:22,12,6000000,879,1502,2381
9/21/2013 2:22,12,6000000,888,1631,2519
9/21/2013 2:22,12,6000000,949,1570,2519
9/21/2013 2:22,12,6000000,674,1595,2269
9/21/2013 2:22,12,6000000,1443,1595,3038
9/21/2013 2:23,12,6000000,1518,1466,2984
9/21/2013 2:23,12,6000000,892,1564,2456
9/21/2013 2:23,12,6000000,1455,1501,2956
9/21/2013 2:23,12,6000000,1495,1984,3479
9/21/2013 2:23,12,6000000,1365,1612,2977
9/21/2013 2:23,12,6000000,1438,1561,2999
9/21/2013 2:23,12,6000000,907,1595,2502
9/21/2013 2:23,12,6000000,1053,1523,2576
9/21/2013 2:23,12,6000000,1621,1657,3278
9/21/2013 2:23,12,6000000,920,1619,2539
9/21/2013 2:24,12,6000000,925,1468,2393
9/21/2013 2:24,12,6000000,1046,1660,2706
9/21/2013 2:24,12,6000000,1005,1672,2677
9/21/2013 2:24,12,6000000,707,1601,2308
9/21/2013 2:24,12,6000000,5436,1623,7059
9/21/2013 2:25,12,6000000,1123,1424,2547
9/21/2013 2:25,12,6000000,1002,1610,2612
9/21/2013 2:25,12,6000000,1023,1555,2578
9/21/2013 2:25,12,6000000,870,1591,2461
9/21/2013 2:25,12,6000000,877,1525,2402
9/21/2013 2:25,12,6000000,1486,1616,3102
9/21/2013 2:26,12,6000000,1003,1531,2534
9/21/2013 2:26,12,6000000,763,1475,2238
9/21/2013 2:26,12,6000000,1424,1591,3015
9/21/2013 2:26,12,6000000,818,1552,2370
9/21/2013 2:26,12,6000000,1534,1497,3031
9/21/2013 2:26,12,6000000,810,1498,2308
9/21/2013 2:26,12,6000000,1090,1620,2710
9/21/2013 2:26,12,6000000,1420,1602,3022
9/21/2013 2:26,12,6000000,1514,1468,2982
9/21/2013 2:26,12,6000000,1425,1605,3030
9/21/2013 2:26,12,6000000,843,1591,2434
9/21/2013 2:27,12,6000000,845,1486,2331
9/21/2013 2:27,12,6000000,687,1595,2282
9/21/2013 2:27,12,6000000,1423,1582,3005
9/21/2013 2:27,12,6000000,1471,1602,3073
9/21/2013 2:27,12,6000000,1056,1552,2608
9/21/2013 2:27,12,6000000,883,1575,2458
9/21/2013 2:27,12,6000000,1431,1651,3082
9/21/2013 2:27,12,6000000,1460,1504,2964
9/21/2013 2:27,12,6000000,884,1495,2379
9/21/2013 2:27,12,6000000,714,1613,2327
9/21/2013 2:27,12,6000000,1448,1615,3063
9/21/2013 2:28,12,6000000,1588,1621,3209
9/21/2013 2:28,12,6000000,988,1493,2481
9/21/2013 2:28,12,6000000,1010,1647,2657
9/21/2013 2:28,12,6000000,1449,1609,3058
9/21/2013 2:28,12,6000000,686,1616,2302
9/21/2013 2:28,12,6000000,1417,1616,3033
9/21/2013 2:28,12,6000000,1459,1499,2958
9/21/2013 2:28,12,6000000,1017,1565,2582
9/21/2013 2:28,12,6000000,848,1595,2443
9/21/2013 2:28,12,6000000,994,1604,2598
9/21/2013 2:28,12,6000000,908,1527,2435
9/21/2013 2:29,12,6000000,829,1599,2428
9/21/2013 2:29,12,6000000,942,1644,2586
9/21/2013 2:29,12,6000000,827,1593,2420
9/21/2013 2:29,12,6000000,1085,1817,2902
9/21/2013 2:29,12,6000000,1438,1686,3124
9/21/2013 2:29,12,6000000,1330,1575,2905
9/21/2013 2:29,12,6000000,1016,1492,2508
9/21/2013 2:29,12,6000000,1030,1490,2520
9/21/2013 2:29,12,6000000,1540,1496,3036
9/21/2013 2:29,12,6000000,849,1488,2337
9/21/2013 2:29,12,6000000,1027,1479,2506
9/21/2013 2:30,12,6000000,887,1540,2427
9/21/2013 2:30,12,6000000,861,1561,2422
9/21/2013 2:30,12,6000000,834,1619,2453
9/21/2013 2:30,12,6000000,902,1579,2481
9/21/2013 2:30,12,7000000,1015,1784,2799
9/21/2013 2:30,12,7000000,834,1735,2569
9/21/2013 2:30,12,7000000,1028,1778,2806
9/21/2013 2:30,12,7000000,1001,1790,2791
9/21/2013 2:30,12,7000000,993,1826,2819
9/21/2013 2:30,12,7000000,1586,1750,3336
9/21/2013 2:30,12,7000000,1025,1666,2691
9/21/2013 2:31,12,7000000,957,1855,2812
9/21/2013 2:31,12,7000000,1146,1832,2978
9/21/2013 2:31,12,7000000,1079,1723,2802
9/21/2013 2:31,12,7000000,1196,2100,3296
9/21/2013 2:31,12,7000000,1626,1759,3385
9/21/2013 2:31,12,7000000,1056,1743,2799
9/21/2013 2:31,12,7000000,1495,1713,3208
9/21/2013 2:31,12,7000000,977,1765,2742
9/21/2013 2:31,12,7000000,1479,1791,3270
9/21/2013 2:31,12,7000000,1014,1720,2734
9/21/2013 2:32,12,7000000,1636,1837,3473
9/21/2013 2:32,12,7000000,1093,1813,2906
9/21/2013 2:32,12,7000000,912,1856,2768
9/21/2013 2:32,12,7000000,912,1790,2702
9/21/2013 2:32,12,7000000,1179,1875,3054
9/21/2013 2:32,12,7000000,1032,1854,2886
9/21/2013 2:32,12,7000000,859,1878,2737
9/21/2013 2:32,12,7000000,1528,1722,3250
9/21/2013 2:32,12,7000000,971,1750,2721
9/21/2013 2:33,12,7000000,1567,1762,3329
9/21/2013 2:33,12,7000000,1169,1841,3010
9/21/2013 2:33,12,7000000,1633,1780,3413
9/21/2013 2:33,12,7000000,992,1844,2836
9/21/2013 2:33,12,7000000,1155,1738,2893
9/21/2013 2:33,12,7000000,1495,1867,3362
9/21/2013 2:33,12,7000000,991,1759,2750
9/21/2013 2:33,12,7000000,1057,1720,2777
9/21/2013 2:33,12,7000000,1042,1737,2779
9/21/2013 2:33,12,7000000,1170,1738,2908
9/21/2013 2:34,12,7000000,2759,1696,4455
9/21/2013 2:34,12,7000000,1020,1762,2782
9/21/2013 2:34,12,7000000,1024,1728,2752
9/21/2013 2:34,12,7000000,1010,1869,2879
9/21/2013 2:34,12,7000000,817,1866,2683
9/21/2013 2:34,12,7000000,934,1766,2700
9/21/2013 2:34,12,7000000,971,1743,2714
9/21/2013 2:34,12,7000000,773,1739,2512
9/21/2013 2:34,12,7000000,1048,1738,2786
9/21/2013 2:34,12,7000000,1146,1781,2927
9/21/2013 2:35,12,7000000,1493,1733,3226
9/21/2013 2:35,12,7000000,870,1781,2651
9/21/2013 2:35,12,7000000,928,1680,2608
9/21/2013 2:35,12,7000000,911,1754,2665
9/21/2013 2:35,12,7000000,981,1887,2868
9/21/2013 2:35,12,7000000,833,1858,2691
9/21/2013 2:35,12,7000000,1568,1752,3320
9/21/2013 2:35,12,7000000,833,1910,2743
9/21/2013 2:35,12,7000000,978,1874,2852
9/21/2013 2:35,12,7000000,1027,1729,2756
9/21/2013 2:36,12,7000000,1130,1872,3002
9/21/2013 2:36,12,7000000,1593,1747,3340
9/21/2013 2:36,12,7000000,1086,1853,2939
9/21/2013 2:36,12,7000000,839,1730,2569
9/21/2013 2:36,12,7000000,838,1809,2647
9/21/2013 2:36,12,7000000,1016,1849,2865
9/21/2013 2:36,12,7000000,856,1808,2664
9/21/2013 2:36,12,7000000,1080,1883,2963
9/21/2013 2:36,12,7000000,1040,1839,2879
9/21/2013 2:36,12,7000000,1100,1777,2877
9/21/2013 2:36,12,7000000,1039,1822,2861
9/21/2013 2:37,12,7000000,997,1769,2766
9/21/2013 2:37,12,7000000,968,1836,2804
9/21/2013 2:37,12,7000000,1557,1745,3302
9/21/2013 2:37,12,7000000,992,1740,2732
9/21/2013 2:37,12,7000000,893,1835,2728
9/21/2013 2:37,12,7000000,847,1733,2580
9/21/2013 2:37,12,7000000,872,1854,2726
9/21/2013 2:37,12,7000000,1050,1851,2901
9/21/2013 2:37,12,7000000,1023,1731,2754
9/21/2013 2:38,12,7000000,1499,1733,3232
9/21/2013 2:38,12,7000000,800,1851,2651
9/21/2013 2:38,12,7000000,1137,1759,2896
9/21/2013 2:38,12,7000000,1528,1847,3375
9/21/2013 2:38,12,7000000,843,1749,2592
9/21/2013 2:38,12,7000000,783,1847,2630
9/21/2013 2:38,12,7000000,889,1864,2753
9/21/2013 2:38,12,7000000,819,1871,2690
9/21/2013 2:38,12,7000000,1606,1734,3340
9/21/2013 2:38,12,7000000,1565,1851,3416
9/21/2013 2:39,12,7000000,1483,1817,3300
9/21/2013 2:39,12,7000000,1489,1858,3347
9/21/2013 2:39,12,7000000,1013,1731,2744
9/21/2013 2:39,12,7000000,1231,1706,2937
9/21/2013 2:39,12,7000000,806,1776,2582
9/21/2013 2:39,12,7000000,1555,1770,3325
9/21/2013 2:39,12,7000000,1044,1696,2740
9/21/2013 2:39,12,7000000,866,1815,2681
9/21/2013 2:39,12,7000000,928,1864,2792
9/21/2013 2:39,12,7000000,882,1837,2719
9/21/2013 2:39,12,7000000,936,1772,2708
9/21/2013 2:40,12,7000000,1102,1847,2949
9/21/2013 2:40,12,7000000,805,1764,2569
9/21/2013 2:40,12,7000000,989,1725,2714
9/21/2013 2:40,12,7000000,1519,1824,3343
9/21/2013 2:40,12,7000000,1044,1769,2813
9/21/2013 2:40,12,7000000,1140,1835,2975
9/21/2013 2:40,12,7000000,922,1877,2799
9/21/2013 2:40,12,7000000,955,1845,2800
9/21/2013 2:40,12,7000000,881,1724,2605
9/21/2013 2:40,12,7000000,1569,1884,3453
9/21/2013 2:41,12,7000000,1026,1768,2794
9/21/2013 2:41,12,7000000,1511,1853,3364
9/21/2013 2:41,12,7000000,1632,1678,3310
9/21/2013 2:41,12,7000000,834,1818,2652
9/21/2013 2:41,12,7000000,1053,1826,2879
9/21/2013 2:41,12,7000000,1029,1870,2899
9/21/2013 2:41,12,7000000,1020,1740,2760
9/21/2013 2:41,12,7000000,1263,1766,3029
9/21/2013 2:41,12,8000000,1178,1990,3168
9/21/2013 2:41,12,8000000,1214,1949,3163
9/21/2013 2:42,12,8000000,1219,1974,3193
9/21/2013 2:42,12,8000000,1213,1910,3123
9/21/2013 2:42,12,8000000,1041,2009,3050
9/21/2013 2:42,12,8000000,992,2126,3118
9/21/2013 2:42,12,8000000,903,2120,3023
9/21/2013 2:42,12,8000000,1461,1925,3386
9/21/2013 2:42,12,8000000,1061,1973,3034
9/21/2013 2:42,12,8000000,991,2000,2991
9/21/2013 2:42,12,8000000,953,2152,3105
9/21/2013 2:43,12,8000000,1733,1975,3708
9/21/2013 2:43,12,8000000,953,2051,3004
9/21/2013 2:43,12,8000000,1123,1960,3083
9/21/2013 2:43,12,8000000,1223,1946,3169
9/21/2013 2:43,12,8000000,1089,2036,3125
9/21/2013 2:43,12,8000000,1031,2039,3070
9/21/2013 2:43,12,8000000,1279,2294,3573
9/21/2013 2:43,12,8000000,1590,1979,3569
9/21/2013 2:43,12,8000000,1218,2043,3261
9/21/2013 2:43,12,8000000,1204,2095,3299
9/21/2013 2:44,12,8000000,1030,2131,3161
9/21/2013 2:44,12,8000000,1011,1938,2949
9/21/2013 2:44,12,8000000,1042,2070,3112
9/21/2013 2:44,12,8000000,1321,2150,3471
9/21/2013 2:44,12,8000000,1033,1928,2961
9/21/2013 2:44,12,8000000,1168,2048,3216
9/21/2013 2:44,12,8000000,1350,2107,3457
9/21/2013 2:44,12,8000000,1251,2016,3267
9/21/2013 2:44,12,8000000,1585,2018,3603
9/21/2013 2:44,12,8000000,1451,1923,3374
9/21/2013 2:45,12,8000000,1570,2084,3654
9/21/2013 2:45,12,8000000,1176,2011,3187
9/21/2013 2:45,12,8000000,1174,2035,3209
9/21/2013 2:45,12,8000000,1091,2020,3111
9/21/2013 2:45,12,8000000,953,1984,2937
9/21/2013 2:45,12,8000000,1045,2017,3062
9/21/2013 2:45,12,8000000,1782,2067,3849
9/21/2013 2:45,12,8000000,1020,1971,2991
9/21/2013 2:45,12,8000000,1075,2047,3122
9/21/2013 2:46,12,8000000,1179,2053,3232
9/21/2013 2:46,12,8000000,1279,1992,3271
9/21/2013 2:46,12,8000000,1616,2166,3782
9/21/2013 2:46,12,8000000,1633,2122,3755
9/21/2013 2:46,12,8000000,955,2293,3248
9/21/2013 2:46,12,8000000,1119,1963,3082
9/21/2013 2:46,12,8000000,1152,2018,3170
9/21/2013 2:46,12,8000000,1138,2117,3255
9/21/2013 2:46,12,8000000,1018,2000,3018
9/21/2013 2:46,12,8000000,1001,1979,2980
9/21/2013 2:47,12,8000000,1920,2106,4026
9/21/2013 2:47,12,8000000,1089,2061,3150
9/21/2013 2:47,12,8000000,1090,2088,3178
9/21/2013 2:47,12,8000000,1023,2040,3063
9/21/2013 2:47,12,8000000,1078,1996,3074
9/21/2013 2:47,12,8000000,1115,2071,3186
9/21/2013 2:47,12,8000000,1228,2439,3667
9/21/2013 2:47,12,8000000,1093,2094,3187
9/21/2013 2:47,12,8000000,969,2011,2980
9/21/2013 2:48,12,8000000,1115,2139,3254
9/21/2013 2:48,12,8000000,1084,2152,3236
9/21/2013 2:48,12,8000000,1604,1998,3602
9/21/2013 2:48,12,8000000,1304,1978,3282
9/21/2013 2:48,12,8000000,1069,2052,3121
9/21/2013 2:48,12,8000000,1228,1979,3207
9/21/2013 2:48,12,8000000,1304,1972,3276
9/21/2013 2:48,12,8000000,1017,2052,3069
9/21/2013 2:48,12,8000000,1022,2035,3057
9/21/2013 2:48,12,8000000,1798,1922,3720
9/21/2013 2:49,12,8000000,995,2000,2995
9/21/2013 2:49,12,8000000,1097,2138,3235
9/21/2013 2:49,12,8000000,1206,2119,3325
9/21/2013 2:49,12,8000000,1126,1955,3081
9/21/2013 2:49,12,8000000,1022,1964,2986
9/21/2013 2:49,12,8000000,1634,2057,3691
9/21/2013 2:49,12,8000000,1653,2088,3741
9/21/2013 2:49,12,8000000,1230,2076,3306
9/21/2013 2:49,12,8000000,1194,1936,3130
9/21/2013 2:49,12,8000000,1008,1984,2992
9/21/2013 2:50,12,8000000,1311,2029,3340
9/21/2013 2:50,12,8000000,1571,2077,3648
9/21/2013 2:50,12,8000000,1140,2136,3276
9/21/2013 2:50,12,8000000,1141,2033,3174
9/21/2013 2:50,12,8000000,1036,2450,3486
9/21/2013 2:50,12,8000000,1424,1989,3413
9/21/2013 2:50,12,8000000,1543,1997,3540
9/21/2013 2:50,12,8000000,1216,1975,3191
9/21/2013 2:50,12,8000000,1701,1954,3655
9/21/2013 2:51,12,8000000,1717,2101,3818
9/21/2013 2:51,12,8000000,1130,1962,3092
9/21/2013 2:51,12,8000000,1308,2023,3331
9/21/2013 2:51,12,8000000,1651,2042,3693
9/21/2013 2:51,12,8000000,1062,1989,3051
9/21/2013 2:51,12,8000000,1192,2055,3247
9/21/2013 2:51,12,8000000,1136,1981,3117
9/21/2013 2:51,12,8000000,1320,1975,3295
9/21/2013 2:51,12,8000000,1037,1968,3005
9/21/2013 2:51,12,8000000,1158,2143,3301
9/21/2013 2:52,12,8000000,1026,2022,3048
9/21/2013 2:52,12,8000000,1129,2133,3262
9/21/2013 2:52,12,8000000,1517,1993,3510
9/21/2013 2:52,12,8000000,1286,1963,3249
9/21/2013 2:52,12,8000000,974,2044,3018
9/21/2013 2:52,12,8000000,1372,1964,3336
9/21/2013 2:52,12,8000000,1297,1979,3276
9/21/2013 2:52,12,8000000,1736,1964,3700
9/21/2013 2:52,12,8000000,1357,1922,3279
9/21/2013 2:53,12,8000000,1194,1910,3104
9/21/2013 2:53,12,8000000,1100,1964,3064
9/21/2013 2:53,12,8000000,1180,2045,3225
9/21/2013 2:53,12,8000000,1325,1960,3285
9/21/2013 2:53,12,8000000,1610,2122,3732
9/21/2013 2:53,12,8000000,1635,1972,3607
9/21/2013 2:53,12,8000000,1007,1993,3000
9/21/2013 2:53,12,8000000,1603,2006,3609
9/21/2013 2:53,12,9000000,1087,2306,3393
9/21/2013 2:53,12,9000000,1266,2458,3724
9/21/2013 2:54,12,9000000,1428,2388,3816
9/21/2013 2:54,12,9000000,1867,2412,4279
9/21/2013 2:54,12,9000000,1415,2431,3846
9/21/2013 2:54,12,9000000,1752,2314,4066
9/21/2013 2:54,12,9000000,1105,2465,3570
9/21/2013 2:54,12,9000000,1195,2371,3566
9/21/2013 2:54,12,9000000,1046,2674,3720
9/21/2013 2:54,12,9000000,1337,2429,3766
9/21/2013 2:54,12,9000000,1850,2195,4045
9/21/2013 2:55,12,9000000,1827,2317,4144
9/21/2013 2:55,12,9000000,1302,2174,3476
9/21/2013 2:55,12,9000000,1233,2328,3561
9/21/2013 2:55,12,9000000,1248,2262,3510
9/21/2013 2:55,12,9000000,1296,2287,3583
9/21/2013 2:55,12,9000000,1396,2404,3800
9/21/2013 2:55,12,9000000,1236,2170,3406
9/21/2013 2:55,12,9000000,1315,2382,3697
9/21/2013 2:56,12,9000000,1611,2481,4092
9/21/2013 2:56,12,9000000,1253,2250,3503
9/21/2013 2:56,12,9000000,1233,2419,3652
9/21/2013 2:56,12,9000000,1699,2410,4109
9/21/2013 2:56,12,9000000,1098,2216,3314
9/21/2013 2:56,12,9000000,1586,2241,3827
9/21/2013 2:56,12,9000000,1637,2406,4043
9/21/2013 2:56,12,9000000,1755,2160,3915
9/21/2013 2:56,12,9000000,1553,2230,3783
9/21/2013 2:57,12,9000000,1313,2254,3567
9/21/2013 2:57,12,9000000,1710,2228,3938
9/21/2013 2:57,12,9000000,1139,2937,4076
9/21/2013 2:57,12,9000000,1203,2430,3633
9/21/2013 2:57,12,9000000,1770,2486,4256
9/21/2013 2:57,12,9000000,1563,2215,3778
9/21/2013 2:57,12,9000000,1279,2143,3422
9/21/2013 2:57,12,9000000,1382,2216,3598
9/21/2013 2:57,12,9000000,1285,2195,3480
9/21/2013 2:58,12,9000000,1111,2383,3494
9/21/2013 2:58,12,9000000,1274,2227,3501
9/21/2013 2:58,12,9000000,1131,2398,3529
9/21/2013 2:58,12,9000000,1225,2262,3487
9/21/2013 2:58,12,9000000,1662,2256,3918
9/21/2013 2:58,12,9000000,1735,2398,4133
9/21/2013 2:58,12,9000000,1107,2412,3519
9/21/2013 2:58,12,9000000,1263,2437,3700
9/21/2013 2:58,12,9000000,1624,2300,3924
9/21/2013 3:15,12,9000000,1330,2484,3814
9/21/2013 3:15,12,9000000,1042,2240,3282
9/21/2013 3:16,12,9000000,1321,2486,3807
9/21/2013 3:16,12,9000000,1272,2185,3457
9/21/2013 3:16,12,9000000,1243,2365,3608
9/21/2013 3:16,12,9000000,1796,2434,4230
9/21/2013 3:16,12,9000000,1760,2451,4211
9/21/2013 3:16,12,9000000,1126,2450,3576
9/21/2013 3:16,12,9000000,1937,2631,4568
9/21/2013 3:16,12,9000000,1646,2251,3897
9/21/2013 3:16,12,9000000,1786,2484,4270
9/21/2013 3:17,12,9000000,1716,2239,3955
9/21/2013 3:17,12,9000000,1702,2333,4035
9/21/2013 3:17,12,9000000,1803,2257,4060
9/21/2013 3:17,12,9000000,1269,2224,3493
9/21/2013 3:17,12,9000000,1016,2324,3340
9/21/2013 3:17,12,9000000,1204,2796,4000
9/21/2013 3:17,12,9000000,1696,2258,3954
9/21/2013 3:17,12,9000000,1826,2393,4219
9/21/2013 3:17,12,9000000,1129,2467,3596
9/21/2013 3:18,12,9000000,1723,2467,4190
9/21/2013 3:18,12,9000000,1300,2283,3583
9/21/2013 3:18,12,9000000,1687,2456,4143
9/21/2013 3:18,12,9000000,1069,2279,3348
9/21/2013 3:18,12,9000000,1125,2230,3355
9/21/2013 3:18,12,9000000,1392,2215,3607
9/21/2013 3:18,12,9000000,1260,2432,3692
9/21/2013 3:18,12,9000000,1308,2457,3765
9/21/2013 3:18,12,9000000,1077,2427,3504
9/21/2013 3:19,12,9000000,1961,2399,4360
9/21/2013 3:19,12,9000000,1398,2411,3809
9/21/2013 3:19,12,9000000,1187,2250,3437
9/21/2013 3:19,12,9000000,1111,2222,3333
9/21/2013 3:19,12,9000000,975,2236,3211
9/21/2013 3:19,12,9000000,1369,2581,3950
9/21/2013 3:19,12,9000000,1186,2229,3415
9/21/2013 3:19,12,9000000,1068,2389,3457
9/21/2013 3:19,12,9000000,1214,2256,3470
9/21/2013 3:20,12,9000000,1740,2231,3971
9/21/2013 3:20,12,9000000,1243,2391,3634
9/21/2013 3:20,12,9000000,1356,2455,3811
9/21/2013 3:20,12,9000000,1176,2807,3983
9/21/2013 3:20,12,9000000,1049,2203,3252
9/21/2013 3:20,12,9000000,1387,2230,3617
9/21/2013 3:20,12,9000000,1433,2419,3852
9/21/2013 3:20,12,9000000,1677,2382,4059
9/21/2013 3:20,12,9000000,1256,2468,3724
9/21/2013 3:21,12,9000000,1351,2477,3828
9/21/2013 3:21,12,9000000,1104,2226,3330
9/21/2013 3:21,12,9000000,1754,2440,4194
9/21/2013 3:21,12,9000000,1123,2292,3415
9/21/2013 3:21,12,9000000,1596,2260,3856
9/21/2013 3:21,12,9000000,1151,2255,3406
9/21/2013 3:21,12,9000000,1355,2829,4184
9/21/2013 3:21,12,9000000,1321,2492,3813
9/21/2013 3:21,12,9000000,1155,2435,3590
9/21/2013 3:22,12,9000000,1246,2247,3493
9/21/2013 3:22,12,9000000,1755,2255,4010
9/21/2013 3:22,12,9000000,1294,2418,3712
9/21/2013 3:22,12,9000000,1175,2231,3406
9/21/2013 3:22,12,9000000,1125,2441,3566
9/21/2013 3:22,12,9000000,1226,2142,3368
9/21/2013 3:22,12,9000000,1193,2302,3495
9/21/2013 3:22,12,9000000,1145,2239,3384
9/21/2013 3:22,12,9000000,1439,2461,3900
9/21/2013 3:23,12,9000000,1744,2236,3980
9/21/2013 3:23,12,9000000,1733,2260,3993
9/21/2013 3:23,12,9000000,1133,2460,3593
9/21/2013 3:23,12,10000000,1384,2427,3811
9/21/2013 3:23,12,10000000,1761,2618,4379
9/21/2013 3:23,12,10000000,1787,2528,4315
9/21/2013 3:23,12,10000000,1407,2398,3805
9/21/2013 3:23,12,10000000,1271,2544,3815
9/21/2013 3:24,12,10000000,1190,2518,3708
9/21/2013 3:24,12,10000000,1734,2510,4244
9/21/2013 3:24,12,10000000,1786,2751,4537
9/21/2013 3:24,12,10000000,1506,2513,4019
9/21/2013 3:24,12,10000000,1267,2731,3998
9/21/2013 3:24,12,10000000,1439,2857,4296
9/21/2013 3:24,12,10000000,1855,2771,4626
9/21/2013 3:24,12,10000000,1300,2729,4029
9/21/2013 3:24,12,10000000,1215,2449,3664
9/21/2013 3:25,12,10000000,1480,2772,4252
9/21/2013 3:25,12,10000000,1885,2800,4685
9/21/2013 3:25,12,10000000,1294,2756,4050
9/21/2013 3:25,12,10000000,1137,2450,3587
9/21/2013 3:25,12,10000000,1676,2692,4368
9/21/2013 3:25,12,10000000,1194,2777,3971
9/21/2013 3:25,12,10000000,1767,3187,4954
9/21/2013 3:25,12,10000000,1361,2734,4095
9/21/2013 3:26,12,10000000,1338,2714,4052
9/21/2013 3:26,12,10000000,1378,2738,4116
9/21/2013 3:26,12,10000000,1434,2451,3885
9/21/2013 3:26,12,10000000,1390,2720,4110
9/21/2013 3:26,12,10000000,1404,2803,4207
9/21/2013 3:26,12,10000000,1793,2551,4344
9/21/2013 3:26,12,10000000,1509,2743,4252
9/21/2013 3:26,12,10000000,1416,2859,4275
9/21/2013 3:27,12,10000000,1468,2744,4212
9/21/2013 3:27,12,10000000,1408,2676,4084
9/21/2013 3:27,12,10000000,1930,2745,4675
9/21/2013 3:27,12,10000000,1385,2727,4112
9/21/2013 3:27,12,10000000,1292,2861,4153
9/21/2013 3:27,12,10000000,1471,2742,4213
9/21/2013 3:27,12,10000000,1972,2675,4647
9/21/2013 3:27,12,10000000,1403,2448,3851
9/21/2013 3:27,12,10000000,1150,2541,3691
9/21/2013 3:28,12,10000000,1305,2694,3999
9/21/2013 3:28,12,10000000,1196,2533,3729
9/21/2013 3:28,12,10000000,1550,3680,5230
9/21/2013 3:28,12,10000000,1371,2774,4145
9/21/2013 3:28,12,10000000,1358,2799,4157
9/21/2013 3:28,12,10000000,1262,2703,3965
9/21/2013 3:28,12,10000000,1326,2465,3791
9/21/2013 3:28,12,10000000,1373,2893,4266
9/21/2013 3:29,12,10000000,1492,2479,3971
9/21/2013 3:29,12,10000000,1450,2836,4286
9/21/2013 3:29,12,10000000,1492,2648,4140
9/21/2013 3:29,12,10000000,1495,2760,4255
9/21/2013 3:29,12,10000000,1399,2461,3860
9/21/2013 3:29,12,10000000,1525,3305,4830
9/21/2013 3:29,12,10000000,1470,2689,4159
9/21/2013 3:29,12,10000000,1356,2709,4065
9/21/2013 3:29,12,10000000,1249,2521,3770
9/21/2013 3:30,12,10000000,1500,2808,4308
9/21/2013 3:30,12,10000000,1494,2701,4195
9/21/2013 3:30,12,10000000,1578,2473,4051
9/21/2013 3:30,12,10000000,1264,2510,3774
9/21/2013 3:30,12,10000000,1365,2434,3799
9/21/2013 3:30,12,10000000,1452,2510,3962
9/21/2013 3:30,12,10000000,1721,2662,4383
9/21/2013 3:30,12,10000000,1832,2762,4594
9/21/2013 3:31,12,10000000,1753,2412,4165
9/21/2013 3:31,12,10000000,1385,2761,4146
9/21/2013 3:31,12,10000000,1318,2582,3900
9/21/2013 3:31,12,10000000,1324,2840,4164
9/21/2013 3:31,12,10000000,1293,2788,4081
9/21/2013 3:31,12,10000000,1361,2491,3852
9/21/2013 3:31,12,10000000,1833,2966,4799
9/21/2013 3:31,12,10000000,1309,2717,4026
9/21/2013 3:31,12,10000000,1440,2536,3976
9/21/2013 3:32,12,10000000,1714,2582,4296
9/21/2013 3:32,12,10000000,1196,2512,3708
9/21/2013 3:32,12,10000000,1439,2743,4182
9/21/2013 3:32,12,10000000,1412,2682,4094
9/21/2013 3:32,12,10000000,1308,2784,4092
9/21/2013 3:32,12,10000000,1265,2449,3714
9/21/2013 3:32,12,10000000,1345,2947,4292
9/21/2013 3:32,12,10000000,1213,2469,3682
9/21/2013 3:33,12,10000000,1936,2732,4668
9/21/2013 3:33,12,10000000,1511,2685,4196
9/21/2013 3:33,12,10000000,1327,2474,3801
9/21/2013 3:33,12,10000000,1468,2858,4326
9/21/2013 3:33,12,10000000,1455,2726,4181
9/21/2013 3:33,12,10000000,1460,2455,3915
9/21/2013 3:33,12,10000000,1793,2564,4357
9/21/2013 3:33,12,10000000,1335,2712,4047
9/21/2013 3:33,12,10000000,1389,2701,4090
9/21/2013 3:34,12,10000000,1295,2710,4005
9/21/2013 3:34,12,10000000,1403,2765,4168
9/21/2013 3:34,12,10000000,1421,2892,4313
9/21/2013 3:34,12,10000000,1438,2491,3929
9/21/2013 3:34,12,10000000,1442,2761,4203
9/21/2013 3:34,12,10000000,1821,2718,4539
9/21/2013 3:34,12,10000000,1283,3132,4415
9/21/2013 3:34,12,10000000,1338,3328,4666
9/21/2013 3:35,12,10000000,2021,2794,4815
9/21/2013 3:35,12,10000000,1199,2520,3719
9/21/2013 3:35,12,10000000,1233,2431,3664
9/21/2013 3:35,12,10000000,1270,2729,3999
9/21/2013 3:35,12,10000000,1198,2532,3730
9/21/2013 3:35,12,10000000,1748,2680,4428
9/21/2013 3:35,12,10000000,1251,2465,3716
9/21/2013 3:35,12,10000000,1441,2785,4226
9/21/2013 3:36,12,10000000,1341,2714,4055
9/21/2013 3:36,12,10000000,1548,2840,4388
9/21/2013 3:36,12,10000000,1947,2559,4506
9/21/2013 3:36,12,10000000,1283,2816,4099
9/21/2013 3:36,12,10000000,1912,2661,4573
9/21/2013 3:36,12,10000000,1965,2718,4683
9/21/2013 3:36,12,10000000,1277,2578,3855
9/21/2013 3:36,12,10000000,1754,2807,4561
9/21/2013 3:36,12,10000000,1360,2507,3867
9/21/2013 3:37,12,10000000,1765,2796,4561
9/21/2013 3:37,12,10000000,1810,2476,4286
9/21/2013 3:37,12,10000000,1760,2800,4560
9/21/2013 3:37,12,10000000,1422,2449,3871
9/21/2013 3:37,12,10000000,1785,2472,4257
9/21/2013 3:37,12,10000000,1635,2511,4146
9/21/2013 3:37,12,10000000,1301,2622,3923
9/21/2013 3:37,12,10000000,1578,2763,4341
9/21/2013 3:38,12,10000000,1368,2689,4057
9/21/2013 3:38,12,10000000,1850,2737,4587
9/21/2013 3:38,12,10000000,1768,2561,4329
9/21/2013 3:38,12,10000000,1847,2787,4634
9/21/2013 3:38,12,10000000,1690,2772,4462
9/21/2013 3:38,12,10000000,1756,2771,4527
9/21/2013 3:38,12,10000000,1596,2680,4276
9/21/2013 3:38,12,10000000,2043,2736,4779
9/21/2013 3:39,12,10000000,1349,2775,4124
9/21/2013 3:39,12,10000000,1514,2765,4279
9/21/2013 3:39,12,10000000,1757,2774,4531
9/21/2013 3:39,12,10000000,1332,2537,3869
9/21/2013 3:39,12,10000000,1353,2460,3813
9/21/2013 3:39,12,10000000,1549,2747,4296
9/21/2013 3:39,12,10000000,1358,2865,4223
9/21/2013 3:39,12,10000000,1321,2537,3858
9/21/2013 3:40,12,10000000,1430,2627,4057
9/21/2013 3:40,12,10000000,1550,2688,4238
9/21/2013 3:56,12,10000000,1583,2678,4261
9/21/2013 3:57,12,10000000,1355,2738,4093
9/21/2013 3:57,12,10000000,1302,2782,4084
9/21/2013 3:57,12,10000000,1493,2698,4191
9/21/2013 3:57,12,10000000,1154,2559,3713
9/21/2013 3:57,12,10000000,1327,2476,3803
9/21/2013 3:57,12,10000000,1239,2499,3738
9/21/2013 3:57,12,10000000,1358,2560,3918
9/21/2013 3:57,12,10000000,1228,2573,3801
9/21/2013 3:58,12,10000000,1458,2736,4194
9/21/2013 3:58,12,10000000,1573,2832,4405
9/21/2013 3:58,12,10000000,1468,2776,4244
9/21/2013 3:58,12,10000000,1462,2870,4332
9/21/2013 3:58,12,10000000,1363,2792,4155
9/21/2013 3:58,12,10000000,1118,2601,3719
9/21/2013 3:58,12,10000000,1467,2710,4177
9/21/2013 3:58,12,10000000,1280,2808,4088
9/21/2013 3:58,12,10000000,1368,2592,3960
9/21/2013 3:59,12,10000000,1587,2842,4429
9/21/2013 3:59,12,10000000,1554,2764,4318
9/21/2013 3:59,12,10000000,1347,2736,4083
9/21/2013 3:59,12,10000000,1403,2617,4020
9/21/2013 3:59,12,10000000,1367,2547,3914
9/21/2013 3:59,12,10000000,1289,2766,4055
9/21/2013 3:59,12,10000000,1260,2545,3805
9/21/2013 3:59,12,10000000,1543,2742,4285
9/21/2013 4:00,12,10000000,1281,2689,3970
9/21/2013 4:00,12,10000000,1365,2799,4164
9/21/2013 4:00,12,10000000,1150,2525,3675
9/21/2013 4:00,12,10000000,1424,2552,3976
9/21/2013 4:00,12,10000000,1296,2483,3779
9/21/2013 4:00,12,10000000,1186,2444,3630
9/21/2013 4:00,12,10000000,1539,2725,4264
9/21/2013 4:00,12,10000000,1354,2688,4042
9/21/2013 4:00,12,10000000,1313,2801,4114
9/21/2013 4:01,12,10000000,1245,2720,3965
9/21/2013 4:01,12,10000000,1836,2746,4582
9/21/2013 4:01,12,10000000,1936,2541,4477
9/21/2013 4:01,12,10000000,1336,2566,3902
9/21/2013 4:01,12,10000000,1176,2525,3701
9/21/2013 4:01,12,10000000,1941,2425,4366
9/21/2013 4:01,12,10000000,1715,2450,4165
9/21/2013 4:01,12,10000000,1760,2490,4250
9/21/2013 4:02,12,10000000,2093,2513,4606
9/21/2013 4:02,12,10000000,1804,2630,4434
9/21/2013 4:02,12,10000000,1390,2625,4015
9/21/2013 4:02,12,10000000,1909,2479,4388
9/21/2013 4:02,12,10000000,1709,2662,4371
9/21/2013 4:02,12,10000000,1716,2530,4246
9/21/2013 4:02,12,10000000,1376,2486,3862
9/21/2013 4:02,12,10000000,1284,2809,4093
9/21/2013 4:03,12,10000000,1427,2530,3957
9/21/2013 4:03,12,10000000,1433,2672,4105
9/21/2013 4:03,12,10000000,1860,2483,4343
9/21/2013 4:03,12,10000000,1798,2562,4360
9/21/2013 4:03,12,10000000,1167,2711,3878
9/21/2013 4:03,12,10000000,1860,2676,4536
9/21/2013 4:03,12,10000000,1279,2696,3975
9/21/2013 4:03,12,10000000,1819,2420,4239
9/21/2013 4:03,12,10000000,1829,2479,4308
9/21/2013 4:04,12,10000000,1156,2760,3916
9/21/2013 4:04,12,10000000,1981,2710,4691
9/21/2013 4:04,12,10000000,1892,2479,4371
9/21/2013 4:21,12,10000000,1791,2783,4574
9/21/2013 4:21,12,10000000,1273,2753,4026
9/21/2013 4:21,12,10000000,1748,2649,4397
9/21/2013 4:21,12,10000000,1681,2781,4462
9/21/2013 4:21,12,10000000,1750,2769,4519
9/21/2013 4:21,12,10000000,1231,2693,3924
9/21/2013 4:21,12,10000000,1729,2474,4203
9/21/2013 4:22,12,10000000,1328,2740,4068
9/21/2013 4:22,12,10000000,1355,2817,4172
9/21/2013 4:22,12,10000000,1359,2546,3905
9/21/2013 4:22,12,10000000,1761,2699,4460
9/21/2013 4:22,12,10000000,1210,2798,4008
9/21/2013 4:22,12,10000000,1669,2518,4187
9/21/2013 4:22,12,10000000,1313,2503,3816
9/21/2013 4:22,12,10000000,1277,2565,3842
9/21/2013 4:23,12,10000000,1247,2418,3665
9/21/2013 4:23,12,10000000,1997,2744,4741
9/21/2013 4:23,12,10000000,1600,2751,4351
9/21/2013 4:23,12,10000000,1385,2820,4205
9/21/2013 4:23,12,10000000,1235,2525,3760
9/21/2013 4:23,12,10000000,1906,2439,4345
9/21/2013 4:23,12,10000000,1114,2553,3667
9/21/2013 4:23,12,10000000,1223,2639,3862
9/21/2013 4:23,12,10000000,1290,2418,3708
9/21/2013 4:24,12,20000000,2899,5032,7931
9/21/2013 4:24,12,20000000,2898,5019,7917
9/21/2013 4:24,12,20000000,3196,4747,7943
9/21/2013 4:24,12,20000000,3107,5256,8363
9/21/2013 4:24,12,20000000,2792,4905,7697
9/21/2013 4:25,12,20000000,3041,4735,7776
9/21/2013 4:25,12,20000000,3156,4815,7971
9/21/2013 4:25,12,20000000,3118,4740,7858
9/21/2013 4:25,12,20000000,2938,4752,7690
9/21/2013 4:25,12,20000000,2932,4891,7823
9/21/2013 4:26,12,20000000,3102,4901,8003
9/21/2013 4:26,12,20000000,3022,4949,7971
9/21/2013 4:26,12,20000000,2987,4847,7834
9/21/2013 4:26,12,20000000,3062,4929,7991
9/21/2013 4:26,12,20000000,3191,4748,7939
9/21/2013 4:26,12,20000000,3108,4917,8025
9/21/2013 4:27,12,20000000,3034,4740,7774
9/21/2013 4:27,12,20000000,2998,4766,7764
9/21/2013 4:27,12,20000000,3021,4769,7790
9/21/2013 4:44,12,20000000,2912,4903,7815
9/21/2013 4:44,12,20000000,2842,4887,7729
9/21/2013 4:44,12,20000000,2723,4917,7640
9/21/2013 4:45,12,20000000,3027,4999,8026
9/21/2013 4:45,12,20000000,2962,4801,7763
9/21/2013 4:45,12,20000000,2768,4948,7716
9/21/2013 4:45,12,20000000,3085,5052,8137
9/21/2013 4:45,12,20000000,2859,4712,7571
9/21/2013 4:46,12,20000000,3083,4762,7845
9/21/2013 4:46,12,20000000,3206,4881,8087
9/21/2013 4:46,12,20000000,2938,4854,7792
9/21/2013 4:46,12,20000000,2940,4777,7717
9/21/2013 4:46,12,20000000,3087,4792,7879
9/21/2013 4:46,12,20000000,3250,4769,8019
9/21/2013 4:47,12,20000000,3037,4754,7791
9/21/2013 4:47,12,20000000,2935,4979,7914
9/21/2013 4:47,12,20000000,3011,4773,7784
9/21/2013 4:47,12,20000000,3198,4750,7948
9/21/2013 4:47,12,20000000,2965,5027,7992
9/21/2013 4:48,12,20000000,2907,5000,7907
9/21/2013 4:48,12,20000000,2850,4829,7679
9/21/2013 4:48,12,20000000,3116,4853,7969
9/21/2013 4:48,12,20000000,3287,4967,8254
9/21/2013 4:48,12,20000000,3115,4831,7946
9/21/2013 4:49,12,20000000,2899,4777,7676
9/21/2013 4:49,12,20000000,3013,4727,7740
9/21/2013 4:49,12,20000000,2982,4739,7721
9/21/2013 4:49,12,20000000,3031,4799,7830
9/21/2013 4:49,12,20000000,2895,4875,7770
9/21/2013 4:49,12,20000000,2974,5098,8072
9/21/2013 4:50,12,20000000,2850,4874,7724
9/21/2013 4:50,12,20000000,2809,5011,7820
9/21/2013 4:50,12,20000000,2878,4836,7714
9/21/2013 4:50,12,20000000,2911,4771,7682
9/21/2013 4:50,12,20000000,2853,4826,7679
9/21/2013 4:51,12,20000000,2987,5754,8741
9/21/2013 4:51,12,20000000,2796,5045,7841
9/21/2013 4:51,12,20000000,3040,4763,7803
9/21/2013 4:51,12,20000000,2992,4724,7716
9/21/2013 4:51,12,20000000,3465,4896,8361
9/21/2013 4:52,12,20000000,2854,4833,7687
9/21/2013 4:52,12,20000000,2840,4775,7615
9/21/2013 4:52,12,20000000,2942,4914,7856
9/21/2013 4:52,12,20000000,3059,4849,7908
9/21/2013 4:52,12,20000000,2813,4914,7727
9/21/2013 4:52,12,20000000,2923,4763,7686
9/21/2013 4:53,12,20000000,2943,4920,7863
9/21/2013 4:53,12,20000000,2868,4881,7749
9/21/2013 4:53,12,20000000,2878,4915,7793
9/21/2013 4:53,12,20000000,3177,4938,8115
9/21/2013 4:53,12,20000000,2937,4839,7776
9/21/2013 4:54,12,20000000,3115,4924,8039
9/21/2013 4:54,12,20000000,2839,4932,7771
9/21/2013 4:54,12,20000000,3066,4782,7848
9/21/2013 4:54,12,20000000,2977,4767,7744
9/21/2013 4:54,12,20000000,3090,4778,7868
9/21/2013 4:55,12,20000000,2964,4844,7808
9/21/2013 4:55,12,20000000,3062,4978,8040
9/21/2013 4:55,12,20000000,3129,4797,7926
9/21/2013 4:55,12,20000000,2715,4879,7594
9/21/2013 4:55,12,20000000,3025,4855,7880
9/21/2013 4:55,12,20000000,3236,4756,7992
9/21/2013 4:56,12,20000000,3027,4903,7930
9/21/2013 4:56,12,20000000,2974,4780,7754
9/21/2013 4:56,12,20000000,3112,4842,7954
9/21/2013 4:56,12,20000000,2996,4839,7835
9/21/2013 4:56,12,20000000,3072,4736,7808
9/21/2013 4:57,12,20000000,2826,4882,7708
9/21/2013 4:57,12,20000000,2849,6074,8923
9/21/2013 4:57,12,20000000,3074,4745,7819
9/21/2013 4:57,12,20000000,2863,4962,7825
9/21/2013 4:57,12,20000000,2995,5672,8667
9/21/2013 4:58,12,20000000,2925,4751,7676
9/21/2013 4:58,12,20000000,2906,4879,7785
9/21/2013 4:58,12,20000000,2900,5079,7979
9/21/2013 4:58,12,20000000,2953,4726,7679
9/21/2013 4:58,12,20000000,2932,4742,7674
9/21/2013 4:58,12,20000000,2875,4883,7758
9/21/2013 4:59,12,20000000,2845,4897,7742
9/21/2013 4:59,12,20000000,3078,4903,7981
9/21/2013 4:59,12,20000000,2930,4939,7869
9/21/2013 4:59,12,20000000,2976,4741,7717
9/21/2013 4:59,12,20000000,2960,4958,7918
9/21/2013 5:00,12,20000000,3242,4786,8028
9/21/2013 5:00,12,20000000,2999,4803,7802
9/21/2013 5:00,12,20000000,2950,4756,7706
9/21/2013 5:00,12,20000000,3197,4778,7975
9/21/2013 5:00,12,20000000,2801,5073,7874
9/21/2013 5:01,12,20000000,3291,4791,8082
9/21/2013 5:01,12,20000000,3452,4846,8298
9/21/2013 5:01,12,20000000,3381,4884,8265
9/21/2013 5:01,12,20000000,2910,4890,7800
9/21/2013 5:01,12,20000000,2981,4898,7879
9/21/2013 5:01,12,20000000,2829,4875,7704
9/21/2013 5:02,12,20000000,2985,4775,7760
9/21/2013 5:02,12,30000000,4610,7284,11894
9/21/2013 5:02,12,30000000,4636,7252,11888
9/21/2013 5:02,12,30000000,5088,7032,12120
9/21/2013 5:03,12,30000000,4654,7140,11794
9/21/2013 5:03,12,30000000,4622,7896,12518
9/21/2013 5:03,12,30000000,4807,7158,11965
9/21/2013 5:04,12,30000000,4808,7208,12016
9/21/2013 5:04,12,30000000,4681,7200,11881
9/21/2013 5:04,12,30000000,4977,7189,12166
9/21/2013 5:04,12,30000000,4541,7097,11638
9/21/2013 5:05,12,30000000,4544,7086,11630
9/21/2013 5:05,12,30000000,4608,7088,11696
9/21/2013 5:05,12,30000000,4485,7137,11622
9/21/2013 5:05,12,30000000,4543,7292,11835
9/21/2013 5:06,12,30000000,4680,7118,11798
9/21/2013 5:06,12,30000000,4618,7377,11995
9/21/2013 5:06,12,30000000,4765,7073,11838
9/21/2013 5:06,12,30000000,4566,7234,11800
9/21/2013 5:07,12,30000000,4710,7122,11832
9/21/2013 5:07,12,30000000,4676,7097,11773
9/21/2013 5:07,12,30000000,4786,7234,12020
9/21/2013 5:08,12,30000000,4712,7195,11907
9/21/2013 5:08,12,30000000,4576,7248,11824
9/21/2013 5:08,12,30000000,4622,7096,11718
9/21/2013 5:08,12,30000000,4358,7187,11545
9/21/2013 5:09,12,30000000,4797,8474,13271
9/21/2013 5:09,12,30000000,4774,7252,12026
9/21/2013 5:09,12,30000000,4641,7028,11669
9/21/2013 5:09,12,30000000,4714,7195,11909
9/21/2013 5:10,12,30000000,4699,7439,12138
9/21/2013 5:10,12,30000000,4627,7073,11700
9/21/2013 5:10,12,30000000,4543,7671,12214
9/21/2013 5:10,12,30000000,4563,7355,11918
9/21/2013 5:11,12,30000000,4870,7185,12055
9/21/2013 5:11,12,30000000,4933,7157,12090
9/21/2013 5:11,12,30000000,4495,7135,11630
9/21/2013 5:12,12,30000000,4574,7281,11855
9/21/2013 5:12,12,30000000,4638,7076,11714
9/21/2013 5:12,12,30000000,4721,7212,11933
9/21/2013 5:12,12,30000000,4711,7187,11898
9/21/2013 5:13,12,30000000,4794,7143,11937
9/21/2013 5:13,12,30000000,4597,7928,12525
9/21/2013 5:13,12,30000000,4691,7073,11764
9/21/2013 5:13,12,30000000,4851,7246,12097
9/21/2013 5:14,12,30000000,4795,7106,11901
9/21/2013 5:14,12,30000000,5161,8163,13324
9/21/2013 5:14,12,30000000,4992,7182,12174
9/21/2013 5:15,12,30000000,4742,7106,11848
9/21/2013 5:15,12,30000000,4660,7329,11989
9/21/2013 5:15,12,30000000,4946,7062,12008
9/21/2013 5:15,12,30000000,4730,7099,11829
9/21/2013 5:16,12,30000000,4393,7326,11719
9/21/2013 5:16,12,30000000,4638,7248,11886
9/21/2013 5:16,12,30000000,6913,7274,14187
9/21/2013 5:16,12,30000000,4809,7063,11872
9/21/2013 5:17,12,30000000,4500,7942,12442
9/21/2013 5:17,12,30000000,4493,7245,11738
9/21/2013 5:17,12,30000000,4847,7271,12118
9/21/2013 5:17,12,30000000,4703,7115,11818
9/21/2013 5:18,12,30000000,4756,7062,11818
9/21/2013 5:18,12,30000000,4622,7387,12009
9/21/2013 5:18,12,30000000,4519,7309,11828
9/21/2013 5:19,12,30000000,4399,7253,11652
9/21/2013 5:19,12,30000000,4928,7324,12252
9/21/2013 5:19,12,30000000,4867,7150,12017
9/21/2013 5:19,12,30000000,4614,7349,11963
9/21/2013 5:20,12,30000000,4636,7114,11750
9/21/2013 5:20,12,30000000,4607,8256,12863
9/21/2013 5:20,12,30000000,4647,7087,11734
9/21/2013 5:20,12,30000000,4877,7218,12095
9/21/2013 5:21,12,30000000,4930,8096,13026
9/21/2013 5:21,12,30000000,4935,7108,12043
9/21/2013 5:21,12,30000000,4678,7407,12085
9/21/2013 5:21,12,30000000,4674,7229,11903
9/21/2013 5:22,12,30000000,4716,7314,12030
9/21/2013 5:22,12,30000000,4624,7159,11783
9/21/2013 5:22,12,30000000,4848,7353,12201
9/21/2013 5:23,12,30000000,4662,7410,12072
9/21/2013 5:23,12,30000000,4490,7234,11724
9/21/2013 5:23,12,30000000,4508,7312,11820
9/21/2013 5:23,12,30000000,4621,7247,11868
9/21/2013 5:24,12,30000000,4700,7318,12018
9/21/2013 5:24,12,30000000,4581,7333,11914
9/21/2013 5:24,12,30000000,4604,7224,11828
9/21/2013 5:24,12,30000000,4615,7162,11777
9/21/2013 5:25,12,30000000,4690,7095,11785
9/21/2013 5:25,12,30000000,4710,7108,11818
9/21/2013 5:25,12,30000000,4592,7129,11721
9/21/2013 5:25,12,30000000,4602,7095,11697
9/21/2013 5:26,12,30000000,4776,7294,12070
9/21/2013 5:26,12,30000000,4536,7286,11822
9/21/2013 5:26,12,30000000,4511,8368,12879
9/21/2013 5:27,12,30000000,4749,7142,11891
9/21/2013 5:27,12,30000000,4589,7203,11792
9/21/2013 5:27,12,30000000,4737,7330,12067
9/21/2013 5:27,12,30000000,4639,7302,11941
9/21/2013 5:28,12,30000000,4658,7175,11833
9/21/2013 5:28,12,30000000,4790,7298,12088
9/21/2013 5:28,12,30000000,4625,7132,11757
9/21/2013 5:28,12,30000000,4646,7177,11823
9/21/2013 5:29,12,30000000,4992,7304,12296
9/21/2013 5:29,12,30000000,4802,7073,11875
9/21/2013 5:29,12,30000000,4579,7253,11832
9/21/2013 5:29,12,30000000,4568,7295,11863
9/21/2013 5:30,12,30000000,4959,7071,12030
9/21/2013 5:30,12,30000000,4878,7063,11941
9/21/2013 5:30,12,30000000,4831,7107,11938
9/21/2013 5:31,12,30000000,4961,7135,12096
9/21/2013 5:31,12,30000000,4636,7289,11925
9/21/2013 5:31,12,30000000,4470,7303,11773
9/21/2013 5:31,12,30000000,4750,7120,11870
9/21/2013 5:32,12,30000000,4789,7691,12480
9/21/2013 5:32,12,30000000,4540,7435,11975
9/21/2013 5:32,12,30000000,4640,7304,11944
9/21/2013 5:32,12,30000000,4600,7206,11806
9/21/2013 5:33,12,40000000,5814,9932,15746
9/21/2013 5:33,12,40000000,6121,9715,15836
9/21/2013 5:33,12,40000000,5871,9861,15732
9/21/2013 5:34,12,40000000,6154,10695,16849
9/21/2013 5:34,12,40000000,5716,10180,15896
9/21/2013 5:34,12,40000000,5651,10098,15749
9/21/2013 5:35,12,40000000,5896,9875,15771
9/21/2013 5:35,12,40000000,5739,9694,15433
9/21/2013 5:35,12,40000000,5749,9895,15644
9/21/2013 5:36,12,40000000,5913,10200,16113
9/21/2013 5:36,12,40000000,6209,10136,16345
9/21/2013 5:36,12,40000000,5955,9635,15590
9/21/2013 5:37,12,40000000,5805,9838,15643
9/21/2013 5:37,12,40000000,5727,9596,15323
9/21/2013 5:37,12,40000000,5991,9619,15610
9/21/2013 5:38,12,40000000,5867,9619,15486
9/21/2013 5:38,12,40000000,6047,9720,15767
9/21/2013 5:39,12,40000000,5753,10006,15759
9/21/2013 5:39,12,40000000,6351,10245,16596
9/21/2013 5:39,12,40000000,5984,9845,15829
9/21/2013 5:40,12,40000000,5924,9782,15706
9/21/2013 5:40,12,40000000,5795,9646,15441
9/21/2013 5:40,12,40000000,5915,9740,15655
9/21/2013 5:41,12,40000000,5853,9912,15765
9/21/2013 5:41,12,40000000,5899,9875,15774
9/21/2013 5:41,12,40000000,5894,9763,15657
9/21/2013 5:42,12,40000000,5851,9896,15747
9/21/2013 5:42,12,40000000,5811,9746,15557
9/21/2013 5:42,12,40000000,5621,9935,15556
9/21/2013 5:43,12,40000000,5846,9857,15703
9/21/2013 5:43,12,40000000,5944,9637,15581
9/21/2013 5:43,12,40000000,5811,9574,15385
9/21/2013 5:44,12,40000000,6377,9653,16030
9/21/2013 5:44,12,40000000,5959,9606,15565
9/21/2013 5:44,12,40000000,5685,9967,15652
9/21/2013 5:45,12,40000000,5765,9728,15493
9/21/2013 5:45,12,40000000,5693,10079,15772
9/21/2013 5:45,12,40000000,5850,9641,15491
9/21/2013 5:46,12,40000000,5746,9910,15656
9/21/2013 5:46,12,40000000,5873,9947,15820
9/21/2013 5:46,12,40000000,6090,9549,15639
9/21/2013 5:47,12,40000000,5839,10008,15847
9/21/2013 5:47,12,40000000,5804,9591,15395
9/21/2013 5:48,12,40000000,43853,10012,53865
9/21/2013 5:49,12,40000000,6131,9806,15937
9/21/2013 5:49,12,40000000,5937,9753,15690
9/21/2013 5:49,12,40000000,6066,9657,15723
9/21/2013 5:50,12,40000000,5853,9808,15661
9/21/2013 5:50,12,40000000,6156,10117,16273
9/21/2013 5:50,12,40000000,5993,9633,15626
9/21/2013 5:51,12,40000000,5907,9703,15610
9/21/2013 5:51,12,40000000,5839,9663,15502
9/21/2013 5:51,12,40000000,5849,9900,15749
9/21/2013 5:52,12,40000000,5976,9855,15831
9/21/2013 5:52,12,40000000,5825,9741,15566
9/21/2013 5:52,12,40000000,5808,11961,17769
9/21/2013 5:53,12,40000000,5651,9940,15591
9/21/2013 5:53,12,40000000,5712,10002,15714
9/21/2013 5:53,12,40000000,5771,10102,15873
9/21/2013 5:54,12,40000000,5572,10062,15634
9/21/2013 5:54,12,40000000,5951,9880,15831
9/21/2013 5:54,12,40000000,5858,9990,15848
9/21/2013 5:55,12,40000000,6135,9669,15804
9/21/2013 5:55,12,40000000,5793,9896,15689
9/21/2013 5:55,12,40000000,5751,10119,15870
9/21/2013 5:56,12,40000000,5818,9833,15651
9/21/2013 5:56,12,40000000,5750,9623,15373
9/21/2013 5:56,12,40000000,5809,9704,15513
9/21/2013 5:57,12,40000000,6196,9627,15823
9/21/2013 5:57,12,40000000,5838,9646,15484
9/21/2013 5:57,12,40000000,5994,9832,15826
9/21/2013 5:58,12,40000000,5731,9776,15507
9/21/2013 5:58,12,40000000,5915,9928,15843
9/21/2013 5:58,12,40000000,5940,11687,17627
9/21/2013 5:59,12,40000000,6038,9946,15984
9/21/2013 5:59,12,40000000,5731,9743,15474
9/21/2013 5:59,12,40000000,5771,9883,15654
9/21/2013 6:00,12,40000000,5983,9951,15934
9/21/2013 6:00,12,40000000,5984,9872,15856
9/21/2013 6:01,12,40000000,5644,9873,15517
9/21/2013 6:01,12,40000000,5710,11948,17658
9/21/2013 6:01,12,40000000,5913,9662,15575
9/21/2013 6:02,12,40000000,5895,10959,16854
9/21/2013 6:02,12,40000000,5698,9958,15656
9/21/2013 6:02,12,40000000,5758,9972,15730
9/21/2013 6:03,12,40000000,5733,9890,15623
9/21/2013 6:03,12,40000000,5961,9585,15546
9/21/2013 6:03,12,40000000,5698,9832,15530
9/21/2013 6:04,12,40000000,5902,10063,15965
9/21/2013 6:04,12,40000000,5934,9803,15737
9/21/2013 6:04,12,40000000,5847,10147,15994
9/21/2013 6:05,12,40000000,5855,9931,15786
9/21/2013 6:05,12,40000000,5794,9948,15742
9/21/2013 6:05,12,40000000,5922,9743,15665
9/21/2013 6:06,12,40000000,5829,9908,15737
9/21/2013 6:06,12,40000000,5825,9691,15516
9/21/2013 6:06,12,40000000,6073,9802,15875
9/21/2013 6:07,12,40000000,5650,10093,15743
9/21/2013 6:07,12,40000000,5850,9563,15413
9/21/2013 6:07,12,40000000,5900,9903,15803
9/21/2013 6:08,12,40000000,6030,9793,15823
9/21/2013 6:08,12,40000000,6605,10548,17153
9/21/2013 6:08,12,40000000,6047,9753,15800
9/21/2013 6:09,12,40000000,6058,9865,15923
9/21/2013 6:09,12,40000000,5862,10761,16623
9/21/2013 6:09,12,40000000,6181,9616,15797
9/21/2013 6:10,12,40000000,5936,9626,15562
9/21/2013 6:10,12,40000000,6022,9723,15745
9/21/2013 6:11,12,40000000,5630,10750,16380
9/21/2013 6:11,12,40000000,5962,9803,15765
9/21/2013 6:11,12,40000000,5600,10067,15667
9/21/2013 6:12,12,40000000,5814,10145,15959
9/21/2013 6:12,12,40000000,5750,9809,15559
9/21/2013 6:12,12,40000000,5833,9611,15444
9/21/2013 6:13,12,40000000,5657,11017,16674
9/21/2013 6:13,12,50000000,7050,13102,20152
9/21/2013 6:13,12,50000000,6916,13003,19919
9/21/2013 6:14,12,50000000,7118,12850,19968
9/21/2013 6:14,12,50000000,6706,12982,19688
9/21/2013 6:15,12,50000000,7532,12533,20065
9/21/2013 6:15,12,50000000,6961,13151,20112
9/21/2013 6:16,12,50000000,6771,12924,19695
9/21/2013 6:16,12,50000000,7357,13031,20388
9/21/2013 6:16,12,50000000,7520,13515,21035
9/21/2013 6:17,12,50000000,7431,13034,20465
9/21/2013 6:17,12,50000000,7087,13141,20228
9/21/2013 6:18,12,50000000,7553,13179,20732
9/21/2013 6:18,12,50000000,7048,14008,21056
9/21/2013 6:19,12,50000000,6922,13436,20358
9/21/2013 6:19,12,50000000,7250,12540,19790
9/21/2013 6:19,12,50000000,7237,13779,21016
9/21/2013 6:20,12,50000000,7187,13019,20206
9/21/2013 6:20,12,50000000,7525,12918,20443
9/21/2013 6:21,12,50000000,7039,13241,20280
9/21/2013 6:21,12,50000000,8219,12970,21189
9/21/2013 6:22,12,50000000,7125,13228,20353
9/21/2013 6:26,12,50000000,6604,13210,19814
9/21/2013 6:26,12,50000000,7409,13255,20664
9/21/2013 6:26,12,50000000,6993,13111,20104
9/21/2013 6:27,12,50000000,6814,13187,20001
9/21/2013 6:27,12,50000000,7240,12773,20013
9/21/2013 6:28,12,50000000,8899,12575,21474
9/21/2013 6:28,12,50000000,6943,12952,19895
9/21/2013 6:29,12,50000000,7272,12640,19912
9/21/2013 6:29,12,50000000,7386,12948,20334
9/21/2013 6:30,12,50000000,7106,13014,20120
9/21/2013 6:30,12,50000000,7309,13058,20367
9/21/2013 6:30,12,50000000,7020,13162,20182
9/21/2013 6:32,12,50000000,6894,12480,19374
9/21/2013 6:32,12,50000000,7587,12906,20493
9/21/2013 6:33,12,50000000,7056,13418,20474
9/21/2013 6:33,12,50000000,7763,12838,20601
9/21/2013 6:37,12,50000000,6978,13743,20721
9/21/2013 6:38,12,50000000,6992,12714,19706
9/21/2013 6:38,12,50000000,7312,12558,19870
9/21/2013 6:39,12,50000000,7070,12866,19936
9/21/2013 6:39,12,50000000,7352,12482,19834
9/21/2013 6:39,12,50000000,7235,13226,20461
9/21/2013 6:40,12,50000000,7363,12556,19919
9/21/2013 6:40,12,50000000,7008,12867,19875
9/21/2013 6:41,12,50000000,7126,12666,19792
9/21/2013 6:41,12,50000000,7294,13184,20478
9/21/2013 6:41,12,50000000,7074,12962,20036
9/21/2013 6:42,12,50000000,7395,12892,20287
9/21/2013 6:42,12,50000000,7158,13019,20177
9/21/2013 6:43,12,50000000,7321,12983,20304
9/21/2013 6:43,12,50000000,7085,12987,20072
9/21/2013 6:44,12,50000000,6878,12889,19767
9/21/2013 6:44,12,50000000,7612,12875,20487
